Yesu	yesu
Yesu	yesu
nzaangc	Ravg
dongh	tovb
cor	Zx
TinHungh	Tinb huvb
zeix	zeij
lungh	luvb
ndau	Dau
caux	Zauj
maanc	maang
muotc	mwrtg
hnangv	Navq
naaiv	naaiq
nor	nx
ziangx	zyavj
nzengc	Revg
aqv	aq
taux	Tauj
dacietv	taZyetq
hnoi	Nxi
zoux	zruj
ninh	ninb
nyei	Eei
gong	kov
ziouc	zyrug
dingh	tivb
hitv	hitq
kuonx	Kwrnj
cuotv	Zwrtq
ceix	Zeij
fuqv	fuq
bun	pun
wuov	uaq
norm	nxm
benx	penj
cingnzengc	Revg
weic	weig
zuqc	zug
yaac	yaag
huingx	Wivj
jauvlouc	lrug
se	se
Ziouv	zyruq
zanc	zang
maiv	maiq
gaengh	kcvb
maaih	maaib
haaix	haiq
nyungc	Euvg
miev	miaq
ndiangx	Dyavj
kungx	Kuvj
wuom	uam
yiem	yem
saamx	saamj
daaih	taaib
ndorn	Dxn
gormx	kxmj
aengx	cvj
zorqv	zxq
deix	teij
niembung	Buv
nanv	nanq
dauh	taub
mienh	myenb
biomv	pyomq
maengc	mcvg
qiex	Qiaj
bieqc	piag
mbazorng	Bazxv
dong	tov
bung	puv
nyuoz	kaEuad
ndiev	Diaq
maanh	maanb
jiez	Jiad
gorn	kxn
hiaangx	Yaavj
jienv	Jyenq
faaux	faauj
yungz	yuvd
duqv	tuq
sieqv	siaq
gorngv	kxvq
mbuox	Buaj
meih	meib
meih	meib
yietc	yetg
biauv	pyauq
hmuangv	Mwavq
doic	txig
oix	xij
nzangv	Ravq
jaax	Jaaj
yie	yia
buatc	pwatg
ganh	kanb
horpc	hxpg
hnyouv	Hruq
Dafaanh	tafaanb
uix	wij
saengkuv	Kuq
dorh	txb
siec	siag
doix	txij
gouv	kruq
nyeiz	Eeid
norqc	nxg
Siex	siaj
douc	trug
buonv	pwrnq
zungv	zuvq
kuqv	laKuq
hieh	Yiab
zoih	zxib
buang	pwav
waac	waag
dorn	txn
mbuo	Bua
dornjueiv	Jweiq
funfaqv	faq
buangv	pwavq
tin	Tinb
Deic	teig
douh	trub
ndaubeih	Daub
nyorng	Exv
ganaaiv	kanaaiq
koiv	Kxiq
mbiauz	Byaud
gamh	kamb
nziex	Riaj
jiu	Jiu
gunv	kunq
haih	haib
dongz	tovd
nyanc	Eang
hopv	hopq
ih	ib
nyungcnyungc	Euvg
zinh	zinb
ndaangc	Daavg
mingh	mivb
Sem	sem
Haam	haam
zeivfun	zeib
yiemx	yemj
liuz	liud
nqa	Gahaaq
buo	pua
nduqc	Dug
fih	fib
fingx	fivj
hlo	Lo
mengh	mevb
hoc	hog
zioux	zyruj
fingxfingx	fivj
mienh	myenb
ziux	ziuj
jauv	Jauq
Lotv	lotq
cietv	Zyetq
ziepc	zyepg
hmz	Mmd
hnyangx	Havj
auv	auq
fun	fun
liemh	lyemb
zornc	zxng
dauh	taub
deicbung	puv
mi	mig
gan	kan
jiex	Jiaj
zingh	zivb
diuh	tiub
domh	tomb
mbaong	Baov
zuei	zwei
hinc	hing
Naaiv	naaiq
ziecdorngh	ziab
ziec	ziag
hungh	huvb
hnyangxjeiv	Havb
juov	Juaq
yie	yia
Nernh	nrnb
muangx	mwavj
zanczanc	zang
lamh	lamb
nqemh	Gemb
dorngx	txvj
zueiz	zweid
ndopvliuh	liub
gauh	kaub
yuoqv	yuaq
ziangh	zyavb
seix	seij
zaangc	zavg
baeqv	pcq
nyic	Eig
hlang	Lav
gox	koj
haic	haig
longc	lovg
heuc	heug
njiec	Fiag
jaadingh	tivb
nzipc	Ripg
zeiv	zeiq
buangh	pwavb
nzunc	Rung
huaang	Waav
ngorc	vxg
lomchuaang	lomb
guanh	kwanb
ba	paki
yungh	yuvb
bueix	pweij
gahlen	kaLen
finmienh	myenb
baeng	pcv
fai	fai
ciangv	Zyavq
paaiv	Paaiq
fienx	fyenj
lorz	lxd
gorx	kxj
njaaux	Faauj
gau	kau
feix	feij
nqoi	Gxi
fujueiv	fuJweiq
i	i
nouh	nrub
beiz	peid
puoqv	Puaq
cingx	Zivj
fatv	fatq
mv baac	mq paag
tiux	Tiuj
zipv	zipq
qam	Qam
zom	zom
m	msiaq
nziaauc	Ryaaug
haiz	haid
hnamv	Namq
longx	lovj
nduov	Duaq
suiv	swiq
miucfangx	miub
guangc	kwavg
saax	saaj
yienc	yeng
luihoux	hruj
corc	Zxg
die	tia
lunx	lunj
leih	leib
biaux	pyauj
sin	sin
danyeic	taEeig
tengx	Tevj
mangc	mavg
waaic	waaig
daic	taig
caamx	Zaamj
bouh	prub
angunc	avung
diuv	tiuq
jien	Jyen
njuov	Fuaq
dorngc	txvg
diex	tiaj
goux	kruj
dinc	ting
baengbieiv	pcvb
wuonx	wrnj
loh	lob
lauh	laub
mbeix	Beij
souv	sruq
Ndaaih	Daaib
hlen	Len
yangh	yavb
ngongh	vovb
nzueic	Rweig
junc	Jung
luoqc	luag
diqc	tig
normh	nxmb
mbiauh	Byaub
maaiz	maaid
hnaangx	Naavj
daic	taig
kouv	Kruq
zaanv	zaanq
nyaanh	Eaanb
dapv	tapq
mbuoqc	Buag
nzuih	Rwib
bou	pru
ei	ei
ndorm	Dxm
nziouv	Ryruq
njang	Fav
fungx	fuvj
lorh	lxb
nzuonx	Rwrnj
ziqc	zig
nangc	navg
go	ko
gaanv	kaanq
zunc	zung
zaaic	zaaig
naaic	naaig
gaax	kaaj
diuc	tiug
mbuo	Bua
nyienz	Eyend
beqv	peq
hiuv	hiuq
nzoih	Rxib
gapv	kapq
zunv	zunq
hingv	hivq
sic	sig
aac	aag
qaqv	Qaq
daauh	taaub
muoz	muad
nzuqc	Rug
ndaauv	Daauq
doqc	tog
wuoqc	uag
ginc	king
daav	taaq
zaeix	zaeij
caangh	Zaavb
laangh	laavb
daix	taij
sueih	sweib
eix	eij
hngaqv	Vaq
luangc	lwavg
jaan	Jaan
dangx	tavj
laaix	laaij
ciouv	Zyruq
ceng	Zev
buoz	puad
winwangv	wavq
jaang	Jaav
gueic	kweig
baaix	paaij
sienh	syenb
saauv	saauq
laauc	laaug
yaangh	yaavb
ngaatc	vaatg
orv	xq
mbaapv	Baapq
gaamv	kaamq
haeqv	hcq
nyie	Eia
ndoh	Dob
hmei	Mei
nquaah	Gwaab
nzox	Roj
siqv	siq
nziaamv	Ryaamq
yiemc	yemg
beiv	peiq
biouv	pyruq
camv	Zamq
koivhlen	Len
gapvjaaix	kapg
daaux	taauj
henv	henq
laanh	laanb
ndongx	BuDovj
Ndaan	Daan
baengh	pcvb
fim	fim
siemv	syemq
baeqc	pcg
naang	naav
bingx	pivj
hlaax	Laaj
nyieqc	Eiag
mbueiz	Bweid
zieqv	ziaq
zung	zuv
hlorpv	Lxpq
gunguaaz	vwaad
an	an
lomc	lomg
dorc	txg
mangc	mavg
dorng	txv
nzahmien	RaMyen
ngaengc	vcvg
horngh	hxvb
jangxhoc	hog
nzamc	lob
leizlatc	latg
nzung	Ruv
njoux	Fruj
taaih	Taaib
mborqv	Bxq
O	o
mbiaauc	Byaaug
jieqv	Jiaq
baaic	paaig
njopc	Fopg
douz	trud
buov	puaq
qui	Qwi
nqaauv	Gaauq
zuangx	zwavj
sinx	sinj
mbong	Bov
kang	Kav
liepc	lyepg
sai	sai
Se	sij
ginv	kinq
Cuotv	Zwrtq
dungx	tuvq
zienh	zyenb
leiz	leid
zaqc	zag
nimc	nimg
oix	xij
fongc	fovg
horc	hxg
jiem	Jyem
suix	swij
setv	setq
mbuov	Buaq
lamaah	lamaab
biei	pyei
dang	tav
galanv	kalanq
youh	yrub
ndaang	Daav
laapc	laapg
liuc	liug
zorpc	zxpg
orn	xn
hung	huv
jaaix	Jaaij
laengz	lcvd
Faang	faav
ganyiec	kaEiag
bin	pin
hormh	hxmb
dasuqv	tasuq
biaa	pyaa
ndorqc	Dxg
jangv	Javq
gorqv	kxq
piaeng	Pycv
naetv	nctq
bienh	pyenb
gandiev	kaDiaq
maengx	mcvj
gaeng	kcv
laatc	laatg
naamh	naamb
mbaeqc	Bcg
dongc	tovg
fai	fai
ndie	Dia
topv	Topq
taapv	Taapq
weih	weib
biaav	pyaaq
corng	Zxv
wuonv	wrnq
dingx	tivj
ngau	vau
Mbuox	Buaj
zaax	zaaj
dinh	tinb
zieqc	ziag
dieh	tiab
jorng	Jxv
gaatv	kaatq
ciqv	Ziq
lorqc	lxg
diu	tiu
biangh	pyavb
zuqc	zug
kuaaiv	Kwaaiq
labieivbenv	penq
fiev	fiaq
huv	huq
hatc	hatg
bienx	pyenj
ndatv	Datq
zuqv	zuq
Singx	sivj
fusux	fub
japv	Japq
muonc	mwrng
jaaiv	Jaaiq
yienx	yenj
Zih	zib
saengyietv	scvb
wuic	wig
maan	maan
mnqorngv	mGxvq
fiqv	fiq
zuiz	zwid
mbuonvmuonc	Bwrnb
caqvbouc	Zag
leiznyeic	Eeig
huing	Wiv
nyutc	Eutg
beu	peu
nitv	nitq
bingv	pivq
dabetv	tapetq
gorqvmienh	kxg
hunglouh	huvb
hietv	Yetq
deih	teib
mbaaix	Baaij
hlengx	Levj
faan	faan
mjangc	mJavg
zaeqv	zcq
nzaaux	Raauj
hmuangx	Mwavj
muoqv	muaq
geh	keb
mbienv	Byenq
hmien	Myen
pai	Pai
cien	Zyen
maac	maag
naaiv	naaiq
dingc	tivg
zunh	zunb
nyeic	Eeig
ziex	ziaj
maiv	maiq
lengc	levg
jeiv	Jeiq
gec	keg
yiem	yem
teix	Teij
zuov	zuaq
hnoinyieqc	Eiag
liouh	lyrub
mbabiei	Bapyei
siaam	syaam
kuh	Kub
sei	sei
maa	maa
youz	yrud
muoc	muag
zeih	zeib
guoqv	kuaq
jaasic	sig
juqv	Juq
cie	Zia
gomv	komq
liuh	liub
bieiv	pyeiq
nziemxyaangh	Ryemb
nzatc	Ratg
mbui	Bwi
Kutv	Kutq
sung	suv
biaavmbiaac	Byaag
ongtaaix	Taaij
juangc	Jwavg
lingc	livg
coqv	Zoq
hungx	huvj
ndopv	Dopq
jaangh	Jaavb
zongh	zovb
guei	kwei
zangx	zavj
guaix	kwaij
hneiv	aNeiq
faatv	faatq
huin	Win
Lingh	livb
mzing	mziv
tong	Tov
hienx	Yenj
yuoqc	yuag
wuonbaengc	pcvg
buonc	pwrng
da	tayetq
houz	hrud
houv	hruq
ndortv	Dxtq
nqox	Goj
za	zakevb
fai	lakwaib
baac	paag
jaa	Jaa
jaauv	Jaauq
win	win
Gaatc	kaatg
buozndiev	Diaq
Okc	okg
faix	faij
jangx	Javj
labieiv	lapyeiq
nyouz	Erud
nzauh	Raub
nyiemv	Eyemq
jung	Juv
njaih	Faib
mouz	mrud
maanzhmuangx	maanb
Mungv	muvq
fangx	favj
youx	yruj
nziev	Riaq
hanc	hang
laangz	laavd
goix	kxij
fengx	fevj
bouv	pruq
ndutv	Dutq
zei	zei
aeqv	cq
balaqc	palag
capv	Zapq
maaz	maad
maazcie	Zia
oc	og
horngz	hxvd
laih	laib
ndoqv	Doq
nauv	nauq
gorxyouz	yrud
naah	naab
guen	kwen
lui	lwi
ndorpc	Dxpg
lauz	laud
buoc	puag
jaux	Jauj
dorngh	txvb
zic	zig
soux	sruj
mouc	mrug
siou	syru
torngx	Txvj
cungaeng	Zunb
don	ton
hui	Wi
zuoqv	zuaq
nzaanx	Raanj
mnormh	mnxmb
baamh	paamb
gen	ken
Tov	Toq
nyinh	Einb
borngbuoz	pxvb
Nun	nun
nqaai	Gaai
mbanziu	BaRiu
yuqc	yug
guon	kwrn
Maiv	maiq
Ai	ai
caangv	Zaavq
zuov	zuaq
waanc	waang
muonz	mwrnd
mbongaiv	aiq
hingh	hivb
nzaeng	Rcv
nduoh	Duab
bungh	puvb
wuomzingv	zivq
caengx	Zcvj
zengc	zevg
ndaauh	Daaub
kaux	Kauj
nipc	nipg
ndaamvfingx	fivj
normnorm	nxmb
kauv	Kauq
hoz	hod
baaux	paauj
mborqv	Bxq
dau	tau
fungc	fuvg
sic	sig
nzauz	Raud
gaeqv	kcq
zeiz	zeid
maaic	maaig
zaah	zaab
mingh	mivb
butv	putq
Saengv	scvq
kuinx	Kwinj
dafeix	tafeij
nyanc	Eang
dangh	tavb
cienceqv	Zeq
mbuangz	Bwavd
ganaaivcenv	kanaaib
nziaaux	Ryaauj
aanx	aanj
bangc	pavg
sou	sru
faqv	faq
Supc	supg
zien	zyen
mbaih	Baib
suei	swei
cin	Zin
gu	kub
nguaaic	vwaaig
Kitv	Kitq
ndongc	Dovg
mbaengc	Bcvg
mbadauh	Bataub
dox	toj
Gikc	kikg
borqv	pxq
gunv	kunq
cing	Ziv
tov	Toq
jaiv	Jaiq
juangzinx	zinj
junbaeng	pcv
mueic	mweig
cangx	Zavj
heix	heij
njienyouh	Fyenb
nzoz	Rod
patv	Patq
daanh	taanb
baah	paab
binc	ping
ninh	ninb
haaix	Euvg
bungx	puvj
orqv	xq
mienv	myenq
morh	mxb
nzang	Rav
cang	Zav
biu	piu
nzopv	Ropq
njongc	Fovg
ding	tiv
jienv	Jyenq
simv	simq
Nopv	nopq
zinx	zinj
Gatc	katg
zong	zov
qiemx	Qyemj
ndo	Do
zouv	zruq
nqaang	Gaav
hei	hei
dafaam	tafaam
Dahmz	taMmd
Daluoqc	taluag
mdaaih	mtaaib
juangc	Jwavg
mbungv	Buvq
hoic	hxig
maaih	maaib
winh	winb
en	en
ninh	ninb
Maaih	maaib
jomc	Jomg
congmengh	mevb
nzaatv	Raatq
ken	Ken
buic	pwig
tor	Tx
ndunh	Dunb
gorng	kxv
dimv	timq
cuoqv	Zuaq
mueiz	mweid
homc	homg
suangx	swavj
siouv	syruq
aapv	aapq
gongmienh	myenb
juang	Jwav
zuoqc	zuag
wuih	wib
faam	faam
gemh	kemb
faah	faab
liouz	lyrud
ndiouh	Dyrub
haengh	hcvb
Mbiorv	Byxq
funx	funj
aqc	ag
torh	Txb
zorngzuqv	zuq
peix	Peij
fuc	fug
sienx	syenj
Wuov	uaq
yietv	yetq
baengc	pcvg
zorng	zxv
baengguanh	pcvb
gomh	komb
hepc	hepg
qongx	Qovj
baamz	paamd
betv	petq
naanc	naang
nyaiv	Eaiq
njunc	Fung
dajuov	taJuaq
saengziepc	scvb
guaatv	kwaatq
daan	taan
hietc	Yetg
nzou	Rru
zaangv	zaavq
Yiem	yem
dunx	tunj
calengc	Zalevg
fiuvdaanh	fiub
nqaapv	Gaapq
caauh	Zaaub
hoqc	hog
banh	panb
zeic	zeig
hlieqv	Liaq
ben	pen
gengx	kevj
daux	tauj
gaux	kauj
njanglaangc	laavg
joux	Jruj
porv	Pxq
mbungh	Buvb
zuotc	zwrtg
nzorng	Rxv
nouz	nrud
zorc	zxg
hnyangxhnyangx	Havb
siepvsiepv	syepq
mbenc	Beng
borngz	pxvd
laauh	laaub
koi	Kxi
caeqv	Zcq
mietc	myetg
zaaix	zaaij
goiv	kxiq
fioux	fyruj
jorm	Jxm
dengv	tevq
mbahnoi	BaNxi
lapv	lapq
nqenx	Genj
huotv	Wrtq
ngopv	vopq
gaqiex	kaQiaj
fiu	fiu
njormh	Fxmb
tiuv	Tiuq
Yopv	yopq
feix	feij
faanh	faanb
nziang	Ryav
Baamh	paamb
gongzinh	kovb
pien	Pyen
zingx	zivj
loz	lod
ahnoi	aNxi
koqv	Koq
linh	linb
gorngv	kxvq
guai	kwai
aiv	aiq
Mienh	myenb
zoqc	zog
wuonh	wrnb
zaang	zaav
dangv	tavq
morc	mxg
nangv	navq
baav	paaq
ornlorqc	lxg
mbaang	Baav
nauc	naug
nyitc	Eitg
kuv	Kuq
laengh	lcvb
gaengv	kcvq
om	om
orqc	xg
gengh	kevb
ziangv	zyavq
mun	mun
wetv	wetq
diev	tiaq
jaav	Jaaq
dunh	tunb
yunh	yunb
siouc	syrug
piex	Piaj
nziaauxzunc	zung
gornndoqv	Doq
hlaang	Laav
ndauhuaang	Daub
cunx	Zunj
kuangx	Kwavj
saengeix	eij
Congmengh	Zovb
aax	aaj
sekv	sekq
hngongx	Vovj
bouc	prug
mau	mau
puix	Pwij
duih	twib
sorng	sxv
zaux	zauj
mbai	Bai
ndiux	Diuj
njimv	Fimq
nyiec	Eiag
tipv	Tipq
gorngvbaeqc	kxvb
jatv	Jyetq
zoi	zxi
laaih	laaib
luic	lwig
longx	lovj
nyau	Eau
hienv	Yenq
hniev	Niaq
ngatv	vatq
mienh	myenb
leiz	leid
mungz	muvd
zueix	zweij
diqv	tiq
kuotv	Kwrtq
nyorqv	Exq
piqv	Piq
zeqc	zeg
mbuonx	Bwrnj
baqv	paq
nyorx	Exj
heh	heb
camh	Zamb
zuih	zwib
junh	Junb
houh	hrub
saeng	scv
sioux	syruj
nzungh	Ruvb
nquaav	Gwaaq
zatv	zatq
jiepv	Jyepq
korvlienh	lyenb
ngaanc	vaang
ndaatv	Daatq
jopvnyeic	Eeig
yienh	yenb
siepv	syepq
luih	lwib
qouqou	Qru
nquin	Gwin
ndongx	Dovj
guaengv	kwcvq
muotv	mwrtq
cai	Zai
gongfim	fim
biux	piuj
cau	Zau
ningv	nivq
ndui	Dwi
ndiangxnquaah	Gwaab
mbueix	Bweij
Ziouv	zyruq
hlungh	Luvb
hluotv	Lwrtq
zueih	zweib
haanz	haand
biopv	pyopq
nqaiv	Gaiq
baetv	pctq
luv	luq
ndiangxgaaz	Dyavb
gaaz	Jyenq
sounjunc	Fung
limc	limg
njuotv	Fwrtq
maeqv	mcq
forng	fxv
cunv	Zunq
ndeic	Deig
youc	yrug
jauh	Jaub
ceux	Zeuj
lunc	lung
lakuotv	laKwrtq
nziez	Riad
ciev	Ziaq
daziepc	tazyepg
ting	Tiv
cingh	Zivb
mborqc	Bxg
donx	tonj
coux	Zruj
nzutv	Rutq
Wuov	uaq
zaeng	zcv
siem	syem
maux	mauj
zorngzengx	zevj
ndiqv	Diq
zungh	zuvb
gasie	kasia
nyiemc	Eyemg
njunh	Funb
juv	Juq
ndaix	Daij
gueix	kweij
mbiungc	Byuvg
samx	samj
hleix	Leij
sie	sia
suonc	swrng
poux	Pruj
dau	BaNxi
aav	aaq
hlorngx	Lxvj
poutong	Tov
cingv	Zivq
noic	nxig
nduov	Duaq
maengh	mcvb
dueiv	tweiq
gitv	kitq
tuix	Twij
nzong	Rov
doz	tod
Janx	Janj
guv	kuq
zungx	zuvj
mbienx	Byenj
koivnzou	Rru
juangv	Jwavq
daaix	taaij
luonx	lwrnj
horngc	hxvg
liouc	lyrug
donv	tonq
mbiorngz	Byxvd
beic	peig
nangh	navb
jiuv	Jiuq
saaix	saaij
gauv	kauq
ndaam	Daam
mbiaangx	Byaavj
cou	Zru
siev	siaq
mauv	mauq
kuanv	Kwanq
pali	Pali
palaaix	Palaaij
guaax	kwaaj
jouh	Jrub
zanx	zanj
gem	kem
mbiaangc	Byaavg
Gorxyouz	kxb
hemx	hemj
lanyauv	laEauq
ndouv	Druq
longxlongx	lovj
haah	haab
ki	Ki
enzingh	zivb
zanv	zanq
laangc	laavg
qangx	Qavj
nyunc	Eung
hengx	hevj
norh	nxb
zuiz	zwid
taux	ninb
lozhnoi	Nxi
kaeqv	Kcq
daaih	taaib
biorngh	pyxvb
nzieqc	Riag
mouh	mrub
siangnzung	syavb
bunh	punb
lengh	levb
jaic	Jaig
im	im
dov	toq
camx	Zamj
qorng	Qxv
fong	fov
muonh	mwrnb
maah	maab
Setc	setg
baatc	paatg
joih	Jxib
nquaqv	Gwaq
ndipc	Dipg
saaiv	saaiq
hiaamx	Yaamj
aah	aab
meix	meij
buv	puq
longh	lovb
koux	Kruj
gaav	kaaq
zaeqvziouv	zyruq
mbouv	Bruq
beuv	peuq
torngv	Txvq
hnoihnoi	Nxib
ziemx	zyemj
nzangh	Ravb
saah	saab
beih	peib
nie	nia
Aandam	aaDam
Haawaa	haawaa
Kaain	Kaain
Aambaen	aaBcn
toi	Txi
caa	Zaa
niaa	nyaa
morngx	mxvj
naqv	naq
njouh	Frub
huaax	Waaj
Enden	tov
Enokv	enokq
Laamekv	laamekq
Aandaa	aaDaa
siang	syav
div	tiq
zuangv	zwavq
Enotv	enotq
Kenan	Kenan
Maahaalaalen	maahaalaalen
Yaaletv	yaaletq
Metuselaa	meTusejlaa
Noyaa	noyaa
Yaafetv	yaafetq
Aa	aa
haapv	haapq
nqo	Go
Kaanaaan	Kaanaaan
Gome	kome
Maagokc	maakokg
Maandai	maaDai
Yaawaan	yaawaan
Tumban	TuBan
Mesekv	mesekq
Tilaatv	Tilaatq
Atckenatv	atgKenatq
Lifaatv	lifaatq
Togaanmaa	Tokaanmaa
Eliseaa	eliseaa
Taansitv	Taansitq
Kitvtim	KitqTim
Londaanim	loDaanim
Iyipv	iyipq
Putv	Putq
Sembaa	sejBaa
Haawilaa	haawilaa
Sapctaa	sapgTaa
Laaaamaa	laaaamaa
Sapctekaa	sapgTeKaa
Qembaa	QeBaa
Ndendaan	DeDaan
Nimlotv	nimlotq
daamv	taamq
Ninaawe	ninaawe
Lundim	luDim
Aanaamim	aanaamim
Lehaambim	lehaaBim
Napvtuhim	napqTuhim
Hiwai	hiwai
Aankaa	aanKaa
Sini	sijni
Elaam	elaam
Atcsu	atgsu
Aanfaasatv	aanfaasatq
Lunde	luDe
Aalam	aalam
Utc	utg
Hun	hun
Gete	keTe
Qelaa	Qelaa
Embe	eBe
Yokvtaan	yokqTaan
Anmondatc	anmoDatg
Qelepv	Qelepq
Haasaanmaawetv	haasaanmaawetq
Yelaa	yelaa
Haandolam	haaDolam
Usaan	usaan
Ndikclaa	Dikglaa
Aambimaaen	aaBimaaen
Ofi	ofi
Yombapc	yoBapg
fanh	fanb
Mbaamben	BaaBen
Belekv	pelekq
Leu	leu
Selukv	sejlukq
Naaho	naaho
Telaa	Telaa
Apclaam	apglaam
Haalaan	haalaan
Saalaai	saalaai
Minkaa	minKaa
Negepc	nekepg
Faalo	faalo
Mbetcen	Betgen
Sondom	sojDom
Gomolaa	komolaa
Atcmaa	atgmaa
Semboyim	sejBoyim
Mbelaa	Belaa
Naaiv	naaiq
Soaa	sojaa
Zingh	zivb
Taamaa	Taamaa
Aamaalekv	aamaalekq
Aamolai	aamolai
Sitcndim	sitgDim
Ndaamatvgatc	Daamatqkatg
Kendolaaome	KeDolaaome
aengx	cvj
Aane	aane
Etcko	etgKo
Mamle	mamle
torngvbaaih	paaib
Eliyese	eliyese
Apclaaham	apglaaham
gopv	kopq
nyuonh	Ewrnb
Hitvtai	hitqTai
Belitvsi	pelitqsi
Lefaaim	lefaaim
Haagaa	haakaa
Isaamaaen	isaamaaen
Saalaa	saalaa
ni	ni
zaamc	zaamg
lov	loq
ziouc	zyrug
fongv	fovq
baan	paan
Gelaaaa	kelaaaa
Aambimelekv	aaBimelekq
Isakc	isakg
houc	hrug
nzitv	Ritq
Mbeeqembaa	BeeQeBaa
lomh	lomb
ndoqc	Dog
Haaso	haaso
Mbetuen	BeTuen
Lembekaa	leBeKaa
Hembolon	heBolon
Sohaax	sojhaaj
Efolon	efolon
zaangh	zaavb
ko	Ko
lo	lo
ong	ov
gux	kuj
Laambaan	laaBaan
kangv	Kavq
zorv	zxq
Ketulaa	KeTulaa
Yokvsaan	yokqsaan
Mitvmaa	mitqmaa
Ndumaa	Dumaa
Haandatc	haaDatg
Temaa	Temaa
Yetu	yeTu
Naafitv	naafitq
Kendemaa	KeDemaa
Esaau	esaau
Yaakopv	yaaKopq
dopc	topg
Filisaadie	filisaatia
Mbeeli	Beeli
Elon	elon
Mbaasematv	Baasejmatq
hluo	Lua
nzomz	Romd
Laasen	laasen
siangx	syavj
nauz	naud
bietv	pyetq
Laambaan	laaBaan
pienx	Pyenj
Mbinhaa	Binhaa
Leaa	leaa
Lewi	lewi
Napvtaali	napqTaali
Sinxbaa	sinjpaa
witv	witq
saau	saau
ndundaaim	DuDaaim
jieh	Jiab
Ndinaa	Dinaa
diemv	tyemq
pui	Pwi
piatv	Pyatq
Isaalaaen	isaalaaen
Yosepv	yosepq
Sei	seji
Haamo	haamo
Sekem	seKem
Simeon	simeon
buix	pwij
Efaalaataa	efaalaaTaa
Mbenyaamin	Benyaamin
Aase	aase
se	se
Elifatv	elifatq
Leuen	leuen
Temaan	Temaan
Omaa	omaa
Sefo	sejfo
Naahatc	naahatg
Zelaa	zelaa
Aanaa	aanaa
Yeutc	yeutg
Yaalaam	yaalaam
Kolaa	Kolaa
Oholimbaamaa	oholiBaamaa
dongh	tovb
Endom	eDom
Holi	holi
Homam	homam
Lotaan	loTaan
Timnaa	Timnaa
Sombaan	soBaan
Maanaahaatv	maanaahaatq
Embaan	eBaan
Onam	onam
Ndison	Dison
Etcmbaan	etgBaan
Itclaan	itglaan
Kelaan	Kelaan
Ese	ese
Ndisaan	Disaan
Aalan	aalan
Simbeon	siBeon
Endom	eDom
Ndinhaambaa	DinhaaBaa
Mbosaalaa	Bosaalaa
Husaam	husaam
Mbendatc	BeDatg
Moapc	moapg
Mindien	miDyen
Aawitv	aawitq
Samxlaa	samjlaa
Lehoxmbotc	lehojBotg
Saaun	saaun
Akcmbo	akgBo
Anwaa	anwaa
Yetetv	yeTetq
Elaa	elaa
Binon	pinon
Kenatv	Kenatq
Mipvsaa	mipqsaa
Ndotaan	DoTaan
Lumben	luBen
Yundaa	yuDaa
Quaa	Quaa
Eaa	eaa
Onan	onan
Hipvlu	hipqlu
jei	Jei
Naiaa	naiaa
dorv	txq
nyaux	Eauj
laeh	lcb
sing	siv
fingv	fivq
Haanokv	haanokq
Banlu	panlu
Hetvlon	hetqlon
Kaanmi	Kaanmi
Yemuen	yemuen
Yaamin	yaamin
Ohaatc	ohaatg
Yaakin	yaaKin
Geson	keson
Kohaatv	Kohaatq
Melaali	melaali
Itcsaaxkaa	itgsaajKaa
Tolaa	Tolaa
Simlon	simlon
Sembulun	sejBulun
Seletv	sejletq
Yaaleen	yaaleen
Hakvgi	hakqki
Suni	suni
Etcmbon	etgBon
Elei	elei
Aaleli	aaleli
Imnaa	imnaa
Itcwaa	itgwaa
Itcwi	itgwi
Mbeliyaa	Beliyaa
Selaaaa	selaaaa
Hembe	heBe
Mbeke	BeKe
Atcmben	atgBen
Gelaa	kelaa
Naaaamaan	naaaamaan
Aatc	aatg
Husim	husim
Yaasien	yaasien
Guni	kuni
Yese	yese
Sinlem	sinlem
Gosen	kosen
nyim	Eim
Maanatvse	maanatqsej
Efaaim	efaaim
nyaah	Eaab
cei	Zei
Jorndaen	JxDcn
Maaki	maaKi
Mose	mose
Aalon	aalon
ziang	zyav
lueic	lweig
Lipvni	lipqni
Simei	simei
maazli	maali
Musi	musi
Itchaa	itghaa
Nefekv	nefekq
Sikcli	sikgli
Utcsien	utgsien
Misaaen	misaaen
Ensaafaan	ensaafaan
Naason	naason
Naandapc	naaDapg
Itaamaa	iTaamaa
Atcsi	atgsij
Enkaanaa	enKaanaa
Eleaasaa	eleaasaa
Finehatc	finehatg
yaamh	yaamb
ziqv	ziq
caix	Zaij
biauvhlen	Len
faanv	faanq
douznzauc	Raug
borqc	pxg
mbaali	Baali
mapv	mapq
Ziouv	zyruq
ndaamv	Daamq
zouc	zrug
Sukckotv	sukgKotq
cih	Zib
Aambipc	aaBipg
zietc	zyetg
Miliem	milyem
orqv	xb
morqv	mxq
Lefindim	lefiDim
Huaa	huaa
Yosuwaa	yosuwaa
zutc	zutg
Yeto	yeTo
jaangv	Jaavq
Sinaai	sinaai
Mbongningv	Bovb
mbongnqenx	Genj
hanh	hanb
lungz	luvd
buih	pwib
leic	leig
waengc	wcvg
Aambihu	aaBihu
kuing	Kwiv
kelumbim	KeluBim
waengh	wcvb
lunh	lunb
nekv	nekq
kou	Kru
wuonc	wrng
efotv	efotq
paanx	Paanj
ndingh	Divb
ndaamdorng	txv
nqanx	Ganj
hiuang	Ywav
ging	kiv
peux	Peuj
Uli	uli
Mbesaalen	Besaalen
mbuonv	Bwrnq
sortv	sxtq
siousetv	setq
Yembutc	yeButg
aengv	cvq
Oholiapc	oholiapg
gungh	kuvb
gangc	kavg
nyatv	Kwiv
caeqvjaangh	Jaavb
caan	Zaan
gorqc	kxg
kuei	Kwei
juix	Jwij
caeng	Zcv
naatv	naatq
Ulim	ulim
Tummim	Tummim
buoqv	puaq
omx	omj
sietv	syetq
buozzaangv	puab
maeng	mcv
guaaih	kwaaib
laauz	laaud
Molekv	molekq
siouh	syrub
nziepv	Ryepq
hlaau	Laau
Selomitv	selomitq
buonvfingx	fivj
Suxlisatvndai	sujlisatqDai
Selumien	selumien
Amminaandapc	amminaaDapg
Zuaa	zuaa
Netanen	neTanen
Helon	helon
Eliapc	eliapg
Ammihutv	ammihutq
Elisaamaa	elisaamaa
Bendaasu	peDaasu
Gaamaalien	kaamaalien
Gindeoni	kiDeoni
Aambindan	aaBiDan
Aahiyese	aahiyese
Okaan	oKaan
Baagien	paakien
Ndeuen	Deuen
Eliyaasaapc	eliyaasaapg
Enan	enan
Aahilaa	aahilaa
Amlaam	amlaam
Elisaafaan	elisaafaan
mborng	Bxv
maanaa	maanaa
mueix	mweij
zepv	zepq
Sakcge	sakgke
Sammuwaa	sammuwaa
Saafatv	saafatq
Yefunne	yefunne
Kaalepv	Kaalepq
Igaan	ikaan
Hoseyaa	hoseyaa
Mikaaen	miKaaen
yaauc	yaaug
hec	heg
nzie	Ria
zitc	zitg
Homaa	homaa
doixdekc	tekg
Ndaataan	DaaTaan
Aambilam	aaBilam
siangsic	syavb
yiemh	yemb
loh	lob
zorngh	zxvb
Melimbaa	meliBaa
Kaandetc	KaaDetg
Hoaa	hoaa
Aalaatv	aalaatq
naangdoqc	tog
Zeletv	zeletq
Sihonx	sihonj
Hetvmbon	hetqBon
Kemotv	Kemotq
mbiec	Biag
Sipcbo	sipgpo
Mbaalaakv	Baalaakq
Mbaalaaam	Baalaaam
laaic	laaig
Mbaaan	Baaan
zengx	zevj
Mbeo	Beo
Kenai	Kenai
Beo	peo
Simxli	simjli
Kotvmbi	KotqBi
Suxaa	sujaa
Otcni	otgni
Yaasupv	yaasupq
Atclien	atglien
Semindaa	semiDaa
Hefe	hefe
Selofehatc	sejlofehatg
Maahaalaa	maahaalaa
Hokvlaa	hokqlaa
Tilaasaa	Tilaasaa
Suham	suham
Gileaatc	kileaatg
Maakile	maaKile
Aambaalim	aaBaalim
Ewi	ewi
Lekem	leKem
Lembaa	leBaa
jungz	Juvd
Mikvndon	mikqDon
Lipvnaa	lipqnaa
Taahatc	Taahatg
Yotvmbaataa	yotqBaaTaa
Ombotc	oBotg
Nembo	neBo
Atcmon	atgmon
Mendidelenien	meDitelenyen
Haamatv	haamatq
Sendatc	sejDatg
Mbukcki	BukgKi
Hannien	hannien
Kemuen	Kemuen
Bantien	panTien
Aahihutv	aahihutq
Endeni	eDeni
Atctaalotv	atgTaalotq
Mbaasaan	Baasaan
Holepv	holepq
Zinh	zinb
Aanaakv	aanaakq
Yaahaatv	yaahaatq
Aangopc	aankopg
sorn	sxn
Hemon	hemon
Saindorn	saiDxn
Seni	sejni
mou	mru
benv	penq
Aalaambaa	aalaaBaa
Bitcgaa	pitgkaa
juoqv	Juaq
jienh	Jyenb
nqaeqv	Gcq
maqc	mag
jamv	Jamq
caaiv	Zaaiq
long	lov
weic	weig
kungxbuoz	puad
jiemx	Jyemj
fin	fin
Ammon	ammon
ngaih	vaib
linc	ling
dou	tru
baengx	pcvj
tutv	Tutq
Gelisim	kelisim
tongx	Tovj
Aamen	aamen
buoqc	puag
nqaatv	Gaatq
yang	yav
Laahapc	laahapg
Gingaan	kinkaan
Yeliko	yeliKo
Sapcndi	sapgDi
Aakaan	aaKaan
ndapv	Dapq
Gimbeon	kiBeon
Mbeelotv	Beelotq
Yelusaalem	yelusaalem
Yaanmutv	yaanmutq
Laakitv	laaKitq
Yaafie	yaafia
Ekclon	ekglon
Ndembi	DeBi
Aasekaa	aaseKaa
Makvkendaa	makqKeDaa
Aiyaalon	aiyaalon
Gese	kese
Yaambin	yaaBin
Maandon	maaDon
Akcsaapv	akgsaapq
Mitvbaa	mitqpaa
tauv	Tauq
Aandunlam	aaDunlam
Tapvbuwaa	Tapqpuwaa
Aafekv	aafekq
Megitcndo	mekitgDo
Kendetc	KeDetg
Kaanmen	Kaanmen
Yokvneam	yokqneam
Goyim	koyim
Gesu	kesu
Maaaakaa	maaaaKaa
Saaxlekaa	saajleKaa
Kendemotv	KeDemotq
Mefaaaatc	mefaaaatg
Mbaaaalaa	Baaaalaa
Timnaahaa	Timnaahaa
Akcsaax	akgsaaj
Otcnien	otgnien
daanz	taand
Sipcaa	sipgaa
Telem	Telem
Mbeaalotv	Beaalotq
Semaa	semaa
Molaandaa	molaaDaa
Esem	esem
Entolatv	enTolatq
Sikclaakv	sikglaakq
Matvmannaa	matqmannaa
Soko	sojKo
Mbotckaatv	BotgKaatq
Ete	eTe
Aaqan	aaQan
Atcnaa	atgnaa
Aanaapv	aanaapq
Etctemoaa	etgTemoaa
Aalapc	aalapg
Maaon	maaon
Yitvleen	yitqleen
Gendo	keDo
Aataalotv	aaTaalotq
Naaaalaa	naaaalaa
Silo	silo
Apcwim	apgwim
Ofaalaa	ofaalaa
Laamaa	laamaa
Mosaa	mosaa
Kision	Kision
Embetc	eBetg
Hammatv	hammatq
Kinneletv	Kinneletq
Solaa	sojlaa
Etctaaon	etgTaaon
Ekolon	eKolon
Enteke	enTeKe
Gipcmbeton	kipgBeTon
Mbaaaalatv	Baaaalatq
Mbesekv	Besekq
Sesai	sesai
Aahimaan	aahimaan
Tanmai	Tanmai
Akcsipv	akgsipq
Lehopc	lehopg
Ehutv	ehutq
mbienc	Byeng
Aanaatv	aanaatq
Samgaa	samkaa
Ndembolaa	DeBolaa
Aambinoam	aaBinoam
Taambo	TaaBo
Siselaa	sisejlaa
dimc	timg
nyomc	Eomg
congx	Zovj
Gindeon	kiDeon
Yoaatc	yoaatg
wuomhlen	uamb
mbietc	Byetg
Aambiyese	aaBiyese
Zembaa	zeBaa
Sanxmunnaa	sanjmunnaa
Benuen	penuen
Heletv	heletq
gaam	kaam
Yotaam	yoTaam
Mbee	Bee
Sembun	sejBun
Gaaan	kaaan
king	Kiv
nzauv	Rauq
haaz	haad
Tembetc	TeBetg
Saami	saami
Jaai	Jaai
Yepvtaa	yepqTaa
Aaloe	aaloe
Mbetclehem	Betglehem
Bilaaton	pilaaTon
Apcndon	apgDon
Maanoaa	maanoaa
Saemsanx	scmsanj
guaengx	kwcvj
Gaasaa	kaasaa
Ndelilaa	Delilaa
nqamv	Gamq
Mikaa	miKaa
Laaitc	laaitg
Gimbeaa	kiBeaa
Wuov	uaq
Naaomi	naaomi
Elimelekv	elimelekq
Lute	luTe
Maalon	maalon
Kilion	Kilion
Nyaam	Eaam
juoh	Juab
hnievhniev	Niaq
Maalaa	maalaa
Mboaatc	Boaatg
ongx	ovj
camvcamv	Zamq
nzien	Ryen
tongv	Tovq
Laam	laam
Sanxmon	sanjmon
Ombetc	oBetg
Jetcsi	Jyetgsi
Ndaawitv	Daawitq
buonvzingh	Eei
Eli	eli
Beninnaa	peninnaa
Hannaa	hannaa
saengyungz	yuvd
Saamuen	saamuen
Atcndotc	atgDotg
lozdorngx	txvj
Aambinaandapc	aaBinaaDapg
ndamv	Damq
Saulo	saulo
zouh	zrub
fuix	fwij
Yaambetc	yaaBetg
Naahaatc	naahaatg
Mikvmaatv	mikqmaatq
Suan	suan
Yonaataan	yonaaTaan
Aahiyaa	aahiyaa
Apcne	apgne
Ne	ne
Aambien	aaBien
Suwaa	suwaa
Aagakc	aakakg
Sammaa	sammaa
hmienfangx	Myenb
Goliatc	koliatg
naamx	naamj
Saaaalaaim	saaaalaaim
Sieqvhlo	siag
Melaapv	heug
Mikaan	miKaan
Naayotv	naayotq
Aahimelekv	aahimelekq
Aakitv	aaKitq
Ndoekc	Doekg
Aahitupv	aahiTupq
Aambiyaataa	aaBiyaaTaa
Keilaa	Keilaa
Naambaan	naaBaan
Aambigaayin	aaBikaayin
Aahinoam	aahinoam
Seluyaa	sejluyaa
Yoaapc	yoaapg
Aambiqai	aaBiQai
Sunem	sunem
Ginmboaa	kinBoaa
box	poj
dien	tyen
Keleti	KeleTi
yieqv	yiaq
Laamotv	laamotq
Yaatvti	yaatqTi
Yelaameen	yelaameen
orpv	xpq
jiemh	Jyemb
Yaasaa	yaasaa
Itcmbosetv	itgBosetq
Maahaanaaim	maahaanaaim
njaangh	Faavb
Aasaaxhen	aasaajhen
Amnon	amnon
Aandoniyaa	aaDoniyaa
Hakvgitc	hakqkitg
Sefaatiyaa	sefaaTiyaa
Gitctaaim	kitgTaaim
Limmon	limmon
Lekaapv	leKaapq
Mbaaaanaa	Baaaanaa
Minlo	minlo
Naatan	naaTan
Saalomorn	saalomxn
Ipchaa	ipghaa
Elisuwaa	elisuwaa
Eliyaandaa	eliyaaDaa
Elifeletv	elifeletq
Gembaa	keBaa
Utcsaa	utgsaa
wingc	wivg
laamx	laamj
sindaa	sijDaa
Sombaa	sojBaa
Haandatcese	haaDatgese
Yufeditc	yufetitg
Silie	silia
Yehoyaandaa	yehoyaaDaa
Mbenaiyaa	Benaiyaa
Peletv	Peletq
Simbaa	siBaa
Mefimbosetv	mefiBosetq
Haanun	haanun
Mbatcqembaa	BatgQeBaa
Uliaa	uliaa
Lapvmbaa	lapqBaa
Apcsaalom	apgsaalom
Yonaandapc	yonaaDapg
Tekoaa	TeKoaa
Itctai	itgTai
Saaxndokc	saajDokg
Aahimaaatc	aahimaaatg
Aahitofen	aahiTofen
Husai	husai
Mbaasinlai	Baasinlai
Aamaasaax	aamaasaaj
Mbikcli	Bikgli
Ilaa	ilaa
Aiaa	aiaa
Litvbaa	litqpaa
Simehaa	simehaa
nzenc	Reng
nqaengc	Gcvg
Dauh	taub
Aahoxhai	aahojhai
Ndondo	DoDo
Haalaa	haalaa
Enhaanan	enhaanan
Haalotv	haalotq
Heletvte	heletqTe
Ikcketc	ikgKetg
Aanaatotv	aanaaTotq
Husaa	husaa
Netofaa	neTofaa
Maahaalai	maahaalai
Limbai	liBai
Gaaatc	kaaatg
Mbaahulim	Baahulim
Atcmaawetv	atgmaawetq
Aahiyam	aahiyam
Gilon	kilon
Hetvlo	hetqlo
Mbaani	Baani
Selekv	sejlekq
Naahaalai	naahaalai
Itclai	itglai
Gaalepv	kaalepq
Uliyaa	uliyaa
Yaase	yaase
Aalaaunaa	aalaaunaa
Ninh	ninb
Aambiqaakv	aaBiQaakq
Aasaaliyaa	aasaaliyaa
Aahilutv	aahilutq
Itcndo	itgDo
Yehosaafatv	yehosaafatq
jai	Jai
Hilaam	hilaam
Lembaanorn	leBaanxn
Aandonilam	aaDonilam
lorngx	lxvj
tei	Tei
ndiangxbenv	penq
daau	taau
nzipv	Ripq
yuonh	ywrnb
Tailaqv	Tailaq
longz	lovd
sengh	sevb
nzormc	Rxmg
Sion	sion
Gaalili	kaalili
Taabenetv	Taapenetq
Yelomboam	yeloBoam
Lehoxmboam	lehojBoam
lozziouv	zyruq
Aambiyaa	aaBiyaa
jaandaangc	Daavg
Sisakv	sisakq
Nembatc	neBatg
Aambiyam	aaBiyam
Aambiqaalom	aaBiQaalom
Aasaax	aasaaj
Mbaaaaqaa	BaaaaQaa
Omli	omli
Saamaalie	saamaalia
Aahapc	aahapg
Aaselaa	aaselaa
Eliyaa	eliyaa
Ombaandi	oBaaDi
Yesemben	yeseBen
Kison	Kison
Yehu	yehu
Elisaa	elisaa
Haasaaen	haasaaen
Naambotc	naaBotg
Imlaa	imlaa
Mikaayaa	miKaayaa
Aahatcyaa	aahatgyaa
Sinhi	sinhi
Aasumbaa	aasuBaa
Yolam	yolam
Yeholam	yeholam
SaiDiex	saib
Ov	oq
Gehaasi	kehaasi
donc	tong
fai	fai
sih	sib
Aannon	aannon
Yehoaahaatc	yehoaahaatg
Aataaliyaa	aaTaaliyaa
luonh	lwrnb
mbaix	Baij
njapv	tavb
njiuv	Fiuq
Yehoaatc	yehoaatg
Aamaasiyaa	aamaasiyaa
ndaau	Daau
Sekaaliyaa	sejKaaliyaa
Sanlum	sanlum
Utcsiyaa	utgsiyaa
Gaandi	kaaDi
Menaahem	menaahem
Atcsilie	atgsilia
Bekaahiyaa	peKaahiyaa
Lemaaliyaa	lemaaliyaa
Bekaa	peKaa
Aahatc	aahatg
Lesin	lesin
Kiaa	Kiaa
Mindie	miDia
Mbaambilon	BaaBilon
Sefaanwaaim	sejfaanwaaim
Hesekiyaa	heseKiyaa
Sennaakelipv	sennaaKelipq
Isaayaa	isaayaa
Aanbatc	aanpatg
Henaa	henaa
Ipcwaa	ipgwaa
opv	opq
Aamon	aamon
Yosiyaa	yosiyaa
Aandaayaa	aaDaayaa
Mesunlaam	mesunlaam
Aasaalaiyaa	aasaalaiyaa
Saafaan	saafaan
Hinkiyaa	hinKiyaa
Aahikam	aahiKam
Aasaaxyaa	aasaajyaa
Hunndaa	hunDaa
Kitclon	Kitglon
buonvsin	sin
Haamutaan	haamuTaan
Yelemi	yelemi
Lipvlaa	lipqlaa
Yehoyaakim	yehoyaaKim
Bendaayaa	peDaayaa
Yehoyaakin	yehoyaaKin
Ennaatan	ennaaTan
Sendekiyaa	sejDeKiyaa
Aanwatv	aanwatq
Matvsaax	matqsaaj
Gaataam	kaaTaam
Mitvsaa	mitqsaa
Anwaan	anwaan
Mbinhaan	Binhaan
Saaxwaan	saajwaan
Matvlekaa	matqleKaa
Makvndien	makqDien
Ilaam	ilaam
Beletv	peletq
Haamun	haamun
Etaan	eTaan
Hemaan	hemaan
Kaanko	KaanKo
Ndaanndaa	DaanDaa
Yete	yeTe
Segupc	sejkupg
Sammai	sammai
Aambihaain	aaBihaain
Itci	itgi
Sesan	sesan
Akclai	akglai
Saaxmbaatc	saajBaatg
Eleaasaax	eleaasaaj
Yekaamiyaa	yeKaamiyaa
Beletc	peletg
Efaa	efaa
Saaapc	saaapg
Qewaa	Qewaa
Simeaa	simeaa
Nogaa	nokaa
Selupvmbaamben	sejlupqBaaBen
Haananyaa	haananyaa
Mbelekiyaa	BeleKiyaa
Belaatiyaa	pelaaTiyaa
Yesaayaa	yesaayaa
Lefaiyaa	lefaiyaa
Sekaaniyaa	seKaaniyaa
Semaiaa	semaiaa
Hatvtatv	hatqTatq
Neaaliyaa	neaaliyaa
Elionai	elionai
Atclikam	atgliKam
Hondaawiyaa	hoDaawiyaa
Eliyaasipv	eliyaasipq
Belaiyaa	pelaiyaa
Akckupc	akgKupg
Yohaanan	yohaanan
Ndelaiyaa	Delaiyaa
Leaayaa	leaayaa
Yaahaatc	yaahaatg
Edaam	etaam
Itcmaa	itgmaa
Helaa	helaa
Baaseaa	paasejaa
Selaiaa	sejlaiaa
Etclaa	etglaa
Meletv	meletq
Efe	efe
Kenan	Kenan
Maahaalaalen	maahaalaalen
Enokv	enokq
Metuselaa	meTusejlaa
Noyaa	noyaa
Aalam	aalam
Qelaa	Qelaa
Isakc	isakg
Lotaan	loTaan
Ndison	Dison
Haandatc	haaDatg
Yundaa	yuDaa
Amminaandapc	amminaaDapg
Naason	naason
Sanxmon	sanjmon
Ombetc	oBetg
Jaai	Jaai
Sesan	sesan
Naatan	naaTan
Yehu	yehu
Ndaawitv	Daawitq
Lehoxmboam	lehojBoam
Aambiyaa	aaBiyaa
Aasaax	aasaaj
Aamaasiyaa	aamaasiyaa
Aasaaliyaa	aasaaliyaa
Aahatc	aahatg
Hesekiyaa	heseKiyaa
Ammon	ammon
Yehoyaakin	yehoyaaKin
Selupvmbaamben	sejlupqBaaBen
Yesaayaa	yesaayaa
Lefaiyaa	lefaiyaa
Ombaandi	oBaaDi
Semaiaa	semaiaa
Yaahaatc	yaahaatg
Maalesaa	maalesaa
Gendelaa	keDelaa
Nemuen	nemuen
Yaalipv	yaalipq
Sanlum	sanlum
Mipvsamx	mipqsamj
Sakcge	sakgke
Aayin	aayin
Yoen	yoen
Aasien	aasien
Aandien	aaDien
Zizaa	zizaa
Yendaayaa	yeDaayaa
Simli	simli
Mikaa	miKaa
Gileaatc	kileaatg
Mikaaen	miKaaen
Mbutc	Butg
Aahi	aahi
Elien	elien
Finehatc	finehatg
Aambiquwaa	aaBiQuwaa
Mbukcki	BukgKi
Utcsi	utgsi
Selaahiyaa	sejlaahiyaa
Selaahiyaa	sejlaahiyaa
Melaayotv	melaayotq
Aamaaliyaa	aamaaliyaa
Aamaaliyaa	aamaaliyaa
Saaxndokc	saajDokg
Hinkiyaa	hinKiyaa
Yehosaandakc	yehosaaDakg
Nembukatvnetvsaa	neBuKatqnetqsaa
Simxmaa	simjmaa
Yoaa	yoaa
Zelaa	zelaa
Enkaanaa	enKaanaa
Embiyaasaapc	eBiyaasaapg
Embiyaasaapc	eBiyaasaapg
Taahatc	Taahatg
Ulien	ulien
Utcsiyaa	utgsiyaa
Eliapc	eliapg
Yeloham	yeloham
Yeloham	yeloham
Simeaa	simeaa
Maahaatv	maahaatq
Aamaasaix	aamaasaij
Yoen	yoen
Sefanyaa	sejfanyaa
Atcsi	atgsij
Itchaa	itghaa
Kohaatv	Kohaatq
Lewi	lewi
Aasaapc	aasaapg
Aasaapc	aasaapg
Mbelekiyaa	BeleKiyaa
Mankiyaa	manKiyaa
Simxmaa	simjmaa
Geson	keson
Apcndi	apgDi
Manlukv	manlukq
Haasaabiyaa	haasaapiyaa
Haasaabiyaa	haasaapiyaa
Amsi	amsi
Amsi	amsi
Mbaani	Baani
Qeme	Qeme
maazli	maali
Melaali	melaali
Utcsi	utgsi
Melaayotv	melaayotq
Ndaambelatv	DaaBelatq
Puaa	Puaa
Yendiyaaen	yeDiyaaen
Yelimotv	yelimotq
Yelemotv	yelemotq
Aalemetv	aalemetq
Kenaaaanaa	Kenaaaanaa
Hupcbim	hupgpim
Supvbim	supqpim
Belaetv	pelctq
Ulaam	ulaam
Telaa	Telaa
Taahan	Taahan
Laandaan	laaDaan
Laandaan	laaDaan
Mankien	manKien
Yaafeletv	yaafeletq
Some	some
Hotaam	hoTaam
Sofaa	sojfaa
Mbese	Bese
Aalaa	aalaa
Atcndaa	atgDaa
Mesaa	mesaa
Enbaaan	enpaaan
Aahiyo	aahiyo
Saasakv	saasakq
Sembaandiyaa	sejBaaDiyaa
Ende	eDe
Yohaa	yohaa
Yaakim	yaaKim
Sinxletai	sinjleTai
Haanan	haanan
Yeien	yeien
Saulo	saulo
Biton	piTon
Melekv	melekq
Taalie	Taalia
Simxli	simjli
Mbineaa	Bineaa
Mbineaa	Bineaa
Eleaasaax	eleaasaaj
Aasen	aasen
Mbokelu	BoKelu
Seaaliyaa	seaaliyaa
Isaalaaen	isaalaaen
Yeuen	yeuen
Sanxlu	sanjlu
Hatcsenuaa	hatgsejnuaa
Elaa	elaa
Mesunlaam	mesunlaam
Sefaatiyaa	sefaaTiyaa
Leuen	leuen
Aandaayaa	aaDaayaa
Baatche	paatghe
Baatche	paatghe
Mankiyaa	manKiyaa
Imme	imme
Gaalaan	kaalaan
Matvtaaniyaa	matqTaaniyaa
Sikcli	sikgli
Yendutun	yeDuTun
Yendutun	yeDuTun
Mikvlotv	mikqlotq
Yembutc	yeButg
Belon	pelon
Sipcmbekai	sipgBeKai
Saaanmbon	saaanBon
Eliyaambaa	eliyaaBaa
Gimso	kimso
Haasem	haasem
Uaa	uaa
Itclai	itglai
Yaaaasien	yaaaasien
Semaaliyaa	semaaliyaa
Itcsiyaa	itgsiyaa
Aasaalen	aasaalen
Yaasombeam	yaasoBeam
kaav	Kaaq
kuatv	suv
nzuonx	Rwrnj
Aambiqai	aaBiQai
Silie	silia
Saadaan	saataan
namx	namj
Selomotv	selomotq
Gesom	kesom
Haalim	haalim
Miyaamin	miyaamin
Hakvkotc	hakqKotg
Yesuaa	yesuaa
Mbingaa	Binkaa
Hesi	hesi
Betaahiyaa	peTaahiyaa
Maaaasiyaa	maaaasiyaa
Yaaaasiyaa	yaaaasiyaa
Gendaaliyaa	keDaaliyaa
Matvtitiyaa	yeDuTun
Sembuen	seBuen
Haanaani	haanaani
Yehohaanan	yehohaanan
Hosaax	hosaaj
guanh	kwanb
hnyangx	Havj
Henndai	henDai
Elihu	elihu
Itcmaiaa	itgmaiaa
Aanki	aanKi
Saalomorn	saalomxn
lungz	luvd
Tailaqv	Tailaq
Yapvfaa	yapqfaa
kelumbim	KeluBim
yietc	yetg
bung	puv
longz	lovd
bunh	punb
Isaalaaen	isaalaaen
Saalomorn	saalomxn
Sekem	seKem
Yelomboam	yeloBoam
Maahaalatv	maahaalatq
Yelusaalem	yelusaalem
Yundaa	yuDaa
Ondetc	oDetg
buangv	pwavq
die	tia
Mbaaaaqaa	BaaaaQaa
Yehosaafatv	yehosaafatq
Netaaniyaa	neTaaniyaa
Tombiyaa	ToBiyaa
Yehosaambaatc	yehosaaBaatg
Aahapc	aahapg
baeqc	pcg
’	’
Yaahaasien	yaahaasien
Sekaaliyaa	se
Mbenaiyaa	se
dungx	tuvq
Aahatcyaa	aahatgyaa
Yeholam	yeholam
Yehien	yehien
Etiobie	eTiopia
Yolam	yolam
Yehu	yehu
gouv	kruq
Yehoyaandaa	yehoyaaDaa
hungh	huvb
Simeatc	simeatg
Yehoaatc	yehoaatg
Yekoliyaa	yeKoliyaa
zingh	zivb
Filisaadie	filisaatia
Aamortv	aamxtq
Ofen	ofen
Yotaam	yoTaam
Maaaaseaa	maaaasejaa
Mesinlemotv	mesinlemotq
baaux	paauj
diex	tiaj
camv	Zamq
hmz	Mmd
Maanatvse	maanatqsej
Aamon	aamon
zorc	zxg
dorngx	txvj
Yosaambaatc	yosaaBaatg
yungh	yuvb
Yoaahaatc	yoaahaatg
Yelemi	yelemi
Besie	pesia
Sailatv	sailatq
Lotc	lotg
Haanditc	haaDitg
Ono	ono
Senaaaa	sejnaaaa
Aantaasesitv	aanTaasesitq
Mitvlendaatc	mitqleDaatg
Ndaaliatc	Daaliatg
Hakvgai	hakqkai
Yiutai	yiuTai
Aahitupv	aahiTupq
Aambiquwaa	aaBiQuwaa
Eleaasaa	eleaasaa
Esaalaa	esaalaa
Aahaawaa	aahaawaa
heng	hev
Esaalaa	esaalaa
Sapvmbetai	sapqBeTai
Kelitaa	KeliTaa
Melemotv	melemotq
Matvtenai	matqTenai
Selemiyaa	selemiyaa
Haakaaliyaa	haaKaaliyaa
Nehaami	nehaami
Susaax	susaaj
hnamv	Namq
Sanxmbaanlatv	sanjBaanlatq
Tombiaa	ToBiaa
Gesem	kesem
Imli	imli
Mesesaamben	mesesaaBen
Yoyaandaa	yoyaaDaa
Haasapvneyaa	haasapqneyaa
Hatcsupv	hatgsupq
Hanlohetc	hanlohetg
Lehum	lehum
Sapcmbai	sapgBai
Mbaalukv	Baalukq
Hatcsupv	hatgsupq
Henaandatc	henaaDatg
Mbinnui	Binnwi
Baalaan	paalaan
Baalotv	paalotq
laanh	laanb
Tombiaa	ToBiaa
youc	yrug
Mondekai	moDeKai
Mbinsaan	Binsaan
Mbikcwai	Bikgwai
joih	Jxib
Katcmien	Katgmien
Qembaaniyaa	QeBaaniyaa
Mbunni	Bunni
Selebiyaa	selepiyaa
Hondiyaa	hoDiyaa
gen	ken
koiv	Kxiq
Ndaanien	Daanien
Ginneton	kinneTon
Batclotv	patglotq
Satctu	satgTu
Atcgaatc	atgkaatg
Mbembai	BeBai
Aandin	aaDin
Aate	aaTe
Haasum	haasum
Mbesai	Besai
Haalipv	haalipq
Yaatvnduwaa	yaatqDuwaa
Aanaayaa	aanaayaa
Sanxlai	sanjlai
Yoyaalipv	yoyaalipq
Atclikam	atgliKam
Sihaqc	sijhag
Seantien	seanTien
Yoyaakim	yoyaaKim
Yonaataan	yonaaTaan
Minyaamin	minyaamin
Aamokv	aamokq
Tanmon	Tanmon
Hosaayaa	hosaayaa
Matvtaaniyaa	matqTaaniyaa
Mikaayaa	miKaayaa
Eliyaakim	eliyaaKim
Aahaasuelatv	aahaasuelatq
Inndie	inDia
yinh	yinb
Watvqaati	watqQaaTi
haac	haag
Yekoniyaa	yeKoniyaa
Mondekai	moDeKai
Esete	eseTe
Esete	eseTe
Esete	eseTe
ndiux	Diuj
Haamaan	haamaan
Haamaan	haamaan
lamz	lamd
Haataakv	haaTaakq
Haataakv	haaTaakq
Kenndie	KenDia
mapv	mapq
zioux	zyruj
Lewiaataan	lewiaaTaan
henh	henb
sienh	syenb
huaax	Waaj
nqapc	Gapg
hlienx	Lyenj
mitc	mitg
yie’	yia’
nzuiz	Rwid
hlaax	Laaj
muonz	mwrnd
goh	kob
Quwaa	Quwaa
Mbinndatc	BinDatg
luangh	lwavb
louc	lrug
zimh	zimb
Naaaame	naaaame
toux	Truj
sung	suv
sux	suj
haangh	haavb
bioh	pyob
sienc	syeng
wuotv	wrtq
guaeqv	kwcq
nzunc	Rung
cien	Zyen
hoic	hxig
fapv	fapq
naanh	naanb
maqc	mag
mbieqv	Biaq
wangc	wavg
guenx	kwenj
hlorv	Lxq
nyaah	Eaab
mbeu	Beu
mbeu	Beu
nqorqv	Gxq
Yie	yia
gox	koj
Elihu	elihu
zueih	zweib
waac’	waag’
soqv	soq
yiemh	yemb
aaux	aauj
ndanc	Dang
hmatv	Matq
hlopv	Lopq
baamz	paamd
yienz	yend
doc	tog
horpc’	hxpg’
guinh	kwinb
guinh	kwinb
gingx	kivj
muangh	mwavb
lamz	lamd
komv	Komq
ndauc	Daug
caaiv	Zaaiq
nyaaiv	Eaaiq
Mbehemotv	Behemotq
diux	tiuj
cutv	Zutq
Selaa	selaa
Selaa	selaa
dorziec	txb
cienh	Zyenb
doh	tob
waac	waag
louh	lrub
zaaux	zaauj
taanx	Taanj
zuoqv	zuaq
liuz	liud
huangx	Wavj
goux	kruj
ziangh	zyavb
zuizmienh	myenb
corngh	Zxvb
wuotv	wrtq
Lembaanorn	leBaanxn
finx	finj
orqv	xq
dangxdonx	tonj
Haav	haaq
haav	haaq
mienz	myend
batv	patq
dunx	tunj
jiex	Jiaj
laic	laig
nyiemz	Eyemd
niouv	nyruq
nzioux	Ryruj
sinx	sinj
nyiex	Eiaj
hlopv	Lopq
nyuotv	Ewrtq
mbiaauz	Byaaud
maaz	maad
mbeux	Beuj
Gembaan	keBaan
buonx	pwrnj
tih	Tib
Aamen	aamen
mbeix	Beij
wuomlaangc	laavg
biopc	pyopg
Zienh	zyenb
nqaatv	Gaatq
laih	laib
Menkisendekc	menKiseDekg
Jorndaen	JxDcn
gaatv	kaatq
Yaakopv	yaaKopq
Efaataa	efaaTaa
singqiex	Qiaj
mbong	Bov
mun	mun
yaapv	yaapq
heiv	heiq
gorngvnjaaux	Faauj
youh	yrub
qopv	Qopq
nuqv	nuq
nyaangc	Eaavg
lorz	lxd
ndiepv	Dyepq
njoux	Fruj
lom	lom
div	tiq
fitv	fitq
taaih	Taaib
nyaanh	Eaanb
hngongx	Vovj
koi	Kxi
korqv	Kxq
Itien	iTien
Itien	iTien
muangx	mwavj
nyei	Eei
saaux	saauj
laengz	lcvd
Saalon	saalon
Janxmuangz	Janb
horqc	hxg
horqc	hxg
jiuc	Jiug
jiuc	Jiug
mbaiv	Baiq
anman	anman
nyueiz	Eweid
sicdorngh	txvb
bingxciouv	Zyruq
biauvhuaang	Waav
wuomdomh	tomb
zuonx	zwrnj
Ndaamatvgatc	Daamatqkatg
fiuv	muvd
Efaaim	efaaim
baengcngaaiz	vaaid
ndiangxndonx	Donj
Mbaambilon	BaaBilon
Moapc	moapg
Aan	aan
dorv	txq
Naiaa	naiaa
mbatc	Batg
Iyipv	iyipq
Atcsilie	atgsilia
maaic	myenb
doix	txij
Sepvnaa	sepqnaa
laihnaangx	Naavj
Aalien	aalien
Aalien	aalien
zipv	zipq
mborngx	Bxvj
Sou	sru
nziaauxjieqv	Jiaq
Sion	sion
kuh	Kub
guoqv	kuaq
Isaayaa	isaayaa
Saibatc	saipatg
huox	huaj
nyim	Eim
faangensen	Zauj
biouvjoih	Jxib
pitv	Pitq
aqv’	aq’
lozgaeng	kcv
hienx	Yenj
liemh	lyemb
zunx	zunj
nin	nin
nie	nia
Mbaaan	Baaan
buozzaux	zauj
Mankiaa	manKiaa
Yosiyaa	yosiyaa
sindaa	sijDaa
guaatv	kwaatq
Atckelon	atgKelon
zuangx	zwavj
Uliaa	uliaa
Gemaaliyaa	kemaaliyaa
Kolaayaa	Kolaayaa
Nehelaam	nehelaam
Sefanyaa	sejfanyaa
bungxzuoqc	puvb
njaaux	Faauj
Sendekiyaa	sejDeKiyaa
Kenndie	KenDia
qongx	Qovj
Neliyaa	neliyaa
Mbaalukv	Baalukq
gorqvmienh	kxg
Koniyaa	Koniyaa
Yehukan	yehuKan
Mbenyaamin	Benyaamin
Matvtaan	matqTaan
buov	puaq
Kaaleaa	Kaaleaa
Tanhumetv	Tanhumetq
Kaaleaa	Kaaleaa
Gendaaliyaa	keDaaliyaa
binc	ping
Taabaanhetc	Taapaanhetg
Memfitv	memfitq
hliouv	Lyruq
Kiliyaataaim	KiliyaaTaaim
Ndimbon	DiBon
njangx	Favj
Endom	eDom
Endom	eDom
ndui	Dwi
ndin	Din
forngcang	fxvb
ndongc	Jopg
fungx	fuvj
Mbaambilon	BaaBilon
zemh	zemb
mbiouh	Byrub
hlengx	Levj
Nembukatvnetvsaa	neBuKatqnetqsaa
zunc	zung
ziex	ziaj
meuz	meud
njapc	Fapg
buonvguoqv	pwrnb
ziqv	ziq
hopv	hopq
saenghmz	scvb
Yiem	yem
Kembaa	KeBaa
Yaaaasanyaa	yaaaasanyaa
caeng	Zcv
luijuoqv	lwib
diev	tiaq
hungh	huvb
kuv	Kuq
paiv	Paiq
tapv	Tapq
Oholaa	oholaa
Oholimbaa	oholiBaa
baaic	paaig
Etiobie	eTiopia
On	on
saengcietv	scvb
njoqc	Fog
mbengx	Bevj
mievciangv	miab
yangh	yavb
Gokc	kokg
Gokc	aab
zaangh	txvj
singx	sivj
home	home
horc	hxg
Ndaanien	Daanien
lai	lai
mbeix	Beij
Mbentesatvsaa	BenTesatqsaa
Satvlakv	satqlakq
Mesaakv	mesaakq
Aambetcnego	aaBetgneko
Aambetcnego	aaBetgneko
hnyouv	Hruq
Mbensatvsaa	Bensatqsaa
daix	taij
Mene	mene
Teken	TeKen
Baasin	paasin
dauh	taub
Gaambelien	kaaBelyen
tiux	Tiuj
Hoseyaa	hoseyaa
limh	limb
Aamotv	aamotq
Aamotv	aamotq
Keliotc	Keliotg
civ	Ziq
liv	liq
Gingaan	kinkaan
muangv	mwavq
Finisie	finisia
Saaxlefatv	saajlefatq
Yonaa	yonaa
Yonaa	yonaa
Ninaawe	ninaawe
ngorngz	vxvd
nqanx	Ganj
ndunh	Dunb
bieivzeiv	pyeib
Naahum	naahum
Limbie	liBia
nyorx	Exj
Haambaagukc	haaBaakukg
puotv	Pwrtq
Kusi	Kusi
ziangv	zyavq
Minkom	minKom
jaaihorngc	hxvg
njanglaangc	Favb
Yosuwaa	yosuwaa
nqaaix	Gaaij
fingx	fivj
seix	seij
caidoix	Zaib
duqv	log
Beletv	peletq
Hetvlon	hetqlon
Laam	laam
Mboaatc	Boaatg
Jetcsi	Jyetgsi
Eliyaakim	eliyaaKim
Yosepv	yosepq
Maaliyaa	maaliyaa
Maaliyaa	maaliyaa
Yesu	yesu
Yesu	yesu
Giduc	kitug
Yesu	yesu
Imaanuen	imaanuen
eix	eij
Helotv	helotq
Yundie	yuDia
Naasaaletv	naasaaletq
Naasaaletv	naasaaletq
Yohan	yohan
Yohan	yohan
Yohan	yohan
nzopc	Ropg
Dornhnamv	txnb
Sembendi	sejBeDi
Yaagorpc	yaakxpg
Totvmbuli	TotqBuli
nqopv	Gopq
baaih	paaib
nyuoqc	Euag
gilo	kilo
bou	pru
hlaau	Laau
ngaengv	vcvq
ngaengv	vcvq
dungz	tuvd
dungz	tuvd
dungz	tuvd
kamx	Kamj
Filipv	filipq
Mbaatolomiu	BaaTolomiu
Tomatv	Tomatq
Matvtaai	matqTaai
Anfeatc	anfeatg
Tatvndeatc	TatqDeatg
Simon	simon
Yundaatc	yuDaatg
Isaakaaliotc	isaaKaaliotg
nyeic	Eeig
ciouh	Zyrub
dunc	tung
doqc	tog
heng	hev
Faalisi	faalisij
Faalisi	faalisij
mienv	myenq
Mbeensembun	BeenseBun
Saadaan	saataan
laengc	lcvg
Helondietc	heloDyetg
Yesu	yesu
mbiauzdorn	txn
Saandusi	saaDusij
Saandusi	saaDusij
Bide	pite
Bide	pite
Saigorx	saib
juov	Juaq
saa	saa
Mbetaani	BeTaani
Sisaa	sisaa
dauh’	taub’
Giduc	kitug
Haaz	haad
Kaayaafaatv	Kaayaafaatq
aex	cj
Bide	pite
Lomaa	lomaa
Bilaatv	pilaatq
Yundaatc	yuDaatg
Bilaatv	pilaatq
Bilaatv	pilaatq
Mbaalapvmbatc	BaalapqBatg
Mbaalapvmbatc	BaalapqBatg
guatc	kwatg
Sailin	sailin
Simon	simon
Eli	eli
laamaasaambakctaani	laamaasaaBakgTaani
Makvndaalaa	makqDaalaa
Anndaalu	anDaalu
Kaabenaaum	Kaapenaaum
Yesu	yesu
guaiv	kwaiq
nqomz	Gomd
laangz	laavd
Helotv	helotq
mbomz	Bomd
Mbetcsaindaa	BetgsaiDaa
Mose	mose
Hosaanaa	hosaanaa
Lomaa	lomaa
Aalekvsaannde	aalekqsaanDe
Lufatv	lufatq
Matvtatv	matqTatq
Matvtatv	matqTatq
Menki	menKi
Menki	menKi
Matvtaatiatc	matqTaaTiatg
Matvtaatiatc	matqTaaTiatg
Eaa	eaa
Simeon	simeon
Apclaaham	apglaaham
Naaho	naaho
Selukv	sejlukq
Leu	leu
Belekv	pelekq
Embe	eBe
Aanfaasatv	aanfaasatq
Laamekv	laamekq
Yaaletv	yaaletq
Enotv	enotq
Aandam	aaDam
Gelaasaa	kelaasaa
Yailatv	yailatq
ciou	Zyru
Saamaalie	saamaalia
biauvziouv	pyaub
Maataa	maaTaa
ndaangh	Daavb
Gaalili	kaalili
Siloam	sijloam
bungx	puvj
waanc	waang
houc	hrug
cuqv	’
zaeqvdaan	taan
Laasaalatv	laasaalatq
Sakckietv	sakgKyetq
’	’
siqc	sig
nyomx	Eomj
Helotv	helotq
kih	Kib
kaatv	Kaatq
ndanh	Danb
Filipv	filipq
Naataanaaen	naaTaanaaen
Nikondematv	niKoDematq
lingh	livb
Yiutai	yiuTai
Kaanaa	Kaanaa
ngih	vib
sungx	suvj
sapv	sapq
mbor	Bx
Laasaalatv	laasaalatq
Laasaalatv	laasaalatq
Maataa	maaTaa
paaiv	Paaiq
Yundaatc	yuDaatg
sienx	syenj
laanh	laanb
hiuv	hiuq
Annaatv	annaatq
Aanaanie	aanaania
Aanaanie	aanaania
tim	Tim
Saatefen	saaTefen
Antiokc	anTiokg
Nikolau	niKolau
dapc	tapg
Saulo	saulo
Aineatc	aineatg
Litvndaa	litqDaa
samh	samb
Koneliatc	Koneliatg
Koneliatc	Koneliatg
Sisaaliyaa	sisaaliyaa
Mbaanaambatc	BaanaaBatg
Mbaanaambatc	BaanaaBatg
Taasatv	Taasatq
ziuh	ziub
Maako	maaKo
Baulo	paulo
Baulo	paulo
Ikoniyum	iKoniyum
Hemetv	hemetq
Begaa	pekaa
Silaa	silaa
Maasindonie	maasiDonia
Baulo	paulo
Silaa	silaa
Tesaalonigaa	Tesaalonikaa
Yaasonx	yaasonj
Aaten	aaTen
Timotai	TimoTai
fiou	fyru
Kolinto	KolinTo
Kaalitvbatc	Kaalitqpatg
Ganlio	kanlio
Aakaayaa	aaKaayaa
Efeso	efeso
Bitcsinxlaa	pitgsinjlaa
Aakuinlaa	aaKwinlaa
Aaborlo	aapxlo
Aantemitv	aanTemitq
Esie	esia
Ndemetvliatc	Demetqliatg
Mbeloaa	Beloaa
Aalitvtaakatv	aalitqTaaKatq
Gaaiatc	kaaiatg
Tikigatc	TiKikatg
Dofimatv	tofimatq
Doatc	toatg
Silisie	silisia
Felikv	felikq
Felikv	felikq
Kaalaaundiatc	KaalaauDiatg
Lisietv	lisyetq
Fesaatatv	fesaaTatq
Fesaatatv	fesaaTatq
Aanqipaa	aaGiPaa
Aanqipaa	aaGiPaa
congh	Zovb
Apclaaham	apglaaham
Giduc	kitug
Aa	aa
Saaben	saapen
Lusiatc	lusiatg
Saatefaanatv	saaTefaanatq
Aaborlo	aapxlo
zaanc	zaang
nouh	nrub
hnomv	Nomq
Maasindonie	maasiDonia
Giduc	kitug
Tidatc	Titatg
Tidatc	Titatg
zoqc	zog
tengx	Tevj
ceng	Zev
fuqv	fuq
hnamv	Namq
Ebaafaa	epaafaa
Laundisie	lauDisia
sin	sin
zoux	zruj
naanh	naanb
mbuo	Bua
Himeneatc	himeneatg
lorx	lxj
fiem	fyem
nzaeng	Rcv
Ndemaatv	Demaatq
Gaalaatie	kaalaaTia
Lugaa	lukaa
Onesifolatv	onesifolatq
Elatvtatv	elatqTatq
Miletatv	mileTatq
suonc	swrng
Filemon	filemon
Onesimatv	onesimatq
Saalem	saalem
nziaamv	Ryaamq
Mose	mose
nyei	Eei
ganh	kanb
laamh	laamb
Mbaalaaam	Baalaaam
Kaain	Kaain
Kolaa	Kolaa
mauv	mauq
gouv	kruq
mbopv	Bopq
ye	ເຢ
su	ຊູ
maaz	maa
li	li
aandam	aadam
kaain	kaain
aambaen	aabcn
enden	tov
aandaa	aadaa
maahaalaalen	maahaalaalen
metuselaa	metusejlaa
kaanaaan	kaanaaan
gome	kome
maandai	maadai
tumban	tuban
atckenatv	atgkenatq
togaanmaa	tokaanmaa
eliseaa	eliseaa
kitvtim	kitqtim
londaanim	lodaanim
iyipv	iyipq
sembaa	sejbaa
haawilaa	haawilaa
sapctaa	sapgtaa
laaaamaa	laaaamaa
sapctekaa	sapgtekaa
qembaa	qebaa
ndendaan	dedaan
ninaawe	ninaawe
lundim	ludim
aanaamim	aanaamim
lehaambim	lehaabim
napvtuhim	napqtuhim
atcsu	atgsu
aanfaasatv	aanfaasatq
lunde	lude
gete	kete
embe	ebe
yokvtaan	yokqtaan
anmondatc	anmodatg
haasaanmaawetv	haasaanmaawetq
haandolam	haadolam
ndikclaa	dikglaa
aambimaaen	aabimaaen
yombapc	yobapg
mbaamben	baaben
leu	leu
naaho	naaho
apclaam	apglaam
mbetcen	betgen
sondom	sojdom
gomolaa	komolaa
atcmaa	atgmaa
semboyim	sejboyim
soaa	sojaa
aamaalekv	aamaalekq
aamolai	aamolai
sitcndim	sitgdim
ndaamatvgatc	daamatqkatg
kendolaaome	kedolaaome
aane	aane
etcko	etgko
eliyese	eliyese
apclaaham	apglaaham
hitvtai	hitqtai
belitvsi	pelitqsi
lefaaim	lefaaim
isaamaaen	isaamaaen
gelaaaa	kelaaaa
aambimelekv	aabimelekq
isakc	isakg
mbeeqembaa	beeqebaa
mbetuen	betuen
lembekaa	lebekaa
hembolon	hebolon
sohaax	sojhaaj
efolon	efolon
laambaan	laabaan
ketulaa	ketulaa
yokvsaan	yokqsaan
mitvmaa	mitqmaa
haandatc	haadatg
kendemaa	kedemaa
filisaadie	filisaatia
mbeeli	beeli
mbaasematv	baasejmatq
laambaan	laabaan
mbinhaa	binhaa
leaa	leaa
napvtaali	napqtaali
sinxbaa	sinjpaa
ndundaaim	dudaaim
isaalaaen	isaalaaen
sei	seji
simeon	simeon
efaalaataa	efaalaataa
mbenyaamin	benyaamin
aase	aase
elifatv	elifatq
leuen	leuen
naahatc	naahatg
yeutc	yeutg
oholimbaamaa	oholibaamaa
endom	edom
sombaan	sobaan
maanaahaatv	maanaahaatq
embaan	ebaan
etcmbaan	etgbaan
itclaan	itglaan
ese	ese
simbeon	sibeon
endom	edom
ndinhaambaa	dinhaabaa
mbosaalaa	bosaalaa
mbendatc	bedatg
moapc	moapg
mindien	midyen
samxlaa	samjlaa
lehoxmbotc	lehojbotg
saaun	saaun
akcmbo	akgbo
mipvsaa	mipqsaa
lumben	luben
yundaa	yudaa
quaa	quaa
eaa	eaa
hipvlu	hipqlu
naiaa	naiaa
hetvlon	hetqlon
yemuen	yemuen
ohaatc	ohaatg
kohaatv	kohaatq
melaali	melaali
itcsaaxkaa	itgsaajkaa
sembulun	sejbulun
yaaleen	yaaleen
hakvgi	hakqki
etcmbon	etgbon
elei	elei
aaleli	aaleli
itcwaa	itgwaa
itcwi	itgwi
mbeliyaa	beliyaa
selaaaa	selaaaa
hembe	hebe
atcmben	atgben
naaaamaan	naaaamaan
yaasien	yaasien
maanatvse	maanatqsej
efaaim	efaaim
jorndaen	jxdcn
lipvni	lipqni
simei	simei
itchaa	itghaa
sikcli	sikgli
utcsien	utgsien
misaaen	misaaen
ensaafaan	ensaafaan
naandapc	naadapg
itaamaa	itaamaa
atcsi	atgsij
enkaanaa	enkaanaa
eleaasaa	eleaasaa
finehatc	finehatg
sukckotv	sukgkotq
aambipc	aabipg
lefindim	lefidim
huaa	huaa
yosuwaa	yosuwaa
aambihu	aabihu
kelumbim	kelubim
mbesaalen	besaalen
yembutc	yebutg
oholiapc	oholiapg
selomitv	selomitq
suxlisatvndai	sujlisatqdai
selumien	selumien
amminaandapc	amminaadapg
zuaa	zuaa
netanen	netanen
eliapc	eliapg
ammihutv	ammihutq
elisaamaa	elisaamaa
bendaasu	pedaasu
gaamaalien	kaamaalien
gindeoni	kideoni
aambindan	aabidan
aahiyese	aahiyese
baagien	paakien
ndeuen	deuen
eliyaasaapc	eliyaasaapg
aahilaa	aahilaa
elisaafaan	elisaafaan
maanaa	maanaa
sakcge	sakgke
sammuwaa	sammuwaa
yefunne	yefunne
igaan	ikaan
hoseyaa	hoseyaa
mikaaen	mikaaen
aambilam	aabilam
melimbaa	melibaa
kaandetc	kaadetg
hoaa	hoaa
sihonx	sihonj
hetvmbon	hetqbon
sipcbo	sipgpo
mbaalaaam	baalaaam
mbaaan	baaan
mbeo	beo
beo	peo
simxli	simjli
kotvmbi	kotqbi
suxaa	sujaa
otcni	otgni
atclien	atglien
semindaa	semidaa
selofehatc	sejlofehatg
maahaalaa	maahaalaa
hokvlaa	hokqlaa
tilaasaa	tilaasaa
suham	suham
gileaatc	kileaatg
maakile	maakile
aambaalim	aabaalim
lembaa	lebaa
mikvndon	mikqdon
lipvnaa	lipqnaa
taahatc	taahatg
yotvmbaataa	yotqbaataa
ombotc	obotg
nembo	nebo
atcmon	atgmon
mendidelenien	meditelenyen
sendatc	sejdatg
mbukcki	bukgki
hannien	hannien
kemuen	kemuen
bantien	pantien
aahihutv	aahihutq
endeni	edeni
atctaalotv	atgtaalotq
yaahaatv	yaahaatq
aangopc	aankopg
saindorn	saidxn
aalaambaa	aalaabaa
bitcgaa	pitgkaa
gelisim	kelisim
laahapc	laahapg
gingaan	kinkaan
yeliko	yeliko
sapcndi	sapgdi
gimbeon	kibeon
mbeelotv	beelotq
yelusaalem	yelusaalem
ekclon	ekglon
ndembi	debi
aasekaa	aasekaa
makvkendaa	makqkedaa
aiyaalon	aiyaalon
yaambin	yaabin
maandon	maadon
akcsaapv	akgsaapq
mitvbaa	mitqpaa
aandunlam	aadunlam
tapvbuwaa	tapqpuwaa
megitcndo	mekitgdo
kendetc	kedetg
yokvneam	yokqneam
maaaakaa	maaaakaa
saaxlekaa	saajlekaa
kendemotv	kedemotq
mefaaaatc	mefaaaatg
mbaaaalaa	baaaalaa
timnaahaa	timnaahaa
akcsaax	akgsaaj
otcnien	otgnien
sipcaa	sipgaa
mbeaalotv	beaalotq
molaandaa	molaadaa
entolatv	entolatq
sikclaakv	sikglaakq
matvmannaa	matqmannaa
mbotckaatv	botgkaatq
ete	ete
atcnaa	atgnaa
etctemoaa	etgtemoaa
maaon	maaon
yitvleen	yitqleen
gendo	kedo
aataalotv	aataalotq
naaaalaa	naaaalaa
apcwim	apgwim
ofaalaa	ofaalaa
kision	kision
embetc	ebetg
kinneletv	kinneletq
etctaaon	etgtaaon
ekolon	ekolon
enteke	enteke
gipcmbeton	kipgbeton
mbaaaalatv	baaaalatq
aahimaan	aahimaan
akcsipv	akgsipq
lehopc	lehopg
ehutv	ehutq
ndembolaa	debolaa
aambinoam	aabinoam
taambo	taabo
siselaa	sisejlaa
gindeon	kideon
yoaatc	yoaatg
aambiyese	aabiyese
zembaa	zebaa
sanxmunnaa	sanjmunnaa
benuen	penuen
mbee	bee
sembun	sejbun
gaaan	kaaan
tembetc	tebetg
jaai	jaai
yepvtaa	yepqtaa
aaloe	aaloe
mbetclehem	betglehem
bilaaton	pilaaton
apcndon	apgdon
maanoaa	maanoaa
saemsanx	scmsanj
ndelilaa	delilaa
laaitc	laaitg
gimbeaa	kibeaa
naaomi	naaomi
elimelekv	elimelekq
lute	lute
kilion	kilion
mboaatc	boaatg
sanxmon	sanjmon
ombetc	obetg
jetcsi	jyetgsi
beninnaa	peninnaa
saamuen	saamuen
atcndotc	atgdotg
aambinaandapc	aabinaadapg
yaambetc	yaabetg
naahaatc	naahaatg
mikvmaatv	mikqmaatq
suan	suan
yonaataan	yonaataan
aahiyaa	aahiyaa
apcne	apgne
aambien	aabien
goliatc	koliatg
saaaalaaim	saaaalaaim
aahimelekv	aahimelekq
ndoekc	doekg
aahitupv	aahitupq
aambiyaataa	aabiyaataa
keilaa	keilaa
naambaan	naabaan
aambigaayin	aabikaayin
aahinoam	aahinoam
seluyaa	sejluyaa
yoaapc	yoaapg
aambiqai	aabiqai
ginmboaa	kinboaa
keleti	keleti
yaatvti	yaatqti
yelaameen	yelaameen
itcmbosetv	itgbosetq
maahaanaaim	maahaanaaim
aasaaxhen	aasaajhen
aandoniyaa	aadoniyaa
hakvgitc	hakqkitg
sefaatiyaa	sefaatiyaa
gitctaaim	kitgtaaim
mbaaaanaa	baaaanaa
saalomorn	saalomxn
ipchaa	ipghaa
elisuwaa	elisuwaa
eliyaandaa	eliyaadaa
elifeletv	elifeletq
gembaa	kebaa
utcsaa	utgsaa
sindaa	sijdaa
sombaa	sojbaa
haandatcese	haadatgese
yufeditc	yufetitg
yehoyaandaa	yehoyaadaa
mbenaiyaa	benaiyaa
simbaa	sibaa
mefimbosetv	mefibosetq
mbatcqembaa	batgqebaa
uliaa	uliaa
lapvmbaa	lapqbaa
apcsaalom	apgsaalom
yonaandapc	yonaadapg
tekoaa	tekoaa
itctai	itgtai
saaxndokc	saajdokg
aahimaaatc	aahimaaatg
aahitofen	aahitofen
mbaasinlai	baasinlai
aamaasaax	aamaasaaj
mbikcli	bikgli
ilaa	ilaa
aiaa	aiaa
litvbaa	litqpaa
simehaa	simehaa
aahoxhai	aahojhai
ndondo	dodo
enhaanan	enhaanan
heletvte	heletqte
ikcketc	ikgketg
aanaatotv	aanaatotq
netofaa	netofaa
maahaalai	maahaalai
limbai	libai
gaaatc	kaaatg
mbaahulim	baahulim
atcmaawetv	atgmaawetq
aahiyam	aahiyam
hetvlo	hetqlo
naahaalai	naahaalai
itclai	itglai
uliyaa	uliyaa
aalaaunaa	aalaaunaa
aambiqaakv	aabiqaakq
aasaaliyaa	aasaaliyaa
aahilutv	aahilutq
itcndo	itgdo
yehosaafatv	yehosaafatq
lembaanorn	lebaanxn
aandonilam	aadonilam
sion	sion
gaalili	kaalili
taabenetv	taapenetq
yelomboam	yeloboam
lehoxmboam	lehojboam
aambiyaa	aabiyaa
nembatc	nebatg
aambiyam	aabiyam
aambiqaalom	aabiqaalom
mbaaaaqaa	baaaaqaa
saamaalie	saamaalia
aahapc	aahapg
aaselaa	aaselaa
eliyaa	eliyaa
ombaandi	obaadi
yesemben	yeseben
yehu	yehu
elisaa	elisaa
haasaaen	haasaaen
naambotc	naabotg
mikaayaa	mikaayaa
aahatcyaa	aahatgyaa
sinhi	sinhi
aasumbaa	aasubaa
yeholam	yeholam
gehaasi	kehaasi
yehoaahaatc	yehoaahaatg
aataaliyaa	aataaliyaa
yehoaatc	yehoaatg
aamaasiyaa	aamaasiyaa
sekaaliyaa	sejkaaliyaa
utcsiyaa	utgsiyaa
gaandi	kaadi
menaahem	menaahem
atcsilie	atgsilia
bekaahiyaa	pekaahiyaa
lemaaliyaa	lemaaliyaa
aahatc	aahatg
kiaa	kiaa
mindie	midia
mbaambilon	baabilon
sefaanwaaim	sejfaanwaaim
hesekiyaa	hesekiyaa
sennaakelipv	sennaakelipq
isaayaa	isaayaa
ipcwaa	ipgwaa
yosiyaa	yosiyaa
aandaayaa	aadaayaa
mesunlaam	mesunlaam
aasaalaiyaa	aasaalaiyaa
hinkiyaa	hinkiyaa
aahikam	aahikam
aasaaxyaa	aasaajyaa
hunndaa	hundaa
kitclon	kitglon
haamutaan	haamutaan
yelemi	yelemi
lipvlaa	lipqlaa
yehoyaakim	yehoyaakim
bendaayaa	pedaayaa
yehoyaakin	yehoyaakin
ennaatan	ennaatan
sendekiyaa	sejdekiyaa
matvsaax	matqsaaj
mitvsaa	mitqsaa
mbinhaan	binhaan
saaxwaan	saajwaan
matvlekaa	matqlekaa
makvndien	makqdien
ilaam	ilaam
ndaanndaa	daandaa
yete	yete
aambihaain	aabihaain
itci	itgi
akclai	akglai
saaxmbaatc	saajbaatg
eleaasaax	eleaasaaj
yekaamiyaa	yekaamiyaa
efaa	efaa
saaapc	saaapg
simeaa	simeaa
selupvmbaamben	sejlupqbaaben
haananyaa	haananyaa
mbelekiyaa	belekiyaa
belaatiyaa	pelaatiyaa
yesaayaa	yesaayaa
lefaiyaa	lefaiyaa
sekaaniyaa	sekaaniyaa
semaiaa	semaiaa
hatvtatv	hatqtatq
neaaliyaa	neaaliyaa
elionai	elionai
atclikam	atglikam
hondaawiyaa	hodaawiyaa
eliyaasipv	eliyaasipq
belaiyaa	pelaiyaa
akckupc	akgkupg
yohaanan	yohaanan
ndelaiyaa	delaiyaa
leaayaa	leaayaa
yaahaatc	yaahaatg
itcmaa	itgmaa
baaseaa	paasejaa
selaiaa	sejlaiaa
etclaa	etglaa
maahaalaalen	maahaalaalen
metuselaa	metusejlaa
isakc	isakg
haandatc	haadatg
yundaa	yudaa
amminaandapc	amminaadapg
sanxmon	sanjmon
ombetc	obetg
jaai	jaai
yehu	yehu
lehoxmboam	lehojboam
aambiyaa	aabiyaa
aamaasiyaa	aamaasiyaa
aasaaliyaa	aasaaliyaa
aahatc	aahatg
hesekiyaa	hesekiyaa
yehoyaakin	yehoyaakin
selupvmbaamben	sejlupqbaaben
yesaayaa	yesaayaa
lefaiyaa	lefaiyaa
ombaandi	obaadi
semaiaa	semaiaa
yaahaatc	yaahaatg
maalesaa	maalesaa
gendelaa	kedelaa
nemuen	nemuen
mipvsamx	mipqsamj
sakcge	sakgke
yoen	yoen
aasien	aasien
aandien	aadien
yendaayaa	yedaayaa
gileaatc	kileaatg
mikaaen	mikaaen
aahi	aahi
elien	elien
finehatc	finehatg
aambiquwaa	aabiquwaa
mbukcki	bukgki
utcsi	utgsi
selaahiyaa	sejlaahiyaa
selaahiyaa	sejlaahiyaa
melaayotv	melaayotq
aamaaliyaa	aamaaliyaa
aamaaliyaa	aamaaliyaa
saaxndokc	saajdokg
hinkiyaa	hinkiyaa
yehosaandakc	yehosaadakg
nembukatvnetvsaa	nebukatqnetqsaa
simxmaa	simjmaa
yoaa	yoaa
enkaanaa	enkaanaa
embiyaasaapc	ebiyaasaapg
embiyaasaapc	ebiyaasaapg
taahatc	taahatg
ulien	ulien
utcsiyaa	utgsiyaa
eliapc	eliapg
yeloham	yeloham
yeloham	yeloham
simeaa	simeaa
maahaatv	maahaatq
aamaasaix	aamaasaij
yoen	yoen
sefanyaa	sejfanyaa
atcsi	atgsij
itchaa	itghaa
kohaatv	kohaatq
mbelekiyaa	belekiyaa
mankiyaa	mankiyaa
simxmaa	simjmaa
apcndi	apgdi
haasaabiyaa	haasaapiyaa
haasaabiyaa	haasaapiyaa
melaali	melaali
utcsi	utgsi
melaayotv	melaayotq
ndaambelatv	daabelatq
puaa	puaa
yendiyaaen	yediyaaen
yelimotv	yelimotq
yelemotv	yelemotq
aalemetv	aalemetq
kenaaaanaa	kenaaaanaa
hupcbim	hupgpim
supvbim	supqpim
taahan	taahan
laandaan	laadaan
laandaan	laadaan
mankien	mankien
yaafeletv	yaafeletq
some	some
atcndaa	atgdaa
enbaaan	enpaaan
aahiyo	aahiyo
sembaandiyaa	sejbaadiyaa
ende	ede
yohaa	yohaa
sinxletai	sinjletai
yeien	yeien
simxli	simjli
mbineaa	bineaa
mbineaa	bineaa
eleaasaax	eleaasaaj
mbokelu	bokelu
seaaliyaa	seaaliyaa
isaalaaen	isaalaaen
yeuen	yeuen
sanxlu	sanjlu
hatcsenuaa	hatgsejnuaa
mesunlaam	mesunlaam
sefaatiyaa	sefaatiyaa
leuen	leuen
aandaayaa	aadaayaa
baatche	paatghe
baatche	paatghe
mankiyaa	mankiyaa
matvtaaniyaa	matqtaaniyaa
sikcli	sikgli
yendutun	yedutun
yendutun	yedutun
mikvlotv	mikqlotq
yembutc	yebutg
sipcmbekai	sipgbekai
saaanmbon	saaanbon
eliyaambaa	eliyaabaa
uaa	uaa
itclai	itglai
yaaaasien	yaaaasien
semaaliyaa	semaaliyaa
itcsiyaa	itgsiyaa
aasaalen	aasaalen
yaasombeam	yaasobeam
aambiqai	aabiqai
selomotv	selomotq
miyaamin	miyaamin
hakvkotc	hakqkotg
yesuaa	yesuaa
mbingaa	binkaa
betaahiyaa	petaahiyaa
maaaasiyaa	maaaasiyaa
yaaaasiyaa	yaaaasiyaa
gendaaliyaa	kedaaliyaa
matvtitiyaa	yedutun
sembuen	sebuen
haanaani	haanaani
yehohaanan	yehohaanan
henndai	hendai
elihu	elihu
itcmaiaa	itgmaiaa
saalomorn	saalomxn
yapvfaa	yapqfaa
kelumbim	kelubim
isaalaaen	isaalaaen
saalomorn	saalomxn
yelomboam	yeloboam
maahaalatv	maahaalatq
yelusaalem	yelusaalem
yundaa	yudaa
ondetc	odetg
mbaaaaqaa	baaaaqaa
yehosaafatv	yehosaafatq
netaaniyaa	netaaniyaa
tombiyaa	tobiyaa
yehosaambaatc	yehosaabaatg
aahapc	aahapg
yaahaasien	yaahaasien
sekaaliyaa	se
mbenaiyaa	se
aahatcyaa	aahatgyaa
yeholam	yeholam
yehien	yehien
etiobie	etiopia
yehu	yehu
yehoyaandaa	yehoyaadaa
simeatc	simeatg
yehoaatc	yehoaatg
yekoliyaa	yekoliyaa
filisaadie	filisaatia
maaaaseaa	maaaasejaa
mesinlemotv	mesinlemotq
maanatvse	maanatqsej
yosaambaatc	yosaabaatg
yoaahaatc	yoaahaatg
yelemi	yelemi
haanditc	haaditg
senaaaa	sejnaaaa
aantaasesitv	aantaasesitq
mitvlendaatc	mitqledaatg
ndaaliatc	daaliatg
hakvgai	hakqkai
aahitupv	aahitupq
aambiquwaa	aabiquwaa
eleaasaa	eleaasaa
esaalaa	esaalaa
aahaawaa	aahaawaa
esaalaa	esaalaa
sapvmbetai	sapqbetai
kelitaa	kelitaa
melemotv	melemotq
matvtenai	matqtenai
selemiyaa	selemiyaa
haakaaliyaa	haakaaliyaa
nehaami	nehaami
sanxmbaanlatv	sanjbaanlatq
tombiaa	tobiaa
mesesaamben	mesesaaben
yoyaandaa	yoyaadaa
haasapvneyaa	haasapqneyaa
hatcsupv	hatgsupq
hanlohetc	hanlohetg
lehum	lehum
sapcmbai	sapgbai
hatcsupv	hatgsupq
henaandatc	henaadatg
tombiaa	tobiaa
mondekai	modekai
mbikcwai	bikgwai
katcmien	katgmien
qembaaniyaa	qebaaniyaa
selebiyaa	selepiyaa
hondiyaa	hodiyaa
ndaanien	daanien
ginneton	kinneton
batclotv	patglotq
satctu	satgtu
atcgaatc	atgkaatg
mbembai	bebai
aandin	aadin
aate	aate
yaatvnduwaa	yaatqduwaa
aanaayaa	aanaayaa
sanxlai	sanjlai
yoyaalipv	yoyaalipq
atclikam	atglikam
sihaqc	sijhag
seantien	seantien
yoyaakim	yoyaakim
yonaataan	yonaataan
minyaamin	minyaamin
hosaayaa	hosaayaa
matvtaaniyaa	matqtaaniyaa
mikaayaa	mikaayaa
eliyaakim	eliyaakim
aahaasuelatv	aahaasuelatq
inndie	india
watvqaati	watqqaati
yekoniyaa	yekoniyaa
mondekai	modekai
esete	esete
esete	esete
esete	esete
kenndie	kendia
lewiaataan	lewiaataan
mbinndatc	bindatg
naaaame	naaaame
elihu	elihu
mbehemotv	behemotq
lembaanorn	lebaanxn
gembaan	kebaan
menkisendekc	menkisedekg
jorndaen	jxdcn
efaataa	efaataa
itien	itien
itien	itien
anman	anman
ndaamatvgatc	daamatqkatg
efaaim	efaaim
mbaambilon	baabilon
moapc	moapg
naiaa	naiaa
iyipv	iyipq
atcsilie	atgsilia
sepvnaa	sepqnaa
aalien	aalien
aalien	aalien
sion	sion
isaayaa	isaayaa
faangensen	zauj
mbaaan	baaan
mankiaa	mankiaa
yosiyaa	yosiyaa
sindaa	sijdaa
atckelon	atgkelon
uliaa	uliaa
gemaaliyaa	kemaaliyaa
kolaayaa	kolaayaa
nehelaam	nehelaam
sefanyaa	sejfanyaa
sendekiyaa	sejdekiyaa
kenndie	kendia
neliyaa	neliyaa
koniyaa	koniyaa
yehukan	yehukan
mbenyaamin	benyaamin
matvtaan	matqtaan
kaaleaa	kaaleaa
tanhumetv	tanhumetq
kaaleaa	kaaleaa
gendaaliyaa	kedaaliyaa
taabaanhetc	taapaanhetg
kiliyaataaim	kiliyaataaim
ndimbon	dibon
endom	edom
endom	edom
mbaambilon	baabilon
nembukatvnetvsaa	nebukatqnetqsaa
kembaa	kebaa
yaaaasanyaa	yaaaasanyaa
oholaa	oholaa
oholimbaa	oholibaa
etiobie	etiopia
home	home
ndaanien	daanien
mbentesatvsaa	bentesatqsaa
satvlakv	satqlakq
aambetcnego	aabetgneko
aambetcnego	aabetgneko
mbensatvsaa	bensatqsaa
gaambelien	kaabelyen
hoseyaa	hoseyaa
keliotc	keliotg
gingaan	kinkaan
finisie	finisia
saaxlefatv	saajlefatq
ninaawe	ninaawe
naahum	naahum
limbie	libia
haambaagukc	haabaakukg
yosuwaa	yosuwaa
hetvlon	hetqlon
mboaatc	boaatg
jetcsi	jyetgsi
eliyaakim	eliyaakim
maaliyaa	maaliyaa
maaliyaa	maaliyaa
imaanuen	imaanuen
yundie	yudia
naasaaletv	naasaaletq
naasaaletv	naasaaletq
yohan	yohan
yohan	yohan
yohan	yohan
sembendi	sejbedi
totvmbuli	totqbuli
mbaatolomiu	baatolomiu
matvtaai	matqtaai
anfeatc	anfeatg
tatvndeatc	tatqdeatg
yundaatc	yudaatg
isaakaaliotc	isaakaaliotg
faalisi	faalisij
faalisi	faalisij
mbeensembun	beensebun
helondietc	helodyetg
saandusi	saadusij
saandusi	saadusij
mbetaani	betaani
kaayaafaatv	kaayaafaatq
yundaatc	yudaatg
mbaalapvmbatc	baalapqbatg
mbaalapvmbatc	baalapqbatg
laamaasaambakctaani	laamaasaabakgtaani
makvndaalaa	makqdaalaa
anndaalu	andaalu
kaabenaaum	kaapenaaum
mbetcsaindaa	betgsaidaa
hosaanaa	hosaanaa
aalekvsaannde	aalekqsaande
matvtatv	matqtatq
matvtatv	matqtatq
matvtaatiatc	matqtaatiatg
matvtaatiatc	matqtaatiatg
eaa	eaa
simeon	simeon
apclaaham	apglaaham
naaho	naaho
leu	leu
embe	ebe
aanfaasatv	aanfaasatq
aandam	aadam
gelaasaa	kelaasaa
saamaalie	saamaalia
gaalili	kaalili
siloam	sijloam
laasaalatv	laasaalatq
sakckietv	sakgkyetq
naataanaaen	naataanaaen
nikondematv	nikodematq
laasaalatv	laasaalatq
laasaalatv	laasaalatq
yundaatc	yudaatg
aanaanie	aanaania
aanaanie	aanaania
saatefen	saatefen
antiokc	antiokg
nikolau	nikolau
aineatc	aineatg
litvndaa	litqdaa
koneliatc	koneliatg
koneliatc	koneliatg
sisaaliyaa	sisaaliyaa
mbaanaambatc	baanaabatg
mbaanaambatc	baanaabatg
ikoniyum	ikoniyum
maasindonie	maasidonia
tesaalonigaa	tesaalonikaa
timotai	timotai
kolinto	kolinto
kaalitvbatc	kaalitqpatg
ganlio	kanlio
aakaayaa	aakaayaa
efeso	efeso
bitcsinxlaa	pitgsinjlaa
aakuinlaa	aakwinlaa
aaborlo	aapxlo
aantemitv	aantemitq
ndemetvliatc	demetqliatg
mbeloaa	beloaa
aalitvtaakatv	aalitqtaakatq
gaaiatc	kaaiatg
tikigatc	tikikatg
dofimatv	tofimatq
doatc	toatg
silisie	silisia
kaalaaundiatc	kaalaaudiatg
fesaatatv	fesaatatq
fesaatatv	fesaatatq
aanqipaa	aagipaa
aanqipaa	aagipaa
apclaaham	apglaaham
lusiatc	lusiatg
saatefaanatv	saatefaanatq
aaborlo	aapxlo
maasindonie	maasidonia
ebaafaa	epaafaa
laundisie	laudisia
himeneatc	himeneatg
gaalaatie	kaalaatia
onesifolatv	onesifolatq
elatvtatv	elatqtatq
miletatv	miletatq
filemon	filemon
onesimatv	onesimatq
mbaalaaam	baalaaam
kaain	kaain
tinhungh	tinb huvb
cingnzengc	revg
jauvlouc	lrug
niembung	buv
saengkuv	kuq
dornjueiv	jweiq
funfaqv	faq
ndaubeih	daub
nyungcnyungc	euvg
zeivfun	zeib
fingxfingx	fivj
deicbung	puv
ziecdorngh	ziab
hnyangxjeiv	havb
zanczanc	zang
ndopvliuh	liub
jaadingh	tivb
lomchuaang	lomb
finmienh	myenb
miucfangx	miub
luihoux	hruj
baengbieiv	pcvb
winwangv	wavq
koivhlen	len
gapvjaaix	kapg
jangxhoc	hog
leizlatc	latg
labieivbenv	penq
fusux	fub
saengyietv	scvb
mbuonvmuonc	bwrnb
caqvbouc	zag
leiznyeic	eeig
gorqvmienh	kxg
hunglouh	huvb
hnoinyieqc	eiag
jaasic	sig
nziemxyaangh	ryemb
biaavmbiaac	byaag
ongtaaix	taaij
wuonbaengc	pcvg
buozndiev	diaq
maanzhmuangx	maanb
maazcie	zia
gorxyouz	yrud
cungaeng	zunb
borngbuoz	pxvb
mbongaiv	aiq
wuomzingv	zivq
ndaamvfingx	fivj
normnorm	nxmb
cienceqv	zeq
ganaaivcenv	kanaaib
juangzinx	zinj
junbaeng	pcv
njienyouh	fyenb
congmengh	mevb
gongmienh	myenb
zorngzuqv	zuq
baengguanh	pcvb
saengziepc	scvb
fiuvdaanh	fiub
njanglaangc	laavg
hnyangxhnyangx	havb
siepvsiepv	syepq
gongzinh	kovb
ornlorqc	lxg
nziaauxzunc	zung
gornndoqv	doq
ndauhuaang	daub
saengeix	eij
congmengh	zovb
gorngvbaeqc	kxvb
korvlienh	lyenb
jopvnyeic	eeig
qouqou	qru
gongfim	fim
ndiangxnquaah	gwaab
ndiangxgaaz	dyavb
sounjunc	fung
zorngzengx	zevj
poutong	tov
koivnzou	rru
gorxyouz	kxb
longxlongx	lovj
enzingh	zivb
lozhnoi	nxi
siangnzung	syavb
zaeqvziouv	zyruq
hnoihnoi	nxib
aandam	aadam
haawaa	haawaa
kaain	kaain
aambaen	aabcn
enokv	enokq
laamekv	laamekq
aandaa	aadaa
enotv	enotq
kenan	kenan
maahaalaalen	maahaalaalen
yaaletv	yaaletq
metuselaa	metusejlaa
noyaa	noyaa
yaafetv	yaafetq
kaanaaan	kaanaaan
gome	kome
maagokc	maakokg
maandai	maadai
yaawaan	yaawaan
tumban	tuban
mesekv	mesekq
tilaatv	tilaatq
atckenatv	atgkenatq
lifaatv	lifaatq
togaanmaa	tokaanmaa
eliseaa	eliseaa
taansitv	taansitq
kitvtim	kitqtim
londaanim	lodaanim
iyipv	iyipq
sembaa	sejbaa
haawilaa	haawilaa
sapctaa	sapgtaa
laaaamaa	laaaamaa
sapctekaa	sapgtekaa
qembaa	qebaa
ndendaan	dedaan
nimlotv	nimlotq
ninaawe	ninaawe
lundim	ludim
aanaamim	aanaamim
lehaambim	lehaabim
napvtuhim	napqtuhim
hiwai	hiwai
aankaa	aankaa
sini	sijni
elaam	elaam
atcsu	atgsu
aanfaasatv	aanfaasatq
lunde	lude
aalam	aalam
gete	kete
qelaa	qelaa
embe	ebe
yokvtaan	yokqtaan
anmondatc	anmodatg
qelepv	qelepq
haasaanmaawetv	haasaanmaawetq
yelaa	yelaa
haandolam	haadolam
usaan	usaan
ndikclaa	dikglaa
aambimaaen	aabimaaen
ofi	ofi
yombapc	yobapg
mbaamben	baaben
belekv	pelekq
leu	leu
selukv	sejlukq
naaho	naaho
telaa	telaa
apclaam	apglaam
haalaan	haalaan
saalaai	saalaai
minkaa	minkaa
negepc	nekepg
faalo	faalo
mbetcen	betgen
sondom	sojdom
gomolaa	komolaa
atcmaa	atgmaa
semboyim	sejboyim
mbelaa	belaa
soaa	sojaa
taamaa	taamaa
aamaalekv	aamaalekq
aamolai	aamolai
sitcndim	sitgdim
ndaamatvgatc	daamatqkatg
kendolaaome	kedolaaome
aane	aane
etcko	etgko
mamle	mamle
torngvbaaih	paaib
eliyese	eliyese
apclaaham	apglaaham
hitvtai	hitqtai
belitvsi	pelitqsi
lefaaim	lefaaim
haagaa	haakaa
isaamaaen	isaamaaen
saalaa	saalaa
gelaaaa	kelaaaa
aambimelekv	aabimelekq
isakc	isakg
mbeeqembaa	beeqebaa
haaso	haaso
mbetuen	betuen
lembekaa	lebekaa
hembolon	hebolon
sohaax	sojhaaj
efolon	efolon
laambaan	laabaan
ketulaa	ketulaa
yokvsaan	yokqsaan
mitvmaa	mitqmaa
ndumaa	dumaa
haandatc	haadatg
temaa	temaa
yetu	yetu
naafitv	naafitq
kendemaa	kedemaa
esaau	esaau
yaakopv	yaakopq
filisaadie	filisaatia
mbeeli	beeli
elon	elon
mbaasematv	baasejmatq
laasen	laasen
laambaan	laabaan
mbinhaa	binhaa
leaa	leaa
lewi	lewi
napvtaali	napqtaali
sinxbaa	sinjpaa
ndundaaim	dudaaim
ndinaa	dinaa
isaalaaen	isaalaaen
yosepv	yosepq
sei	seji
haamo	haamo
sekem	sekem
simeon	simeon
efaalaataa	efaalaataa
mbenyaamin	benyaamin
aase	aase
elifatv	elifatq
leuen	leuen
temaan	temaan
omaa	omaa
sefo	sejfo
naahatc	naahatg
zelaa	zelaa
aanaa	aanaa
yeutc	yeutg
yaalaam	yaalaam
kolaa	kolaa
oholimbaamaa	oholibaamaa
endom	edom
holi	holi
homam	homam
lotaan	lotaan
timnaa	timnaa
sombaan	sobaan
maanaahaatv	maanaahaatq
embaan	ebaan
onam	onam
ndison	dison
etcmbaan	etgbaan
itclaan	itglaan
kelaan	kelaan
ese	ese
ndisaan	disaan
aalan	aalan
simbeon	sibeon
endom	edom
ndinhaambaa	dinhaabaa
mbosaalaa	bosaalaa
husaam	husaam
mbendatc	bedatg
moapc	moapg
mindien	midyen
aawitv	aawitq
samxlaa	samjlaa
lehoxmbotc	lehojbotg
saaun	saaun
akcmbo	akgbo
anwaa	anwaa
yetetv	yetetq
elaa	elaa
binon	pinon
kenatv	kenatq
mipvsaa	mipqsaa
ndotaan	dotaan
lumben	luben
yundaa	yudaa
quaa	quaa
eaa	eaa
onan	onan
hipvlu	hipqlu
naiaa	naiaa
haanokv	haanokq
banlu	panlu
hetvlon	hetqlon
kaanmi	kaanmi
yemuen	yemuen
yaamin	yaamin
ohaatc	ohaatg
yaakin	yaakin
geson	keson
kohaatv	kohaatq
melaali	melaali
itcsaaxkaa	itgsaajkaa
tolaa	tolaa
simlon	simlon
sembulun	sejbulun
seletv	sejletq
yaaleen	yaaleen
hakvgi	hakqki
suni	suni
etcmbon	etgbon
elei	elei
aaleli	aaleli
imnaa	imnaa
itcwaa	itgwaa
itcwi	itgwi
mbeliyaa	beliyaa
selaaaa	selaaaa
hembe	hebe
mbeke	beke
atcmben	atgben
gelaa	kelaa
naaaamaan	naaaamaan
husim	husim
yaasien	yaasien
guni	kuni
yese	yese
sinlem	sinlem
gosen	kosen
maanatvse	maanatqsej
efaaim	efaaim
jorndaen	jxdcn
maaki	maaki
mose	mose
aalon	aalon
lipvni	lipqni
simei	simei
maazli	maali
musi	musi
itchaa	itghaa
nefekv	nefekq
sikcli	sikgli
utcsien	utgsien
misaaen	misaaen
ensaafaan	ensaafaan
naason	naason
naandapc	naadapg
itaamaa	itaamaa
atcsi	atgsij
enkaanaa	enkaanaa
eleaasaa	eleaasaa
finehatc	finehatg
biauvhlen	len
douznzauc	raug
mbaali	baali
sukckotv	sukgkotq
aambipc	aabipg
miliem	milyem
lefindim	lefidim
huaa	huaa
yosuwaa	yosuwaa
yeto	yeto
sinaai	sinaai
mbongningv	bovb
mbongnqenx	genj
aambihu	aabihu
kelumbim	kelubim
efotv	efotq
ndaamdorng	txv
uli	uli
mbesaalen	besaalen
siousetv	setq
yembutc	yebutg
oholiapc	oholiapg
caeqvjaangh	jaavb
ulim	ulim
tummim	tummim
buozzaangv	puab
molekv	molekq
selomitv	selomitq
buonvfingx	fivj
suxlisatvndai	sujlisatqdai
selumien	selumien
amminaandapc	amminaadapg
zuaa	zuaa
netanen	netanen
helon	helon
eliapc	eliapg
ammihutv	ammihutq
elisaamaa	elisaamaa
bendaasu	pedaasu
gaamaalien	kaamaalien
gindeoni	kideoni
aambindan	aabidan
aahiyese	aahiyese
okaan	okaan
baagien	paakien
ndeuen	deuen
eliyaasaapc	eliyaasaapg
enan	enan
aahilaa	aahilaa
amlaam	amlaam
elisaafaan	elisaafaan
maanaa	maanaa
sakcge	sakgke
sammuwaa	sammuwaa
saafatv	saafatq
yefunne	yefunne
kaalepv	kaalepq
igaan	ikaan
hoseyaa	hoseyaa
mikaaen	mikaaen
homaa	homaa
doixdekc	tekg
ndaataan	daataan
aambilam	aabilam
siangsic	syavb
melimbaa	melibaa
kaandetc	kaadetg
hoaa	hoaa
aalaatv	aalaatq
naangdoqc	tog
zeletv	zeletq
sihonx	sihonj
hetvmbon	hetqbon
kemotv	kemotq
sipcbo	sipgpo
mbaalaakv	baalaakq
mbaalaaam	baalaaam
mbaaan	baaan
mbeo	beo
kenai	kenai
beo	peo
simxli	simjli
kotvmbi	kotqbi
suxaa	sujaa
otcni	otgni
yaasupv	yaasupq
atclien	atglien
semindaa	semidaa
hefe	hefe
selofehatc	sejlofehatg
maahaalaa	maahaalaa
hokvlaa	hokqlaa
tilaasaa	tilaasaa
suham	suham
gileaatc	kileaatg
maakile	maakile
aambaalim	aabaalim
ewi	ewi
lekem	lekem
lembaa	lebaa
mikvndon	mikqdon
lipvnaa	lipqnaa
taahatc	taahatg
yotvmbaataa	yotqbaataa
ombotc	obotg
nembo	nebo
atcmon	atgmon
mendidelenien	meditelenyen
haamatv	haamatq
sendatc	sejdatg
mbukcki	bukgki
hannien	hannien
kemuen	kemuen
bantien	pantien
aahihutv	aahihutq
endeni	edeni
atctaalotv	atgtaalotq
mbaasaan	baasaan
holepv	holepq
aanaakv	aanaakq
yaahaatv	yaahaatq
aangopc	aankopg
hemon	hemon
saindorn	saidxn
seni	sejni
aalaambaa	aalaabaa
bitcgaa	pitgkaa
kungxbuoz	puad
ammon	ammon
gelisim	kelisim
aamen	aamen
laahapc	laahapg
gingaan	kinkaan
yeliko	yeliko
sapcndi	sapgdi
aakaan	aakaan
gimbeon	kibeon
mbeelotv	beelotq
yelusaalem	yelusaalem
yaanmutv	yaanmutq
laakitv	laakitq
yaafie	yaafia
ekclon	ekglon
ndembi	debi
aasekaa	aasekaa
makvkendaa	makqkedaa
aiyaalon	aiyaalon
gese	kese
yaambin	yaabin
maandon	maadon
akcsaapv	akgsaapq
mitvbaa	mitqpaa
aandunlam	aadunlam
tapvbuwaa	tapqpuwaa
aafekv	aafekq
megitcndo	mekitgdo
kendetc	kedetg
kaanmen	kaanmen
yokvneam	yokqneam
goyim	koyim
gesu	kesu
maaaakaa	maaaakaa
saaxlekaa	saajlekaa
kendemotv	kedemotq
mefaaaatc	mefaaaatg
mbaaaalaa	baaaalaa
timnaahaa	timnaahaa
akcsaax	akgsaaj
otcnien	otgnien
sipcaa	sipgaa
telem	telem
mbeaalotv	beaalotq
semaa	semaa
molaandaa	molaadaa
esem	esem
entolatv	entolatq
sikclaakv	sikglaakq
matvmannaa	matqmannaa
soko	sojko
mbotckaatv	botgkaatq
ete	ete
aaqan	aaqan
atcnaa	atgnaa
aanaapv	aanaapq
etctemoaa	etgtemoaa
aalapc	aalapg
maaon	maaon
yitvleen	yitqleen
gendo	kedo
aataalotv	aataalotq
naaaalaa	naaaalaa
silo	silo
apcwim	apgwim
ofaalaa	ofaalaa
laamaa	laamaa
mosaa	mosaa
kision	kision
embetc	ebetg
hammatv	hammatq
kinneletv	kinneletq
solaa	sojlaa
etctaaon	etgtaaon
ekolon	ekolon
enteke	enteke
gipcmbeton	kipgbeton
mbaaaalatv	baaaalatq
mbesekv	besekq
sesai	sesai
aahimaan	aahimaan
tanmai	tanmai
akcsipv	akgsipq
lehopc	lehopg
ehutv	ehutq
aanaatv	aanaatq
samgaa	samkaa
ndembolaa	debolaa
aambinoam	aabinoam
taambo	taabo
siselaa	sisejlaa
gindeon	kideon
yoaatc	yoaatg
wuomhlen	uamb
aambiyese	aabiyese
zembaa	zebaa
sanxmunnaa	sanjmunnaa
benuen	penuen
heletv	heletq
yotaam	yotaam
mbee	bee
sembun	sejbun
gaaan	kaaan
tembetc	tebetg
saami	saami
jaai	jaai
yepvtaa	yepqtaa
aaloe	aaloe
mbetclehem	betglehem
bilaaton	pilaaton
apcndon	apgdon
maanoaa	maanoaa
saemsanx	scmsanj
gaasaa	kaasaa
ndelilaa	delilaa
mikaa	mikaa
laaitc	laaitg
gimbeaa	kibeaa
naaomi	naaomi
elimelekv	elimelekq
lute	lute
maalon	maalon
kilion	kilion
hnievhniev	niaq
maalaa	maalaa
mboaatc	boaatg
camvcamv	zamq
sanxmon	sanjmon
ombetc	obetg
jetcsi	jyetgsi
ndaawitv	daawitq
buonvzingh	eei
eli	eli
beninnaa	peninnaa
hannaa	hannaa
saengyungz	yuvd
saamuen	saamuen
atcndotc	atgdotg
lozdorngx	txvj
aambinaandapc	aabinaadapg
saulo	saulo
yaambetc	yaabetg
naahaatc	naahaatg
mikvmaatv	mikqmaatq
suan	suan
yonaataan	yonaataan
aahiyaa	aahiyaa
apcne	apgne
aambien	aabien
suwaa	suwaa
aagakc	aakakg
sammaa	sammaa
hmienfangx	myenb
goliatc	koliatg
saaaalaaim	saaaalaaim
sieqvhlo	siag
mikaan	mikaan
naayotv	naayotq
aahimelekv	aahimelekq
aakitv	aakitq
ndoekc	doekg
aahitupv	aahitupq
aambiyaataa	aabiyaataa
keilaa	keilaa
naambaan	naabaan
aambigaayin	aabikaayin
aahinoam	aahinoam
seluyaa	sejluyaa
yoaapc	yoaapg
aambiqai	aabiqai
sunem	sunem
ginmboaa	kinboaa
keleti	keleti
laamotv	laamotq
yaatvti	yaatqti
yelaameen	yelaameen
yaasaa	yaasaa
itcmbosetv	itgbosetq
maahaanaaim	maahaanaaim
aasaaxhen	aasaajhen
amnon	amnon
aandoniyaa	aadoniyaa
hakvgitc	hakqkitg
sefaatiyaa	sefaatiyaa
gitctaaim	kitgtaaim
limmon	limmon
lekaapv	lekaapq
mbaaaanaa	baaaanaa
minlo	minlo
naatan	naatan
saalomorn	saalomxn
ipchaa	ipghaa
elisuwaa	elisuwaa
eliyaandaa	eliyaadaa
elifeletv	elifeletq
gembaa	kebaa
utcsaa	utgsaa
sindaa	sijdaa
sombaa	sojbaa
haandatcese	haadatgese
yufeditc	yufetitg
silie	silia
yehoyaandaa	yehoyaadaa
mbenaiyaa	benaiyaa
peletv	peletq
simbaa	sibaa
mefimbosetv	mefibosetq
haanun	haanun
mbatcqembaa	batgqebaa
uliaa	uliaa
lapvmbaa	lapqbaa
apcsaalom	apgsaalom
yonaandapc	yonaadapg
tekoaa	tekoaa
itctai	itgtai
saaxndokc	saajdokg
aahimaaatc	aahimaaatg
aahitofen	aahitofen
husai	husai
mbaasinlai	baasinlai
aamaasaax	aamaasaaj
mbikcli	bikgli
ilaa	ilaa
aiaa	aiaa
litvbaa	litqpaa
simehaa	simehaa
aahoxhai	aahojhai
ndondo	dodo
haalaa	haalaa
enhaanan	enhaanan
haalotv	haalotq
heletvte	heletqte
ikcketc	ikgketg
aanaatotv	aanaatotq
husaa	husaa
netofaa	netofaa
maahaalai	maahaalai
limbai	libai
gaaatc	kaaatg
mbaahulim	baahulim
atcmaawetv	atgmaawetq
aahiyam	aahiyam
gilon	kilon
hetvlo	hetqlo
mbaani	baani
selekv	sejlekq
naahaalai	naahaalai
itclai	itglai
gaalepv	kaalepq
uliyaa	uliyaa
yaase	yaase
aalaaunaa	aalaaunaa
aambiqaakv	aabiqaakq
aasaaliyaa	aasaaliyaa
aahilutv	aahilutq
itcndo	itgdo
yehosaafatv	yehosaafatq
hilaam	hilaam
lembaanorn	lebaanxn
aandonilam	aadonilam
ndiangxbenv	penq
tailaqv	tailaq
sion	sion
gaalili	kaalili
taabenetv	taapenetq
yelomboam	yeloboam
lehoxmboam	lehojboam
lozziouv	zyruq
aambiyaa	aabiyaa
jaandaangc	daavg
sisakv	sisakq
nembatc	nebatg
aambiyam	aabiyam
aambiqaalom	aabiqaalom
aasaax	aasaaj
mbaaaaqaa	baaaaqaa
omli	omli
saamaalie	saamaalia
aahapc	aahapg
aaselaa	aaselaa
eliyaa	eliyaa
ombaandi	obaadi
yesemben	yeseben
kison	kison
yehu	yehu
elisaa	elisaa
haasaaen	haasaaen
naambotc	naabotg
imlaa	imlaa
mikaayaa	mikaayaa
aahatcyaa	aahatgyaa
sinhi	sinhi
aasumbaa	aasubaa
yolam	yolam
yeholam	yeholam
saidiex	saib
gehaasi	kehaasi
aannon	aannon
yehoaahaatc	yehoaahaatg
aataaliyaa	aataaliyaa
yehoaatc	yehoaatg
aamaasiyaa	aamaasiyaa
sekaaliyaa	sejkaaliyaa
sanlum	sanlum
utcsiyaa	utgsiyaa
gaandi	kaadi
menaahem	menaahem
atcsilie	atgsilia
bekaahiyaa	pekaahiyaa
lemaaliyaa	lemaaliyaa
bekaa	pekaa
aahatc	aahatg
lesin	lesin
kiaa	kiaa
mindie	midia
mbaambilon	baabilon
sefaanwaaim	sejfaanwaaim
hesekiyaa	hesekiyaa
sennaakelipv	sennaakelipq
isaayaa	isaayaa
aanbatc	aanpatg
henaa	henaa
ipcwaa	ipgwaa
aamon	aamon
yosiyaa	yosiyaa
aandaayaa	aadaayaa
mesunlaam	mesunlaam
aasaalaiyaa	aasaalaiyaa
saafaan	saafaan
hinkiyaa	hinkiyaa
aahikam	aahikam
aasaaxyaa	aasaajyaa
hunndaa	hundaa
kitclon	kitglon
buonvsin	sin
haamutaan	haamutaan
yelemi	yelemi
lipvlaa	lipqlaa
yehoyaakim	yehoyaakim
bendaayaa	pedaayaa
yehoyaakin	yehoyaakin
ennaatan	ennaatan
sendekiyaa	sejdekiyaa
aanwatv	aanwatq
matvsaax	matqsaaj
gaataam	kaataam
mitvsaa	mitqsaa
anwaan	anwaan
mbinhaan	binhaan
saaxwaan	saajwaan
matvlekaa	matqlekaa
makvndien	makqdien
ilaam	ilaam
beletv	peletq
haamun	haamun
etaan	etaan
hemaan	hemaan
kaanko	kaanko
ndaanndaa	daandaa
yete	yete
segupc	sejkupg
sammai	sammai
aambihaain	aabihaain
itci	itgi
sesan	sesan
akclai	akglai
saaxmbaatc	saajbaatg
eleaasaax	eleaasaaj
yekaamiyaa	yekaamiyaa
beletc	peletg
efaa	efaa
saaapc	saaapg
qewaa	qewaa
simeaa	simeaa
nogaa	nokaa
selupvmbaamben	sejlupqbaaben
haananyaa	haananyaa
mbelekiyaa	belekiyaa
belaatiyaa	pelaatiyaa
yesaayaa	yesaayaa
lefaiyaa	lefaiyaa
sekaaniyaa	sekaaniyaa
semaiaa	semaiaa
hatvtatv	hatqtatq
neaaliyaa	neaaliyaa
elionai	elionai
atclikam	atglikam
hondaawiyaa	hodaawiyaa
eliyaasipv	eliyaasipq
belaiyaa	pelaiyaa
akckupc	akgkupg
yohaanan	yohaanan
ndelaiyaa	delaiyaa
leaayaa	leaayaa
yaahaatc	yaahaatg
edaam	etaam
itcmaa	itgmaa
helaa	helaa
baaseaa	paasejaa
selaiaa	sejlaiaa
etclaa	etglaa
meletv	meletq
efe	efe
kenan	kenan
maahaalaalen	maahaalaalen
enokv	enokq
metuselaa	metusejlaa
noyaa	noyaa
aalam	aalam
qelaa	qelaa
isakc	isakg
lotaan	lotaan
ndison	dison
haandatc	haadatg
yundaa	yudaa
amminaandapc	amminaadapg
naason	naason
sanxmon	sanjmon
ombetc	obetg
jaai	jaai
sesan	sesan
naatan	naatan
yehu	yehu
ndaawitv	daawitq
lehoxmboam	lehojboam
aambiyaa	aabiyaa
aasaax	aasaaj
aamaasiyaa	aamaasiyaa
aasaaliyaa	aasaaliyaa
aahatc	aahatg
hesekiyaa	hesekiyaa
ammon	ammon
yehoyaakin	yehoyaakin
selupvmbaamben	sejlupqbaaben
yesaayaa	yesaayaa
lefaiyaa	lefaiyaa
ombaandi	obaadi
semaiaa	semaiaa
yaahaatc	yaahaatg
maalesaa	maalesaa
gendelaa	kedelaa
nemuen	nemuen
yaalipv	yaalipq
sanlum	sanlum
mipvsamx	mipqsamj
sakcge	sakgke
aayin	aayin
yoen	yoen
aasien	aasien
aandien	aadien
zizaa	zizaa
yendaayaa	yedaayaa
simli	simli
mikaa	mikaa
gileaatc	kileaatg
mikaaen	mikaaen
aahi	aahi
elien	elien
finehatc	finehatg
aambiquwaa	aabiquwaa
mbukcki	bukgki
utcsi	utgsi
selaahiyaa	sejlaahiyaa
selaahiyaa	sejlaahiyaa
melaayotv	melaayotq
aamaaliyaa	aamaaliyaa
aamaaliyaa	aamaaliyaa
saaxndokc	saajdokg
hinkiyaa	hinkiyaa
yehosaandakc	yehosaadakg
nembukatvnetvsaa	nebukatqnetqsaa
simxmaa	simjmaa
yoaa	yoaa
zelaa	zelaa
enkaanaa	enkaanaa
embiyaasaapc	ebiyaasaapg
embiyaasaapc	ebiyaasaapg
taahatc	taahatg
ulien	ulien
utcsiyaa	utgsiyaa
eliapc	eliapg
yeloham	yeloham
yeloham	yeloham
simeaa	simeaa
maahaatv	maahaatq
aamaasaix	aamaasaij
yoen	yoen
sefanyaa	sejfanyaa
atcsi	atgsij
itchaa	itghaa
kohaatv	kohaatq
lewi	lewi
aasaapc	aasaapg
aasaapc	aasaapg
mbelekiyaa	belekiyaa
mankiyaa	mankiyaa
simxmaa	simjmaa
geson	keson
apcndi	apgdi
manlukv	manlukq
haasaabiyaa	haasaapiyaa
haasaabiyaa	haasaapiyaa
amsi	amsi
amsi	amsi
mbaani	baani
qeme	qeme
maazli	maali
melaali	melaali
utcsi	utgsi
melaayotv	melaayotq
ndaambelatv	daabelatq
puaa	puaa
yendiyaaen	yediyaaen
yelimotv	yelimotq
yelemotv	yelemotq
aalemetv	aalemetq
kenaaaanaa	kenaaaanaa
hupcbim	hupgpim
supvbim	supqpim
belaetv	pelctq
ulaam	ulaam
telaa	telaa
taahan	taahan
laandaan	laadaan
laandaan	laadaan
mankien	mankien
yaafeletv	yaafeletq
some	some
hotaam	hotaam
sofaa	sojfaa
mbese	bese
aalaa	aalaa
atcndaa	atgdaa
mesaa	mesaa
enbaaan	enpaaan
aahiyo	aahiyo
saasakv	saasakq
sembaandiyaa	sejbaadiyaa
ende	ede
yohaa	yohaa
yaakim	yaakim
sinxletai	sinjletai
haanan	haanan
yeien	yeien
saulo	saulo
biton	piton
melekv	melekq
taalie	taalia
simxli	simjli
mbineaa	bineaa
mbineaa	bineaa
eleaasaax	eleaasaaj
aasen	aasen
mbokelu	bokelu
seaaliyaa	seaaliyaa
isaalaaen	isaalaaen
yeuen	yeuen
sanxlu	sanjlu
hatcsenuaa	hatgsejnuaa
elaa	elaa
mesunlaam	mesunlaam
sefaatiyaa	sefaatiyaa
leuen	leuen
aandaayaa	aadaayaa
baatche	paatghe
baatche	paatghe
mankiyaa	mankiyaa
imme	imme
gaalaan	kaalaan
matvtaaniyaa	matqtaaniyaa
sikcli	sikgli
yendutun	yedutun
yendutun	yedutun
mikvlotv	mikqlotq
yembutc	yebutg
belon	pelon
sipcmbekai	sipgbekai
saaanmbon	saaanbon
eliyaambaa	eliyaabaa
gimso	kimso
haasem	haasem
uaa	uaa
itclai	itglai
yaaaasien	yaaaasien
semaaliyaa	semaaliyaa
itcsiyaa	itgsiyaa
aasaalen	aasaalen
yaasombeam	yaasobeam
aambiqai	aabiqai
silie	silia
saadaan	saataan
selomotv	selomotq
gesom	kesom
haalim	haalim
miyaamin	miyaamin
hakvkotc	hakqkotg
yesuaa	yesuaa
mbingaa	binkaa
hesi	hesi
betaahiyaa	petaahiyaa
maaaasiyaa	maaaasiyaa
yaaaasiyaa	yaaaasiyaa
gendaaliyaa	kedaaliyaa
matvtitiyaa	yedutun
sembuen	sebuen
haanaani	haanaani
yehohaanan	yehohaanan
hosaax	hosaaj
henndai	hendai
elihu	elihu
itcmaiaa	itgmaiaa
aanki	aanki
saalomorn	saalomxn
tailaqv	tailaq
yapvfaa	yapqfaa
kelumbim	kelubim
isaalaaen	isaalaaen
saalomorn	saalomxn
sekem	sekem
yelomboam	yeloboam
maahaalatv	maahaalatq
yelusaalem	yelusaalem
yundaa	yudaa
ondetc	odetg
mbaaaaqaa	baaaaqaa
yehosaafatv	yehosaafatq
netaaniyaa	netaaniyaa
tombiyaa	tobiyaa
yehosaambaatc	yehosaabaatg
aahapc	aahapg
yaahaasien	yaahaasien
aahatcyaa	aahatgyaa
yeholam	yeholam
yehien	yehien
etiobie	etiopia
yolam	yolam
yehu	yehu
yehoyaandaa	yehoyaadaa
simeatc	simeatg
yehoaatc	yehoaatg
yekoliyaa	yekoliyaa
filisaadie	filisaatia
aamortv	aamxtq
ofen	ofen
yotaam	yotaam
maaaaseaa	maaaasejaa
mesinlemotv	mesinlemotq
maanatvse	maanatqsej
aamon	aamon
yosaambaatc	yosaabaatg
yoaahaatc	yoaahaatg
yelemi	yelemi
besie	pesia
sailatv	sailatq
haanditc	haaditg
ono	ono
senaaaa	sejnaaaa
aantaasesitv	aantaasesitq
mitvlendaatc	mitqledaatg
ndaaliatc	daaliatg
hakvgai	hakqkai
yiutai	yiutai
aahitupv	aahitupq
aambiquwaa	aabiquwaa
eleaasaa	eleaasaa
esaalaa	esaalaa
aahaawaa	aahaawaa
esaalaa	esaalaa
sapvmbetai	sapqbetai
kelitaa	kelitaa
melemotv	melemotq
matvtenai	matqtenai
selemiyaa	selemiyaa
haakaaliyaa	haakaaliyaa
nehaami	nehaami
susaax	susaaj
sanxmbaanlatv	sanjbaanlatq
tombiaa	tobiaa
gesem	kesem
imli	imli
mesesaamben	mesesaaben
yoyaandaa	yoyaadaa
haasapvneyaa	haasapqneyaa
hatcsupv	hatgsupq
hanlohetc	hanlohetg
lehum	lehum
sapcmbai	sapgbai
mbaalukv	baalukq
hatcsupv	hatgsupq
henaandatc	henaadatg
mbinnui	binnwi
baalaan	paalaan
baalotv	paalotq
tombiaa	tobiaa
mondekai	modekai
mbinsaan	binsaan
mbikcwai	bikgwai
katcmien	katgmien
qembaaniyaa	qebaaniyaa
mbunni	bunni
selebiyaa	selepiyaa
hondiyaa	hodiyaa
ndaanien	daanien
ginneton	kinneton
batclotv	patglotq
satctu	satgtu
atcgaatc	atgkaatg
mbembai	bebai
aandin	aadin
aate	aate
haasum	haasum
mbesai	besai
haalipv	haalipq
yaatvnduwaa	yaatqduwaa
aanaayaa	aanaayaa
sanxlai	sanjlai
yoyaalipv	yoyaalipq
atclikam	atglikam
sihaqc	sijhag
seantien	seantien
yoyaakim	yoyaakim
yonaataan	yonaataan
minyaamin	minyaamin
aamokv	aamokq
tanmon	tanmon
hosaayaa	hosaayaa
matvtaaniyaa	matqtaaniyaa
mikaayaa	mikaayaa
eliyaakim	eliyaakim
aahaasuelatv	aahaasuelatq
inndie	india
watvqaati	watqqaati
yekoniyaa	yekoniyaa
mondekai	modekai
esete	esete
esete	esete
esete	esete
haamaan	haamaan
haamaan	haamaan
haataakv	haataakq
haataakv	haataakq
kenndie	kendia
lewiaataan	lewiaataan
quwaa	quwaa
mbinndatc	bindatg
naaaame	naaaame
elihu	elihu
mbehemotv	behemotq
selaa	selaa
selaa	selaa
dorziec	txb
zuizmienh	myenb
lembaanorn	lebaanxn
dangxdonx	tonj
gembaan	kebaan
aamen	aamen
wuomlaangc	laavg
menkisendekc	menkisedekg
jorndaen	jxdcn
yaakopv	yaakopq
efaataa	efaataa
singqiex	qiaj
gorngvnjaaux	faauj
itien	itien
itien	itien
saalon	saalon
janxmuangz	janb
anman	anman
sicdorngh	txvb
bingxciouv	zyruq
biauvhuaang	waav
wuomdomh	tomb
ndaamatvgatc	daamatqkatg
efaaim	efaaim
baengcngaaiz	vaaid
ndiangxndonx	donj
mbaambilon	baabilon
moapc	moapg
naiaa	naiaa
iyipv	iyipq
atcsilie	atgsilia
sepvnaa	sepqnaa
laihnaangx	naavj
aalien	aalien
aalien	aalien
nziaauxjieqv	jiaq
sion	sion
isaayaa	isaayaa
saibatc	saipatg
biouvjoih	jxib
lozgaeng	kcv
mbaaan	baaan
buozzaux	zauj
mankiaa	mankiaa
yosiyaa	yosiyaa
sindaa	sijdaa
atckelon	atgkelon
uliaa	uliaa
gemaaliyaa	kemaaliyaa
kolaayaa	kolaayaa
nehelaam	nehelaam
sefanyaa	sejfanyaa
bungxzuoqc	puvb
sendekiyaa	sejdekiyaa
kenndie	kendia
neliyaa	neliyaa
mbaalukv	baalukq
gorqvmienh	kxg
koniyaa	koniyaa
yehukan	yehukan
mbenyaamin	benyaamin
matvtaan	matqtaan
kaaleaa	kaaleaa
tanhumetv	tanhumetq
kaaleaa	kaaleaa
gendaaliyaa	kedaaliyaa
taabaanhetc	taapaanhetg
memfitv	memfitq
kiliyaataaim	kiliyaataaim
ndimbon	dibon
endom	edom
endom	edom
forngcang	fxvb
mbaambilon	baabilon
nembukatvnetvsaa	nebukatqnetqsaa
buonvguoqv	pwrnb
saenghmz	scvb
kembaa	kebaa
yaaaasanyaa	yaaaasanyaa
luijuoqv	lwib
oholaa	oholaa
oholimbaa	oholibaa
etiobie	etiopia
saengcietv	scvb
mievciangv	miab
home	home
ndaanien	daanien
mbentesatvsaa	bentesatqsaa
satvlakv	satqlakq
mesaakv	mesaakq
aambetcnego	aabetgneko
aambetcnego	aabetgneko
mbensatvsaa	bensatqsaa
mene	mene
teken	teken
baasin	paasin
gaambelien	kaabelyen
hoseyaa	hoseyaa
aamotv	aamotq
aamotv	aamotq
keliotc	keliotg
gingaan	kinkaan
finisie	finisia
saaxlefatv	saajlefatq
yonaa	yonaa
yonaa	yonaa
ninaawe	ninaawe
bieivzeiv	pyeib
naahum	naahum
limbie	libia
haambaagukc	haabaakukg
kusi	kusi
minkom	minkom
jaaihorngc	hxvg
njanglaangc	favb
yosuwaa	yosuwaa
caidoix	zaib
beletv	peletq
hetvlon	hetqlon
mboaatc	boaatg
jetcsi	jyetgsi
eliyaakim	eliyaakim
yosepv	yosepq
maaliyaa	maaliyaa
maaliyaa	maaliyaa
yesu	yesu
yesu	yesu
giduc	kitug
yesu	yesu
imaanuen	imaanuen
helotv	helotq
yundie	yudia
naasaaletv	naasaaletq
naasaaletv	naasaaletq
yohan	yohan
yohan	yohan
yohan	yohan
dornhnamv	txnb
sembendi	sejbedi
yaagorpc	yaakxpg
totvmbuli	totqbuli
gilo	kilo
filipv	filipq
mbaatolomiu	baatolomiu
tomatv	tomatq
matvtaai	matqtaai
anfeatc	anfeatg
tatvndeatc	tatqdeatg
simon	simon
yundaatc	yudaatg
isaakaaliotc	isaakaaliotg
faalisi	faalisij
faalisi	faalisij
mbeensembun	beensebun
saadaan	saataan
helondietc	helodyetg
yesu	yesu
mbiauzdorn	txn
saandusi	saadusij
saandusi	saadusij
bide	pite
bide	pite
saigorx	saib
mbetaani	betaani
sisaa	sisaa
giduc	kitug
kaayaafaatv	kaayaafaatq
bide	pite
lomaa	lomaa
bilaatv	pilaatq
yundaatc	yudaatg
bilaatv	pilaatq
bilaatv	pilaatq
mbaalapvmbatc	baalapqbatg
mbaalapvmbatc	baalapqbatg
sailin	sailin
simon	simon
eli	eli
laamaasaambakctaani	laamaasaabakgtaani
makvndaalaa	makqdaalaa
anndaalu	andaalu
kaabenaaum	kaapenaaum
yesu	yesu
helotv	helotq
mbetcsaindaa	betgsaidaa
mose	mose
hosaanaa	hosaanaa
lomaa	lomaa
aalekvsaannde	aalekqsaande
lufatv	lufatq
matvtatv	matqtatq
matvtatv	matqtatq
menki	menki
menki	menki
matvtaatiatc	matqtaatiatg
matvtaatiatc	matqtaatiatg
eaa	eaa
simeon	simeon
apclaaham	apglaaham
naaho	naaho
selukv	sejlukq
leu	leu
belekv	pelekq
embe	ebe
aanfaasatv	aanfaasatq
laamekv	laamekq
yaaletv	yaaletq
enotv	enotq
aandam	aadam
gelaasaa	kelaasaa
yailatv	yailatq
saamaalie	saamaalia
biauvziouv	pyaub
maataa	maataa
gaalili	kaalili
siloam	sijloam
zaeqvdaan	taan
laasaalatv	laasaalatq
sakckietv	sakgkyetq
helotv	helotq
filipv	filipq
naataanaaen	naataanaaen
nikondematv	nikodematq
yiutai	yiutai
kaanaa	kaanaa
laasaalatv	laasaalatq
laasaalatv	laasaalatq
maataa	maataa
yundaatc	yudaatg
annaatv	annaatq
aanaanie	aanaania
aanaanie	aanaania
saatefen	saatefen
antiokc	antiokg
nikolau	nikolau
saulo	saulo
aineatc	aineatg
litvndaa	litqdaa
koneliatc	koneliatg
koneliatc	koneliatg
sisaaliyaa	sisaaliyaa
mbaanaambatc	baanaabatg
mbaanaambatc	baanaabatg
taasatv	taasatq
maako	maako
baulo	paulo
baulo	paulo
ikoniyum	ikoniyum
hemetv	hemetq
begaa	pekaa
silaa	silaa
maasindonie	maasidonia
baulo	paulo
silaa	silaa
tesaalonigaa	tesaalonikaa
yaasonx	yaasonj
aaten	aaten
timotai	timotai
kolinto	kolinto
kaalitvbatc	kaalitqpatg
ganlio	kanlio
aakaayaa	aakaayaa
efeso	efeso
bitcsinxlaa	pitgsinjlaa
aakuinlaa	aakwinlaa
aaborlo	aapxlo
aantemitv	aantemitq
esie	esia
ndemetvliatc	demetqliatg
mbeloaa	beloaa
aalitvtaakatv	aalitqtaakatq
gaaiatc	kaaiatg
tikigatc	tikikatg
dofimatv	tofimatq
doatc	toatg
silisie	silisia
felikv	felikq
felikv	felikq
kaalaaundiatc	kaalaaudiatg
lisietv	lisyetq
fesaatatv	fesaatatq
fesaatatv	fesaatatq
aanqipaa	aagipaa
aanqipaa	aagipaa
apclaaham	apglaaham
giduc	kitug
saaben	saapen
lusiatc	lusiatg
saatefaanatv	saatefaanatq
aaborlo	aapxlo
maasindonie	maasidonia
giduc	kitug
tidatc	titatg
tidatc	titatg
ebaafaa	epaafaa
laundisie	laudisia
himeneatc	himeneatg
ndemaatv	demaatq
gaalaatie	kaalaatia
lugaa	lukaa
onesifolatv	onesifolatq
elatvtatv	elatqtatq
miletatv	miletatq
filemon	filemon
onesimatv	onesimatq
saalem	saalem
mose	mose
mbaalaaam	baalaaam
kaain	kaain
kolaa	kolaa
