เยซู	Yesu
เยซู	Yesu
หฑั่ง	nzaangc
จั๋นไท้	JanxTaiv
ต้ง	dongh
ธอ	cor
ทินฮู่ง	TinHungh
เหฒย	zeix
ลู่ง	lungh
เดา	ndau
โยฮัน	Yohan
เหธา	caux
หม่าน	maanc
หมวด	muotc
ฮนั้ง	hnangv
น้าย	naaiv
นอ	nor
เหฒียง	ziangx
เหฑ่ง	nzengc
อ๊ะ	aqv
เถา	taux
ตะเธี้ยด	dacietv
ฮนอย	hnoi
โหฒว	zoux
นิ่น	ninh
เญย	nyei
กง	gong
ฯฒฯ	ziouc
ตี้ง	dingh
ฮิด	hitv
ขวน	kuonx
ธ้วด	cuotv
อียิบ	Iyipv
ฮิบลู	Hipvlu
เหธย	ceix
ฟุ	fuqv
ปุน	bun
วั้ว	wuov
นอม	norm
เป๋น	benx
ธีงเหฑ่ง	cingnzengc
เหว่ย	weic
หฒุ	zuqc
หย่า	yaac
เอเดน	Enden
หฮวีง	huingx
เจ๊าโหล่ว	jauvlouc
เซ	se
เฒี้ยว	Ziouv
หฒั่น	zanc
ไม้	maiv
แก้ง	gaengh
ม่าย	maaih
หาย	haaix
หญู่ง	nyungc
เมี้ย	miev
เดี๋ยง	ndiangx
ขูง	kungx
ววม	wuom
เยียม	yiem
เดาเดี๊ย	ndaundiev
สาม	saamx
ต้าย	daaih
ดอน	ndorn
ก๋อม	gormx
แอ๋ง	aengx
เฒาะ	zorqv
เต๋ย	deix
เนียบูง	niembung
นั้น	nanv
เต้า	dauh
เมี่ยน	mienh
ปย๊ม	biomv
แหม่ง	maengc
เฉีย	qiex
เปียะ	bieqc
บะฒอง	mbazorng
โคลินโท	Kolinto
ตง	dong
ปูง	bung
กะญั์ว	nyuoz
เดี๊ย	ndiev
ม่าน	maanh
เจี์ย	jiez
กอน	gorn
หฮยาง	hiaangx
เจี๊ยน	jienv
ฝาว	faaux
ยู์ง	yungz
ตุ๊	duqv
เซียะ	sieqv
ก๊อง	gorngv
บั๋ว	mbuox
โนยา	Noyaa
เม่ย	meih
เม่ย	meih
เหยียด	yietc
เปย๊า	biauv
ฮมวั้ง	hmuangv
ต่อย	doic
อ๋อย	oix
ฑั้ง	nzangv
จ๋า	jaax
เยีย	yie
ปวัด	buatc
กั้น	ganh
หอบ	horpc
เฮญี้ยว	hnyouv
ตะฟ่าน	Dafaanh
หวุย	uix
แซงคู้	saengkuv
ต้อ	dorh
เสี่ย	siec
ต๋อย	doix
โก๊ว	gouv
เญ์ย	nyeiz
ด๊ามลู่ง	ndaamvlungh
เหนาะ	norqc
ก๋อง	gorngx
เสีย	Siex
โต่ว	douc
ป๊วน	buonv
ฒู้ง	zungv
หละคุ	kuqv
เฮยี่ย	hieh
ฒ่อย	zoih
ปวัง	buang
หว่า	waac
ตอน	dorn
บัว	mbuo
ตอนเจว๊ย	dornjueiv
ฟุนฟะ	funfaqv
ปวั๊ง	buangv
ทิน	tin
เต่ย	Deic
โต้ว	douh
เดาเป้ย	ndaubeih
ญอง	nyorng
กะน้าย	ganaaiv
ค้อย	koiv
เบย์า	mbiauz
กั้ม	gamh
เหฑีย	nziex
จิว	jiu
กุ๊น	gunv
ไฮ่	haih
ต์ง	dongz
หญั่น	nyanc
ฮบ	hopv
อี้	ih
หญู่งๆ	nyungcnyungc
ฒิ่น	zinh
ด่าง	ndaangc
ไลแมง	laimaeng
ไลเมี้ย	laimiev
มี่ง	mingh
เซม	Sem
ฮาม	Haam
ยาเฟ้ด	Yaafetv
เฒ้ยฟุน	zeivfun
บยู่งซุ้ยอิ๋ม	mbiungcsuivimx
เหยียม	yiemx
ลิ์ว	liuz
ฆะฮ้า	nqa
ปัว	buo
ดุ	nduqc
หว่าเอ๋ย	Waaceix
ฟี่	fih
อับลาม	Apclaam
ฝีง	fingx
โฮล	hlo
เม่ง	mengh
โห่	hoc
เหฒียว	zioux
ฝีงๆ	fingxfingx
เมี่ยน	mienh
กาลาเทีย	Gaalaatie
หฒิว	ziux
เจ๊า	jauv
โล้ด	Lotv
ฮาลาน	Haalaan
เธี้ยด	cietv
เหฒียบ	ziepc
ฮม์	hmz
หฮญัง	hnyangx
เอ๊า	auv
ซาลาย	Saalaai
ฟุน	fun
เลี่ยม	liemh
หฒ่อน	zornc
เต้าๆ	dauh
คานาอัน	Kaanaaan
เต่ยปูง	deicbung
หมี่	mi
กัน	gan
เจี๋ย	jiex
เซเคม	Sekem
ฒี่ง	zingh
ติ้ว	diuh
ต้ม	domh
บะอง	mbaong
เฒวย	zuei
โมเล	Mole
หิ่น	hinc
น้าย	Naaiv
ฟุนฟะ	funfaqv
กงโฒ่	gongzoh
เหฒี่ยต้อง	ziecdorngh
เหฒี่ย	ziec
ซีนา	Sinaa
ฮู่ง	hungh
อัมลาเฟน	Amlaafen
เอนลาสา	Enlaasaax
อาลีโอก	Aaliokc
เอลาม	Elaam
เคโดลาโอเม	Kendolaaome
โกยิม	Goyim
ทิดาน	Tindaan
หฮญังเจ๊ย	hnyangxjeiv
จั๊ว	juov
เยีย	yie
เน่น	Nernh
เอนซัดได	En
หมวัง	muangx
หฒั่นๆ	zanczanc
ลั่ม	lamh
เฆ่ม	nqemh
ต๋อง	dorngx
อับลาฮัม	Apclaaham
มัมเล	Mamle
เดี๋ยงหล่ม	ndiangxlomc
เฒว์ย	zueiz
ด๊บลิ่ว	ndopvliuh
เก้า	gauh
ยัวะ	yuoqv
เฒี่ยง	ziangh
ซาลา	Saalaa
เสย	seix
หฒั่ง	zaangc
แป๊ะ	baeqv
หญี่	nyic
ฮลัง	hlang
โก๋	gox
ไห่	haic
หล่ง	longc
เห่ว	heuc
เคทูลา	Ketulaa
ธั้มเต้า	camvdauh
สิมลาน	Simxlaan
โย้กซาน	Yokvsaan
เมดาน	Mendaan
มีเดียน	Mindien
อิดบาก	Itcmbaakc
ชูวา	Quwaa
เชบา	Qembaa
เดดาน	Ndendaan
เหฌี่ย	njiec
อัดซูลิม	Atcsulim
เลทูซิม	Letusim
เลอุมมิม	Leummim
เอฟา	Efaa
เอเฟ	Efe
ฮาโน้ก	Haanokv
อาบีดา	Aambindaa
เอนดาอา	Enndaaaa
จาตี้ง	jaadingh
อีสัก	Isakc
หฑิบ	nzipc
เฒ้ย	zeiv
ปวั้ง	buangh
หฑุ่น	nzunc
ฮวาง	huaang
หง่อ	ngorc
เกลาอา	Gelaaaa
ยาโค้บ	Yaakopv
ววมค้วด	wuomkuotv
หล่มฮวาง	lomchuaang
กวั้น	guanh
ปะกี	ba
ยู่ง	yungh
เปว๋ย	bueix
กะเฮลน	gahlen
ฟินเมี่ยน	finmienh
แปง	baeng
ไฟ	fai
ทินฮู่ง	TinHungh
เธี้ยง	ciangv
มาหะนาอิม	Maahaanaaim
พ้าย	paaiv
เฝียน	fienx
เสอี	Sei
เอโดม	Endom
ล์อ	lorz
ก๋อ	gorx
เอซาว	Esaau
หฌาว	njaaux
เกา	gau
เฝย	feix
ฆอย	nqoi
ฝุเจว๊ย	fujueiv
เลอา	Leaa
ลาเซน	Laasen
อี	i
โน่ว	nouh
เป์ย	beiz
พัวะ	puoqv
หธีง	cingx
ฟัด	fatv
มป่า	mv baac
ถิว	tiux
ฒิบ	zipv
ชัม	qam
ฒม	zom
ยิวไท	Yiutai
เล์ยฝีง	leizfingx
ดีนา	Ndinaa
มเซียะ	m
หฑย่าว	nziaauc
ฮีไว	Hiwai
ไฮ์	haiz
ฮนั้ม	hnamv
หลง	longx
ดั๊ว	nduov
อี้	Ih
ซุ้ย	suiv
เบดเอน	Mbetcen
หมิ่วฝัง	miucfangx
กวั่ง	guangc
สา	saax
เหยี่ยน	yienc
ลุยโหว	luihoux
หธ่อ	corc
เตีย	die
โยเซ้บ	Yosepv
หลุน	lunx
ยูดา	Yundaa
เล่ย	leih
มั์วต่อย	muozdoic
เปย๋า	biaux
อาดุนลัม	Aandunlam
ฮีลา	Hilaa
ชูอา	Quaa
ซิน	sin
เออา	Eaa
ตะเหญ่ย	danyeic
โอนัน	Onan
เถง	tengx
ตอนโฮล	dornhlo
ทามา	Taamaa
หมั่ง	mangc
หว่าย	waaic
ไต่	daic
หธาม	caamx
ฟาโล	Faalo
โป้ว	bouh
อะหงุ่น	angunc
ติ๊ว	diuv
เจียน	jien
ฌั้ว	njuov
ต่อง	dorngc
เตี๋ย	diex
โก๋ว	goux
ติ่น	dinc
แปงเปย๊ย	baengbieiv
หววน	wuonx
โล่	loh
เล่า	lauh
เบ๋ย	mbeix
โซ้ว	souv
ไนอา	Naiaa
ด้าย	Ndaaih
เฮลน	hlen
ยั่ง	yangh
ง่ง	ngongh
เหฑว่ย	nzueic
จุ่น	junc
หลัวะ	luoqc
ติ	diqc
น่อม	normh
เบย้า	mbiauh
ม์าย	maaiz
ม่าะ!	maah!
หฮนาง	hnaangx
ไต่	daic
โค้ว	kouv
ฒ้าน	zaanv
ญ่าน	nyaanh
ตั๊บ	dapv
โย์วลาย	youzlaai
บัวะ	mbuoqc
ฑุ่ย	nzuih
โปว	bou
เอย	ei
ดอม	ndorm
เฑี้ยว	nziouv
เบี์ยวๆ	mbiouzmbiouz
ฌัง	njang
ฝูง	fungx
ล่อ	lorh
หฑวน	nzuonx
หฒิ	ziqc
หนั่ง	nangc
โก	go
ก๊าน	gaanv
หฒุ่น	zunc
หฒ่าย	zaaic
หน่าย	naaic
ก๋า	gaax
เยีย	yie
ติ่ว	diuc
บัว	mbuo
เญี์ยน	nyienz
ววมเหมว่ย	wuommueic
เป๊ะ	beqv
ม่าะ!	maah!
ฮิ้ว	hiuv
ฑ่อย	nzoih
กั๊บ	gapv
ฒุ้น	zunv
ฮี้ง	hingv
สี่	sic
ยาโค้บ	Yaakopv
อ่า	aac
อิสะลาเอน	Isaalaaen
ลูเบน	Lumben
ชะ	qaqv
ต้าว	daauh
สิเมโอน	Simeon
เลวี	Lewi
มั์ว	muoz
หฑุ	nzuqc
ด๊าว	ndaauv
โตะ	doqc
หวัวะ	wuoqc
กิ่น	ginc
ต๊า	daav
หฒะเอ๋ย	zaeix
ธ่าง	caangh
ล่าง	laangh
ไต๋	daix
เซว่ย	sueih
เอ๋ย	eix
ฮงะ	hngaqv
หลวั่ง	luangc
จาน	jaan
ตั๋ง	dangx
หลาย	laaix
เธี้ยว	ciouv
ยูดา	Yundaa
เธง	ceng
ปั์ว	buoz
วินวั้ง	winwangv
จาง	jaang
เกว่ย	gueic
ป๋าย	baaix
เซี่ยน	sienh
ซ้าว	saauv
หล่าว	laauc
ย่าง	yaangh
หงาด	ngaatc
อ๊อ	orv
บ๊าบ	mbaapv
ก๊าม	gaamv
แฮะ	haeqv
เญีย	nyie
โด้	ndoh
เฮมย	hmei
ฆว่า	nquaah
โหฑ	nzox
ซิ	siqv
ฑย้าม	nziaamv
ลุยด๊าว	luindaauv
เหยี่ยม	yiemc
เป๊ย	beiv
เดาโท้ว	ndautouv
เปี๊ยว	biouv
ธั้ม	camv
เสบูลุน	Sembulun
ค้อยเฮลน	koivhlen
ฑั้งโป่ว	nzangvbouc
กั๊บจ๋าย	gapvjaaix
ต๋าว	daaux
ไซดอน	Saindorn
อิดสาคา	Itcsaaxkaa
เฮ้น	henv
ล่าน	laanh
ต๋อ	dorx
บุด๋ง	ndongx
ดาน	Ndaan
แป้ง	baengh
ฟิม	fim
เซี้ยม	siemv
แปะ	baeqc
ฝีงอิสะลาเอน	fingxIsaalaaen
ดาน	Ndaan
นาง	naang
ปี๋ง	bingx
หฮลา	hlaax
เหญียะ	nyieqc
เบว์ย	mbueiz
เฒียะ	zieqv
ฒูง	zung
ไหน่	naic
ฮล้อบ	hlorpv
กู้งว์า	gunguaaz
อัน	an
หล่ม	lomc
ต่อ	dorc
โมเซ	Mose
หมั่ง	mangc
ตอง	dorng
หฑะเฮมียน	nzahmien
อาโลน	Aalon
แหง่ง	ngaengc
ฮ่อง	horngh
จั๋งโห่	jangxhoc
หฑั่ม	nzamc
เล์ยหลัด	leizlatc
ฑูง	nzung
เหฌียว	njoux
ทินฮู่งเยีย	TinHunghyie
ท่าย	taaih
เบ๊าะ	mborqv
แปง	baeng
โอ	O
บย่าว	mbiaauc
เจี๊ยะ	jieqv
โอ	O
ป่าย	baaic
หฌบ	njopc
โต์ว	douz
ปั๊ว	buov
ชุย	qui
ฆ้าว	nqaauv
หฒวัง	zuangx
เอลิม	Elim
สิน	sinx
เต่ยปูงฮวาง	deicbunghuaang
ซีนาย	Sinaai
บง	mbong
คัง	kang
เหลียบ	liepc
เธี้ยง	ciangv
เลฟีดิม	Lefindim
องตา	ongdaa
ไซ	sai
เยโท	Yeto
เม่ย	meih
สี	Se
กิ๊น	ginv
ธ้วด	Cuotv
ตู๋ง	dungx
เฒี่ยน	zienh
เล์ย	leiz
เป๊ย	Beiv
สี	Se
หฒะ	zaqc
หนิ่ม	nimc
อ๋อย	oix
ฝ่ง	fongc
ห่อ	horc
เจียม	jiem
สุย	suix
เซ้ด	setv
บั๊ว	mbuov
ซิห่ง	siqvhongc
ล่าม่า	lamaah
เดียหม่วน	ndiemuonc
เปยย	biei
ตัง	dang
กะลั้น	galanv
โย่ว	youh
ดาง	ndaang
หลาบ	laapc
หลิ่ว	liuc
หฒอบ	zorpc
ออน	orn
ฮูง	hung
จ๋าย	jaaix
หละเปย๊ยซิ	labieivsiqv
จาต๋อง	jaadorngx
แล์ง	laengz
ฟาง	Faang
กะเหญี่ย	ganyiec
ปิน	bin
ฮ่อม	hormh
ตะซุ	dasuqv
ปยา	biaa
เดาะ	ndorqc
จั๊ง	jangv
เฝยปูง	feixbung
เก๊าะ	gorqv
แพยง	piaeng
แน้ด	naetv
เปี้ยน	bienh
กะเดี๊ย	gandiev
แหมง	maengx
ด๊ามเหฒี่ยต้อง	ndaamvziecdorngh
แกง	gaeng
หลาด	laatc
น่าม	naamh
แบะ	mbaeqc
ต่ง	dongc
ไฟ	fai
เดีย	ndie
ทบ	topv
ท้าบ	taapv
เว่ย	weih
ปย๊า	biaav
ธอง	corng
ว้วน	wuonv
ตี๋ง	dingx
เงา	ngau
บั๋ว	Mbuox
หฒา	zaax
ติ้น	dinh
เหฒียะ	zieqc
เตี้ย	dieh
จอง	jorng
ด้ง	ndongh
ฮูอา	Huaa
อุลี	Uli
เบซาเลน	Mbesaalen
ก๊าด	gaatv
หละเปย๊ยจ๋าย	labieivjaaix
ธิ	ciqv
เหลาะ	lorqc
เดี๋ยงหฒั่ง	ndiangxzaangc
ติว	diu
เปี้ยง	biangh
ปั์วเต้า	buozdauh
อาโมไล	Aamolai
ฮิดไท	Hitvtai
เปลิดซี	Belitvsi
เยบุด	Yembutc
หฒุ	zuqc
คว้าย	kuaaiv
หละเปย๊ยเป๊น	labieivbenv
เฟี้ย	fiev
ฮู้	huv
หัด	hatc
เปี๋ยน	bienx
ดั๊ด	ndatv
ฒุ	zuqv
สีง	Singx
ฟูสู	fusux
จั๊บ	japv
หม่วน	muonc
เอโฟ้ด	efotv
จ๊าย	jaaiv
เจียมฝิน	jiemfinx
เหยียน	yienx
ฒี่	Zih
แซงเยี้ยด	saengyietv
หวุ่ย	wuic
มาน	maan
มฆ้อง	mnqorngv
ฟิ	fiqv
ฒุ์ย	zuiz
หาย	haaix
บ๊วนหม่วน	mbuonvmuonc
หาย	haaix
ธะโป่ว	caqvbouc
ฟิ	fiqv
เล์ยเหญ่ย	leiznyeic
เพี้ยด	pietv
ฮวีง	huing
หญุด	nyutc
เปว	beu
นิด	nitv
ปั๊น	banv
ฮลัน	hlan
อ๊อบย์อง	orvmbiorngz
ต้อ	Dorh
ปี๊ง	bingv
ตะเป๊ด	dabetv
นาดับ	Naandapc
อาบีฮู	Aambihu
เก๊าะเมี่ยน	gorqvmienh
ฮูงโล่ว	hunglouh
เฮยี้ยด	hietv
เต้ย	deih
บ๋าย	mbaaix
เหฮลง	hlengx
ฟาน	faan
โธ้	cov
สี	se
มจั่ง	mjangc
แฒะ	zaeqv
หฑาว	nzaaux
หฮมวัง	hmuangx
มัวะ	muoqv
เก้	geh
เนียมอ	niemor
ปีเต	Bide
เบี๊ยน	mbienv
เฮมียน	hmien
ไพ	pai
ไซ	sai
เอเสเคน	Eseken
เธียน	cien
หม่า	maac
น้าย	naaiv
ตี่ง	dingc
ฒุ่น	zunh
เหญ่ย	nyeic
เหฒีย	ziex
ไม้	maiv
เหล่ง	lengc
เจ๊ย	jeiv
นาสี	Naasi
เก่	gec
ววมซุย	wuomsui
เยียม	yiem
เถย	teix
ฒั้ว	zuov
ฮนอยเหญียะ	hnoinyieqc
เลี่ยว	liouh
บะเปยย	mbabiei
ซยาม	siaam
คู่	kuh
จั๋นไต่	janxdaic
เซย	sei
มา	maa
โย์ว	youz
หมั่ว	muoc
สี	se
เฒ่ย	zeih
กั๊วะ	guoqv
จาสี่	jaasic
จุ๊	juqv
เธีย	cie
ก๊ม	gomv
ลิ่ว	liuh
เปย๊ย	bieiv
ฒี่	zih
เถา	Taux
เหฑียมย่าง	nziemxyaangh
หฑัด	nzatc
บุย	mbui
คู้ด	Kutv
มิเลียม	Miliem
ซูง	sung
ปย๊าบย่า	biaavmbiaac
องถาย	ongtaaix
จวั่ง	juangc
หฒิว	Ziux
หลี่ง	lingc
เญ์ยซิ	nyeizsiqv
เอเลอาซา	Eleaasaa
ปั์วโด๊ะ	buozndoqv
โธะ	coqv
หูง	hungx
ทิว	tiu
ด๊บ	ndopv
จ้าง	jaangh
สีดา	sindaa
ฒ่ง	zongh
คาเดด	Kaandetc
เกวย	guei
หฒัง	zangx
ไกว๋	guaix
โมอับ	Moapc
เดาแป้ง	ndaubaengh
จอแดน	Jorndaen
เยลีโค	Yeliko
ต๋อยหง่าน	doixngaanc
สิบโป	Sipcbo
บาล้าก	Mbaalaakv
เก้ง!	gengh!
ธั้ม!	camv!
บาลาอัม	Mbaalaaam
อะเฮน้ย	hneiv
ฟ้าด	faatv
ตะฮน้า	dahnaav
ฮวิน	huin
ลี่ง	Lingh
เบโอ	Mbeo
มฒีง	mzing
ทง	tong
ซิดทิม	Sitvtim
เหฮยียน	hienx
หยัวะ	yuoqc
ววนแป่ง	wuonbaengc
ป่วน	buonc
เหฑ่ง	nzengc
ตะเยี้ยด	da
โฮ์ว	houz
มั์วเซียะ	muozsieqv
เธี้ยด	cietv
เล์ยป๋าย	leizbaaix
โฮ้ว	houv
ด๊อด	ndortv
โจ๋วๆ	jouxjoux
มัดทาย	Matvtaai
โหฆ	nqox
หฒะเก้ง	za
หละไกว้	fai
ป่า	baac
หาย	Haaix
เอ๊ากว๊า	auvguaav
เอ๊าเล่ย	auvleih
จา	jaa
จ๊าว	jaauv
วิน	win
ลูเบน	Lumben
กาด	Gaatc
ยาเซ	Yaase
กิเลอาด	Gileaatc
ปั์วเดี๊ย	buozndiev
ลามาเสด	Laamaasetc
สุกโค้ด	Sukckotv
เอทาม	Etaam
บาซาน	Mbaasaan
โอก	Okc
เอเดนอี	Endeni
ไฝ	faix
จั๋ง	jangx
หละเปย๊ย	labieiv
โญ์ว	nyouz
เฑ่า	nzauh
เญี้ยม	nyiemv
จูง	jung
ไฌ่	njaih
โม์ว	mouz
อาบีบ	Aambipc
เต่ยจ๋าย	deicjaaix
ม์านหฮมวัง	maanzhmuangx
มู้ง	Mungv
ฝัง	fangx
โหยว	youx
เฑี้ย	nziev
เฒ์ย	zeiz
หั่น	hanc
ล์าง	laangz
ก๋อย	goix
เฝง	fengx
โป๊ว	bouv
ดุ๊ด	ndutv
เฒย	zei
แอ๊ะ	aeqv
เจี์ย!	jiez!
ปะหละ	balaqc
ธับ	capv
ม์า	maaz
ม์าเธีย	maazcie
โอ่	oc
ฮ์อง	horngz
ไล่	laih
โด๊ะ	ndoqv
ววมต้าย	wuomdaaih
เน้า	nauv
ก๋อโย์ว	gorxyouz
น่า	naah
เกวน	guen
ลุย	lui
ดอบ	ndorpc
เล์า	lauz
เจ๊าเฮลน	jauvhlen
ปั่ว	buoc
เจ๋า	jaux
ต้อง	dorngh
หฒี่	zic
โสว	soux
โหม่ว	mouc
เซียว	siou
ถอง	torngx
ธุนแกง	cungaeng
ตน	don
ฮวุย	hui
หววด	wuotc
โยซูวา	Yosuwaa
ฒัวะ	zuoqv
โหละ	loqc
ต๋อยติ่ว	doixdiuc
หฑาน	nzaanx
มน่อม	mnormh
ป้าม	baamh
เกน	gen
โท้	Tov
ฑุ่ย	nzuih
ญิ่น	nyinh
ปองปั์ว	borngbuoz
นุน	Nun
ฆาย	nqaai
หฒะเก้ง!	zagengh!
บะฑิว	mbanziu
หยุ	yuqc
กวน	guon
ไม้	Maiv
ไอ	Ai
ธ้าง	caangv
ฒั้ว	zuov
หว่าน	waanc
ม์วน	muonz
บงไอ๊	mbongaiv
บงจั๊วะ	mbongjuoqv
เลบานอน	Lembaanorn
ฮาโซ	Haaso
ยาบิน	Yaambin
มาโดน	Maandon
โยบับ	Yombapc
ซิมโลน	Simlon
อักซ้าบ	Akcsaapv
ฮี่ง	hingh
อานโนน	Aannon
เฮโมน	Hemon
อาลาบา	Aalaambaa
แฑง	nzaeng
หธ่อ	Corc
ฟีลิสะเตีย	Filisaadie
เกซู	Gesu
ดั้ว	nduoh
ฝีงเปี๋ยน	fingxbienx
ปู้ง	bungh
ค้อยเฑ้า	KoivNzauv
เตว๊ยเมว์ย	dueivmueiz
ค้อยหธง	koivcongx
ววมฒี้ง	wuomzingv
แหธง	caengx
ลู้ด	Lutv
อาทาโล้ด	Aataalotv
อานคี	Aanki
มะนัดเส	Maanatvse
มาคี	Maaki
เหฒ่ง	zengc
อาบีเยเซ	Aambiyese
เฮเล้ก	Helekv
อัดลีเอน	Atclien
เฮเฟ	Hefe
เซมิดา	Semindaa
เสโลเฟหัด	Selofehatc
มาคีเล	Maakile
มาฮาลา	Maahaalaa
โฮ้กลา	Hokvlaa
มินคา	Minkaa
ทีละซา	Tilaasaa
สิเมโอน	Simeon
เบเอเชบา	Mbeeqembaa
เซ	se
เชบา	Qembaa
โมลาดา	Molaandaa
ด้าว	ndaauh
เขา	kaux
ธะโป่ว	Caqvbouc
หนิบ	nipc
ด๊ามฝีง	ndaamvfingx
ถายแป้ง	taaixbaengh
นอมๆ	normnorm
กินกาน	Gingaan
โบคิม	Mbokim
เค้า	kauv
โฮ์	hoz
เอฮู้ด	Ehutv
เดโบลา	Ndembolaa
อาบีโนอัม	Aambinoam
ป๋าว	baaux
แบ๋งง่าม	mbaengxngaamh
แบ๋งค้วด	mbaengxkuotv
อามาเล้ก	Aamaalekv
เอฟาอิม	Efaaim
กิเดโอน	Gindeon
เบ๊าะ	mborqv
เตา	dau
ฝู่ง	fungc
สี่	sic
เฑ์า	nzauz
แก๊ะ	gaeqv
เฒ์ย	zeiz
มาโนอา	Maanoaa
โสลา	Solaa
แซมสัน	Saemsanx
ทิมนาฮา	Timnaahaa
กาซา	Gaasaa
หม่าย	maaic
มีคา	Mikaa
หฮญังต้าว	hnyangxdaauh
เอดทาโอน	Etctaaon
ฒ่า	zaah
มี่ง	mingh
โอ่	oc
เบดเลเฮม	Mbetclehem
จ๊าเฒ่ย	jaavzeih
ปุ๊ด	butv
โหฆ	nyei
ยูเดีย	Yundie
แซ้ง	Saengv
ขวิน	kuinx
ตะเฝย	dafeix
เซียะล่าง	sieqvlaangh
หญั่น	nyanc
ตั้ง	dangh
หมั่น	manc
มี่ง	daaih
เอลีเมเล้ก	Elimelekv
นาโอมี	Naaomi
มาโลน	Maalon
คิลิโอน	Kilion
เอฟาทา	Efaataa
เธียนเธะ	cienceqv
โบอาด	Mboaatc
ปุ๊ด	butv
บวั์ง	mbuangz
ไฟ	fai
บาลี	mbaali
กะน้ายเธ้น	ganaaivcenv
หฑยาว	nziaaux
อ๋าน	aanx
ปั่ง	bangc
ลามาทาอิม	Laamaataaim
โซว	sou
ลามาทาอิมโซฟิม	Laamaataaim
ลามา	Laamaa
เอนคานา	Enkaanaa
เยโลฮัม	Yeloham
เอลีฮู	Elihu
โทหุ	Tohu
ฟะ	faqv
สูบ	Supc
ซามูเอน	Saamuen
เอลี	Eli
เฒียน	zien
เอเบนเอเซ	Embenese
อาเฟ้ก	Aafekv
ไบ้	mbaih
เซวย	suei
ธิน	cin
คีลิย้าดเยอาลิม	Kiliyaatv
อาบีนาดับ	taux
กู้	gu
หงว่าย	nguaaic
มิดปาต้อ	MitvbaaDorh
โยเอน	Yoen
ตอนไฝ	dornfaix
อาบียา	Aambiyaa
เบนยามิน	Mbenyaamin
คี้ด	Kitv
อาบีเอน	Aambien
เสโล	Selo
เบโคลัด	Mbekolatv
อาฟียา	Aafiyaa
ปุ๊ดฒ่อย	butvzoih
เซาโล	Saulo
ด่ง	ndongc
แบ่ง	mbaengc
บะเต้า	mbadauh
โต๋	dox
ไฟ	fai
กีก	Gikc
เป๊าะ	borqv
กุ๊น	gunv
ธีง	cing
ป่วน	buonc
อัมโมน	Ammon
นาหาด	Naahaatc
ยาเบดกิเลอาด	Yaambetc
ยาเบด	Gileaatc
โท้	tov
เม่ย	fusux
ดาวิด	Ndaawitv
โยนาทาน	Yonaataan
ไจ๊	jaiv
จวังหฒิน	juangzinx
โหวฮลาง	houxhlaang
จุนแปง	junbaeng
เหมว่ย	mueic
หธัง	cangx
เหย	heix
เฌียนโย่ว	njienyouh
โฑ์	nzoz
พัด	patv
ต้าน	daanh
ป้า	baah
ปิ่น	binc
เซาโล	Saulo
ธินๆ	cincin
หว่านๆ	waancwaanc
นิ่น	ninh
หว่านๆ	waancwaanc
หญู่ง	haaix
ปู๋ง	bungx
เอ๊าะ	orqv
เมี้ยน	mienv
ม่อ	morh
ฑัง	nzang
ธัง	cang
ปิว	biu
ฑบ	nzopv
หฌ่ง	njongc
ตีง	ding
เจี๊ยน	jienv
ซิ้ม	simv
โน้บ	Nopv
อาหิเมเล้ก	Aahimelekv
หฒิน	zinx
เหว่ย	Weic
มาโค	Maako
ลูกา	Lugaa
กัด	Gatc
ฒง	zong
เฉียม	qiemx
ดาวิด	Ndaawitv
เอนเกดี	En
เต่ยปูงฮวาง	nyei
แบ๋ง	mbaengx
โด	ndo
โฒ้ว	zouv
ปาลาน	Baalaan
มาโอน	Maaon
คานเมน	Kaanmen
สิบอา	Sipcaa
กิเบอา	Gimbeaa
ฮาคีลา	Haakilaa
เยซิโมน	Yesimon
ต๋อยหง่าน	doixngaanc
ยิดเลเอน	Yitvleen
อาคิด	Aakitv
ฆาง	nqaang
กินโบอา	Ginmboaa
เฮย	hei
เฮโบโลน	Hembolon
อัมโนน	Amnon
อาหิโนอัม	Aahinoam
คิเลอาบ	Kileaapc
นาบาน	Naambaan
อาบีกายิน	Aambigaayin
ตะฟาม	dafaam
อับซาโลม	Apcsaalom
ทันไม	Tanmai
มาอาคา	Maaaakaa
อาโดนียา	Aandoniyaa
ฮักกีด	Hakvgitc
ตะฮม์	Dahmz
เซฟาทิยา	Sefaatiyaa
อาบีทัน	Aambitan
ตะหลัวะ	Daluoqc
อิดเลอัม	Itcleam
เอกลา	Ekclaa
อับเน	Apcne
มต้าย	mdaaih
ฑย้ามเฟย	nziaamvfei
จวั่ง	juangc
บู๊ง	mbungv
อ๊อ	orv
ห่อย	hoic
นาทัน	Naatan
ด๊บลิ่ว	ndopvliuh
ม่าย	maaih
วิ่น	winh
เอน	en
นิ่น	ninh
ม่าย	Maaih
จ่ม	jomc
เสลุยา	Seluyaa
โยอาบ	Yoaapc
เทโคอา	Tekoaa
ธงเม่ง	congmengh
ฑ้าด	nzaatv
บงนี้ง	mbongningv
เมฟีโบเซ้ด	Mefimbosetv
ซิบา	Simbaa
เคน	ken
ปุ่ย	buic
ทอ	tor
ดุ้น	ndunh
เปี๊ยวฆาย	biouvnqaai
กอง	gorng
ด๊บบัวะ	ndopvmbuoqc
อาหิโทเฟน	Aahitofen
ติ๊ม	dimv
ธัวะ	cuoqv
บีกลี	Mbikcli
เจียดซี	Jetcsi
เมว์ย	mueiz
เซ	Se
โหฒ่	zoc
ห่ม	homc
สวัง	suangx
เซี้ยว	siouv
ซาโลมอน	Saalomorn
เยลูซาเลม	Yelusaalem
กิเบโอน	Gimbeon
สาโดก	Saaxndokc
อาซาลิยา	Aasaaliyaa
ชีชา	Qiqaa
เอลีโฮเล้บ	Eliholepv
อาหิยา	Aahiyaa
โซวปิ๊ว	soubiuv
อาหิลู้ด	Aahilutv
เยโฮซาฟัด	Yehosaafatv
โซวตาน	soudaan
เยโฮยาดา	Yehoyaandaa
เบไนยา	Mbenaiyaa
อาบียาทา	Aambiyaataa
แซ้งเฒี้ยว	saengvziouv
สาบุด	Saaxmbutc
อาหิชา	Aahiqaa
อับดา	Apcndaa
อาโดนีลัม	Aandonilam
อ๊าบ	aapv
กงเมี่ยน	gongmienh
จวัง	juang
ไทละ	Tailaqv
ฮีลาม	Hilaam
หฒัวะ	zuoqc
ดาวิด	Ndaawitv
วุ่ย	wuih
ปูงๆ	bungbung
เหฒาเดี๊ย	zauxndiev
ฟาม	faam
เก้ม	gemh
ฟ่า	faah
เลี์ยว	liouz
เดี้ยว	ndiouh
แฮ่ง	haengh
สิโอน	Sion
เอทานิม	Etaanim
บย๊อ	Mbiorv
ฝุน	funx
อะ	aqc
ท่อ	torh
หฮนางเตี้ย	hnaangxdieh
ฒองฒุ	zorngzuqv
ติ๊วฒ้าน	diuvzaanv
เผย	peix
ฝู่	fuc
เสียน	sienx
เลโหโบอัม	Lehoxmboam
วั้ว	Wuov
เนบัด	Nembatc
เยโลโบอัม	Yelomboam
อียิบ	Iyipv
เยี้ยด	yietv
หล่ง	longc
เหฒี่ย	ziec
แป่ง	baengc
ฒอง	zorng
ซีโล	Silo
ฮานานี	Haanaani
เยฮู	Yehu
บาอาชา	Mbaaaaqaa
ซีเลีย	Silie
อาลัม	Aalam
เบนฮาดัด	Haandatc
แปงกวั้น	baengguanh
สะมาเลีย	Saamaalie
นาโบด	Naambotc
อาหับ	Aahapc
นาอามาน	Naaaamaan
ก้ม	gomh
เซียะไฝ	sieqvfaix
เอลีซา	Elisaa
เหบ	hepc
หลิ่ว	Liuc
ลาโม้ดกิเลอาด	Gileaatc
นิมซี	Nimsi
ฉง	qongx
อาหัดยา	Aahatcyaa
โยอาด	Yoaatc
เยโฮอาหาด	Yehoaahaatc
ป์าม	baamz
เยโฮอาด	Yehoaatc
อามาซิยา	Aamaasiyaa
เยโฮอัดดิน	Yehoatcndin
เลมาลิยา	Lemaaliyaa
เปคา	Bekaa
โยทาม	Yotaam
อาหัด	Aahatc
เอลา	Elaa
โฮเซยา	Hoseyaa
เฮเซคียา	Hesekiyaa
เสคาลิยา	Sekaaliyaa
อาบี	Aambi
เป๊ด	betv
เดียโธว	ndiecou
เอลียาคิม	Eliyaakim
เซ้บนา	Sepvnaa
อาม้อด	Aamortv
อิสะยา	Isaayaa
หน่าน	naanc
ไญ้	nyaiv
เฮ้บซีบา	Hepvsimbaa
เยเลมี	Yelemi
โฮลๆ	hlohlo
ไฝๆ	faixfaix
หฌุ่น	njunc
เยโฮยาคิม	Yehoyaakim
บาบีโลน	Mbaambilon
เนบูคัดเน้ดซา	Nembukatvnetvsaa
ดานีเอน	Ndaanien
เสเดคียา	Sendekiyaa
ตะจั๊ว	dajuov
แซงเหฒียบ	saengziepc
แซงจั๊ว	saengjuov
อิดสาคา	Itcsaaxkaa
เสบูลุน	Sembulun
นับทาลี	Napvtaali
อาเซ	Aase
เปเล้ด	Beletv
เฮ้ดโลน	Hetvlon
คานมี	Kaanmi
โซบาน	Sombaan
เลอายา	Leaayaa
ยาหาด	Yaahaatc
อาหุไม	Aahumai
ลาฮ้าด	Laahaatv
เกโซน	Geson
โคฮ้าด	Kohaatv
เมลาลี	Melaali
อัมลาม	Amlaam
อิดฮา	Itchaa
อุดซีเอน	Utcsien
อิทามา	Itaamaa
ฟีเนหัด	Finehatc
อาบีชูวา	Aambiquwaa
บุกคี	Mbukcki
อุดซี	Utcsi
เสลาหิยา	Selaahiyaa
เมลาโย้ด	Melaayotv
อามาลิยา	Aamaaliyaa
อาหิทู้บ	Aahitupv
อาหิมาอัด	Aahimaaatc
โยฮานัน	Yohaanan
กว๊าด	guaatv
เยโฮซาดัก	Yehosaandakc
โทลา	Tolaa
พูอา	Puaa
ยาซู้บ	Yaasupv
เลไฟยา	Lefaiyaa
เยลีเอน	Yelien
ยาไม	Yaamai
อิบสัม	Ipcsamx
ตาน	daan
อิสะลาหิยา	Isaalaahiyaa
มีคาเอน	Mikaaen
โอบาดี	Ombaandi
อิดซียา	Itcsiyaa
ตอนเตี๋ย	dorndiex
เหฮยียด	hietc
เบลา	Mbelaa
เบเค	Mbeke
เยดียาเอน	Yendiyaaen
เอดโบน	Etcmbon
เยลีโม้ด	Yelimotv
อิลี	Ili
เสมิลา	Semilaa
เอลีเยเซ	Eliyese
เอลีโอไน	Elionai
โอมลี	Omli
เยเลโม้ด	Yelemotv
อานาโท้ด	Aanaatotv
อาเลเม้ด	Aalemetv
บินฮาน	Mbinhaan
เยอูด	Yeutc
เคนาอะนา	Kenaaaanaa
เสทาน	Setaan
ทานซิด	Taansitv
อาหิชาฮา	Aahiqaahaa
ซุบปิม	Supvbim
หุบปิม	Hupcbim
อีละ	Ilaqv
หุซิม	Husim
อาเฮ	Aahe
อัดเบน	Atcmben
อาหะลา	Aahaalaa
โนฮา	Nohaa
ลาฟา	Laafaa
อัดดา	Atcndaa
เกลา	Gelaa
อาบีฮู้ด	Aambihutv
อาโหอา	Aahoxaa
เซฟูฟาน	Sefufaan
หุลาม	Hulaam
เกบา	Gembaa
มานาฮ้าด	Maanaahaatv
อุดซา	Utcsaa
อาหิฮู้ด	Aahihutv
ซาหะลาอิม	Saahaalaaim
บาอาลาอา	Mbaaaalaaaa
โฮเดด	Hondetc
สิเบีย	Simbie
เมซา	Mesaa
มันคาม	Mankaam
ป๊วนเต่ย	buonvdeic
เนหะมี	Nehaami
สิกล้าก	Sikclaakv
หละเปย๊ยหฒั่ง	labieivzaangc
ซัมมุวา	Sammuwaa
โซบับ	Sombapc
เอลีซามา	Elisaamaa
เบเอนยาดา	Mbeenyaandaa
เอลีเฟเล้ด	Elifeletv
อุลีเอน	Ulien
อาสายา	Aasaaxyaa
เอลีซาฟาน	Elisaafaan
เซไมอา	Semaiaa
เอลีเอน	Elien
อัมมีนาดับ	Amminaandapc
ฟิ้วล์าง	fiuvlaangz
โฑว	nzou
โสบา	Sombaa
ฮาดัดเอเซ	Haandatcese
ฮามัด	Haamatv
ยูเฟติด	Yufeditc
ฒ้าง	zaangv
ดามัดกัด	Ndaamatvgatc
แปงเธี้ยง	baengciangv
เจียมท้องป้าย	jiemtorngvbaaih
ซาตาน	Saadaan
เยียม	Yiem
เฟี้ย	fiev
ตุ๋น	dunx
หธะเหล่ง	calengc
อาสาบ	Aasaapc
เฮมาน	Hemaan
เยดูทูน	Yendutun
ฟิ้วต้าน	fiuvdaanh
ฆ้าบ	nqaapv
ธ่าว	caauh
สักเก	Sakcge
เนทานิยา	Netaaniyaa
อาชาเลลา	Aaqaalelaa
เกดาลิยา	Gendaaliyaa
เสลี	Seli
เยซายา	Yesaayaa
ซิเมอี	Simei
ฮาซาปิยา	Haasaabiyaa
มัดทีทิยา	Matvtitiyaa
โหะ	hoqc
ปั้น	banh
เหฒ่ย	zeic
เฮลียะ	hlieqv
เปน	ben
บั๊วแมง	mbuovmaeng
หละเปย๊ยหม่วน	labieivmuonc
หละเปย๊ยเมา	labieivmau
ฒิ่น	Zinh
เก๋ง	gengx
ดอมๆ	ndormndorm
ม์วนๆ	muonzmuonz
เซียงหฮลา	SiangHlaax
เต๋า	daux
เก๋า	gaux
ฌังหล่าง	njanglaangc
เซียงเหธย	siangceix
ฮามัดโสบา	Haamatv
ทัดโม	Tatvmo
โจ๋ว	joux
พ้อ	porv
ซิซัก	Sisakv
โอเดด	Ondetc
อาสา	Aasaax
บู้ง	mbungh
บาอัน	Mbaaan
หฒวด	zuotc
อาเซลา	Aaselaa
ธีงจา	cingjaa
ฑอง	nzorng
โน์ว	nouz
แปงเป๊ย	baengbeiv
เยโฮฮานัน	Yehohaanan
อิสะมาเอน	Isaamaaen
โอเบด	Ombetc
อาดายา	Aandaayaa
มาอาเสอา	Maaaaseaa
สิกลี	Sikcli
เอลีซาฟัด	Elisaafatv
สิบียา	Simbiyaa
หฒ่อ	zorc
โฑวฒิ่น	nzouzinh
หฮญังๆ	hnyangxhnyangx
เซี้ยบๆ	siepvsiepv
เบ่น	mbenc
สี่	Mv
ก๊าน	gaanv
เยลูซา	Yelusaa
อุดซียา	Utcsiyaa
ป์อง	borngz
เปย๊า	biauv
โอเฟน	Ofen
ล่าว	laauh
คอย	koi
หละเปย๊ยต่ง	labieivdongc
แธะ	caeqv
เหมียด	mietc
ปุนไซ	BunSai
อัดซีเลีย	Atcsilie
เซนนาเคลิบ	Sennaakelipv
โยสิยา	Yosiyaa
หฒาย	zaaix
ก๊อย	goiv
หฒั่งเญย	ZaangcNyei
เฝียว	fioux
จอม	jorm
โยอาหาด	Yoaahaatc
ไซลัด	Sailatv
เปเซีย	Besie
เอสะลา	Esaalaa
ป๊วนมู้ง	buonvmungv
ป๊วนล์าง	buonvlaangz
เสลุบบาเบน	Selupvmbaamben
เยซูอา	Yesuaa
เสไลอา	Selaiaa
เลเอไลยา	Leelaiyaa
โมเดไค	Mondekai
บินซาน	Mbinsaan
มิดปา	Mitvbaa
บิกไว	Mbikcwai
เลฮูม	Lehum
บาอานา	Mbaaaanaa
ปาโล้ด	Baalotv
อาลา	Aalaa
ฮักไก	Hakvgai
อิดโด	Itcndo
เต๊ง	dengv
เซอันทิเอน	Seantien
โยซาดัก	Yosaandakc
บะฮนอย	mbahnoi
ทัดเทไน	Tatvtenai
เชทาโบเซไน	Qetaa
เซียงเหลียบ	aengx
เจี์ย	siangliepc
ดาลิอัด	Ndaaliatc
มีเดีย	Mindie
เอกบาทานา	Ekcmbaataanaa
ลับ	lapv
เหฆน	nqenx
ธั้มหฮญัง	camvhnyangx
อานทาเซซี้ด	Aantaasesitv
ฮินคียา	Hinkiyaa
ซันลูม	Sanlum
เกโซม	Gesom
ฮัดทัด	Hatvtatv
เซคานิยา	Sekaaniyaa
สันบานลัด	Sanxmbaanlatv
ฮว้วด	huotv
ชะ!	qaqv!
งบ	ngopv
ฮานันยา	Haananyaa
เชบานียา	Qembaaniyaa
มันลุก	Manlukv
มาอาซิยา	Maaaasiyaa
บินไก	Mbingai
กินเนทอย	Ginnetoi
อาหะสุเอลัด	Aahaasuelatv
กะเฉีย	gaqiex
ฟิว	fiu
วัดชาที	Watvqaati
อากัก	Aagakc
ฮัมเมดาทา	Hammendaataa
ฮามาน	Haamaan
เอเซเท	Esete
ฌ่อม	njormh
อาดา	Aandaa
ทิ้ว	tiuv
เทมาน	Temaan
เอลีฟัด	Elifatv
โย้บ	Yopv
อ้า!	aah!
เฝย	feix
ฟ่าน	faanh
เฑียง	nziang
ป้าม	Baamh
กงฒิ่น	gongzinh
บินดัด	Mbinndatc
หฒั่น	zanc
เพียน	pien
หฒีง	zingx
โล์	loz
อะฮนอย	ahnoi
โคะ	koqv
ลิ่น	linh
โย้บ	Yopv
นาอาเม	Naaaame
โสฟา	Sofaa
ก๊อง	gorngv
เฒ์ย	Zeiz
ไกว	guai
ไอ๊	aiv
เมี่ยน	Mienh
โหฒะ	zoqc
ธงเม่ง	congmengh
ว่วน	wuonh
ฒาง	zaang
ตั๊ง	dangv
หม่อ	morc
นั้ง	nangv
ป๊า	baav
ออนเหลาะ	ornlorqc
บาง	mbaang
ฝุเจว๊ยไฝ	fujueivfaix
เฮล้าด้ง	hlauvndongh
หนู	nux
เหน่า	nauc
หญิด	nyitc
คู้	kuv
ต๋องต้าว	dorngxdaauh
กอนแป๋ง	gornbaengx
แล่ง	laengh
แก๊ง	gaengv
อม	om
เน่น	Nernh
เด่ยเหฆน	ndeicnqenx
เอาะ	orqc
เก้ง	gengh
เฒี้ยง	ziangv
มุน	mun
เฒียน	Zien
เว้ด	wetv
หฮลาเหญียะ	hlaaxnyieqc
เตี๊ย	diev
จ๊า	jaav
ตุ้น	dunh
ยุ่น	yunh
เสี่ยว	siouc
เผีย	piex
หฑยาวหฒุ่น	nziaauxzunc
กอนโด๊ะ	gornndoqv
หาย	haaix
ล่อ	lorh
ฮลาง	hlaang
เดาฮวาง	ndauhuaang
เดาฑ่าย	ndaunzaaih
ฮลาง	hlaang
หธุน	cunx
ขวัง	kuangx
จ๋าฒิ่น	jaaxzinh
แซงเอ๋ย	saengeix
ธังโฟว	cangfou
ธง	Congmengh
อ๋า	aax
หฮนางฆาย	hnaangxnqaai
เซ้ก	sekv
หฮงง	hngongx
โป่ว	bouc
หว่าซับ	waacsapv
เมา	mau
ผุย	puix
ตุ้ย	duih
ซอง	sorng
แกงหฒวัง	gaengzuangx
เหฒา	zaux
ไบ	mbai
เหฒา	zaux
ดิ๋ว	ndiux
ฮนั้ง	hnangv
ฌิ้ม	njimv
เหญี่ย	nyiec
ยาเค	Yaake
อากู	Aagu
เป๊ย	Beiv
ทิบ	tipv
ก๊องเหม	gorngvhemx
ก๊องแปะ	gorngvbaeqc
ธุนเธียว	cunciou
จั๊ด	jatv
ฒอย	zoi
ล่าย	laaih
หลุ่ย	luic
หลง	longx
เญา	nyau
เฮยี้ยน	hienv
เฮนี้ย	hniev
งัด	ngatv
เมี่ยน	mienh
เล์ย	leiz
มู์ง	mungz
เหฒวย	zueix
ติ๊	diqv
ค้วด	kuotv
เญาะ	nyorqv
พิ	piqv
เดี๋ยงด้ง	ndiangxndongh
เหฒะ	zeqc
บ๋วน	mbuonx
ป๊ะ	baqv
เซียงบวั์ง	siangmbuangz
มูหย่อ	muyorc
เมว์ยต้อง	mueizdorngh
เมว์ยเผง	mueizpengx
หญอ	nyorx
ตาบ	daapc
เฮ่	heh
ธั่ม	camh
ฒุ่ย	zuih
จุ้น	junh
หธอ	corx
โฮ่ว	houh
แซง	saeng
เสียว	sioux
ฑู่ง	nzungh
ฆว้า	nquaav
ฒัด	zatv
เจี๊ยบ	jiepv
นางเจี๊ยะ	naangjieqv
ค้วดด่าง	kuotvndaangc
ค้อเลี่ยน	korvlienh
หง่าน	ngaanc
เอทีโอเปีย	Etiobie
ด๊าด	ndaatv
ดัดๆ	ndatc
จ๊บเหญ่ย	jopvnyeic
เสฟันยา	Sefanyaa
เธียต๋อย	ciedoix
เยี่ยน	yienh
เซี้ยบ	siepv
มี่งๆ	mingh
ต้ายๆ	mingh
ลุ่ย	luih
เลวีอาทาน	Lewiaataan
โชวๆ	qouqou
ฆวิน	nquin
ด๋ง	ndongx
แกว๊ง	guaengv
ต๊บ	dopv
อ๊าว	aauv
ตังโธ้	dangcov
กั๋น	ganx
กู้งว์าบัวะ	gunguaazmbuoqc
ม้วด	muotv
ไธ	cai
เญีย	nyie
กงฟิม	gongfim
ปิ๋ว	biux
เจี์ย	Jiez
เธา	cau
นี้ง	ningv
ดุย	ndui
เดี๋ยงฆว่า	ndiangxnquaah
ญัง	nyang
เบว๋ย	mbueix
ลู่ง	Lungh
อาโมน	Aamon
เฒี้ยว	Ziouv
เยีย	yie
อิสะลาเอน	Isaalaaen
ฮลู่ง	hlungh
ฮล้วด	hluotv
ฒี้ง	zingv
เฒว่ย	zueih
ฮ์าน	haanz
ปย๊บ	biopv
ไฆ้	nqaiv
อิมเม	Imme
ปาดเฮ	Baatche
แป๊ด	baetv
ลู้	luv
เดี๋ยงก์า	ndiangxgaaz
ก์า	gaaz
โซวหฌุ่น	sounjunc
เนบูซาละดาน	Nembusaalaandaan
หลิ่ม	limc
มิกโดน	Mikvndon
ทาปานเหด	Taabaanhetc
เมมฟิด	Memfitv
เนลิยา	Neliyaa
ฮามุทาน	Haamutaan
ลิบนา	Lipvnaa
ฌ้วด	njuotv
แมะ	maeqv
ฟอง	forng
ฟองด้ง	forngndongh
ธุ้น	cunv
เนียฒุน	niezun
กอนป๊วน	gornbuonv
เด่ย	ndeic
เมี้ยเปี้ยง	mievbiangh
นอ	nor’Meih
หมั่นๆ	mancmanc
โหย่ว	youc
เจ้า	jauh
เหธว	ceux
หลุ่น	lunc
หมั่ง	mangc
หละค้วด	lakuotv
เซียะหลุน	Sieqvlunx
โอโฮลา	Oholaa
เฑี์ย	nziez
โอโฮลีบา	Oholimbaa
เธี้ย	ciev
อาโม้ด	Aamotv
ตะเหฒียบ	daziepc
ทีง	ting
เคบา	Kembaa
เฒี้ยว	ziouv
กะญั์ว	Gunyuoz
ธี่ง	cingh
เบาะ	mborqc
นิด	Nitv
เหฒ่ง	Zengc
ธีงเหฑ่ง	Cingnzengc
เจียมฝัง	jiemfangx
เบนซัดซา	Mbensatvsaa
ต๋น	donx
โฮล!	hlo!
โหธว	coux
ฑุด	nzutv
วั้ว	Wuov
แอ๋ง	Aengx
ไซ	Sai
ฮลางฮลบ	hlaanghlopv
ทาโบ	Taambo
แฒง	zaeng
อาคาเซีย	Aakaasiezoux
เซียม	siem
เหมา	maux
ฒองเหฒง	zorngzengx
ดิ๊	ndiqv
ฒุ์ยหนิบ	zuiznipc
จั๋นหฒะ	janxzaqc
ฒู่ง	zungh
เปทุเอน	Betuen
คานเน	Kaanne
อามิดไท	Aamitvtai
โยนา	Yonaa
กะเซีย	gasie
ต๊า	Daav
นินะเว	Ninaawe
เจ๊าคู้	jauvkuv
ฮาบากุก	Haambaagukc
คูซี	Kusi
เหญี่ยม	nyiemc
ฌุ่น	njunh
จู๊	juv
เธา	cau
ได๋	ndaix
คิดเล้บ	Kitvlepv
แซงเฝย	saengfeix
ธุน	cun
เกว๋ย	gueix
บยู่ง	mbiungc
เยซู	Yesu
กีตู่	Giduc
อุลียา	Uliyaa
โยลัม	Yolam
เฮโล้ด	Helotv
สัม	samx
เหฮลย	hleix
เซีย	sie
ส่วน	suonc
เต๋ยม่าย	deixmaaih
ทินต้อง	tindorngh
ไซก๋อ	saigorx
ค้อยตอน	KoivDorn
โผว	poux
ฟาลิสี	Faalisi
บะฮนอย	dau
อ๊า	aav
ฮ่อ	horh
ฌัง	njang
หฮลอง	hlorngx
โล่ะ!	aav
ดอมเฑี้ยว	ndormnziouv
บ๋วนเจี๊ยะ	mbuonxjieqv
อี้	ih
บยู่งหฑยาว	mbiungcnziaaux
กาลิลี	Gaalili
โพวทง	poutong
ธี้ง	cingv
หฮวีงเฒี้ยว	huingxziouv
มาลี	maazli
เซียะตอน	sieqvdorn
เซียงล่าง	sianglaangh
คาเปนาอุม	Kaabenaaum
หน่อย	noic
เปย๊าง่อ	biauvngorh
โฒ้วเก้ม	zouvgemh
เกนเนซาเล้ด	Gennesaaletv
ดั๊ว	nduov
หว่าเป๊ย	waacbeiv
คานา	Kaanaa
ธีงจายิ่น	cingjaayinh
เยียมทอย	yiemtoi
แม่ง	maengh
เฮมยฆว่า	hmeinquaah
เตว๊ย	dueiv
กิ๊ด	gitv
ถุย	tuix
ปีล้าด	Bilaatv
ปย๊าปิน	biaavbin
ลุยด๊าวหลัวะ	luindaauvluoqc
ซีโมน	Simon
โทมัด	Tomatv
ซูงกู้งว์า	SungGunguaaz
นาทานาเอน	Naataanaaen
เสเบดี	Sembendi
อานาเนีย	Aanaanie
สับฟีลา	Sapcfilaa
ฑง	nzong
เฑ้บ	nzepv
โต์	doz
สะเทเฟน	Saatefen
จิวปาง	jiubaang
จั๋น	Janx
อีโคนียูม	Ikoniyum
เปาโล	Baulo
บานาบัด	Mbaanaambatc
ซีลา	Silaa
อัมฟีบุลี	Amfimbuli
อาปอโลเนีย	Aaborlonie
เทสะโลนิกา	Tesaalonigaa
อาเทน	Aaten
อาควินลา	Aakuinlaa
ปอนทัด	Borntatv
ปิดสินลา	Bitcsinxlaa
อิตาลี	Idaali
คาลาวดิอัด	Kaalaaundiatc
ทิโมไท	Timotai
มาซีโดเนีย	Maasindonie
กู๊	guv
ฮยาง	hiaang
เททูลัด	Tetulatv
ซีซาลียา	Sisaaliyaa
หฒูง	zungx
เฟสะทัด	Fesaatatv
อัดลามิดทิยุม	Atclaamitvtiyum
เอเซีย	Esie
ซีลีเซีย	Silisie
ปัมฟีเลีย	Bamfilie
ลีเซีย	Lisie
เบี๋ยน	mbienx
ค้อยโฑว	koivnzou
มอนตา	Morndaa
จวั๊ง	juangv
ก๊อง	gorngv
เฒ์ย!	zeiz!
ต๋าย	daaix
หลวน	luonx
ห่อง	horngc
เหมา	maux
เหลี่ยว	liouc
ต๊น	donv
ฟีลิบพอย	Filipvpoi
บย์อง	mbiorngz
โยวเฑ่า	younzauh
เป่ย	beic
นั่ง	nangh
อาเมน	Aamen
จิ๊ว	jiuv
ทิตัด	Tidatc
เฑ่า	nzauh
สาย	saaix
หล่ง	longc
จั๋นกีก	JanxGikc
เก๊า	gauv
ต่อง	dorngcmeih
ดาม	ndaam
บย๋าง	mbiaangx
โธว	cou
โคโลสี	Kolosi
เซี้ย	siev
เม้า	mauv
ควั้น	kuanv
เทียน	tien
หว่าหฒ่าน	waaczaanc
หว่าโธว	waaccou
พะลี	pali
พะหลาย	palaaix
เหว่ย	weic
หมิ่วฝัง	miucfangx
ขูงหว่า	kungxwaac
โน่วเยีย	nouhYie
ว้วน	wuonv
โท้!	tov!
ยูโอเดีย	Yuondie
สินทิเค	Sinxtike
เคนเมน	Kenmen
กว๋า	guaax
โจ้ว	jouh
หฒัน	zanx
กงโฒ่เยีย	gongzohYie
เลาดีเซีย	Laundisie
เฮญี้ยวฒ่อย	hnyouvzoih
เกม	gem
บย่าง	mbiaangc
ก๋อ	Gorxyouz
เหม	hemx
หละเญ้า	lanyauv
โด๊ว	ndouv
หลงๆ	longxlongx
ฮ่า	haah
คี	ki
เอนฒี่ง	enzingh
ฒั้น	zanv
หล่าง	laangc
ฉัง	qangx
หญุ่น	nyunc
ฟินแซง	finsaeng
เหฮลียว	hlioux
โก๊วไหล่	gouvlaic
หว่าฮู้	waachuv
เหง	hengx
เอ๊าจ๋าน	auvjaanx
เจียนโฟ้ว	jienfouv
น่อ	norh
ฟีเลโมน	Filemon
ฒุ์ย	zuiz
เซียงลู่ง	sianglungh
กีงโซว	GingSou
นิ่น	taux
เล์ย	Leizlatc
หลัด	latc
โล์ฮนอย	lozhnoi
แคะ	kaeqv
เจียมปั์วโด๊ะแฑง	jiembuozndoqvnzaeng
ลุยโหวฮู้	luihouxhuv
จ๋า	jaax
คับปาโดเซีย	Kapvbaandosie
บิทีเนีย	Mbitinie
เอเฟโซ	Efeso
เจียมจ๋า	jiemjaax
ต้าย	daaih
ปย้อง	biorngh
เหฑียะ	nzieqc
ด๊ามนอม	ndaamvnorm
ปย๊าเดาะ	biaavndorqc
ปย้อง	biorngh
โม่ว	mouh
เซียงฑูง	siangnzung
ปุ้น	bunh
เล่ง	lengh
ไจ่	jaic
ฟางต้าว	faangdaauh
ฟางหฆาย	faangnqaaix
อิม	im
โต๊	dov
หธัม	camx
ชอง	qorng
ฟง	fong
ม่วน	muonh
ม่าะ	maah
เสด	Setc
ปาด	baatc
จ้อย	joih
หมิ่วเปย๊า	miucbiauv
ฆวะ	nquaqv
ดิบ	ndipc
แก้ง	gaengh
ซ้าย	saaiv
หฮยาม	hiaamx
เฮยห่อง	heihorngc
ปู๋งซีง	bungxsing
ปู๋งเฉีย	bungxqiex
ซ้ายดุย	saaivndui
ฮลุด	hlutv
ปั์วโด๊ะแฑง	buozndoqvnzaeng
เหฒาเฮลน	zauxhlen
อ้า	aah
เหมย	meix
ปู๊	buv
ล่ง	longh
โขว	koux
ก๊า	gaav
แฒะเฒี้ยว	zaeqvziouv
ขูงม่อง	kungxmorngh
โบ๊ว	mbouv
หฮวาญิ์น	huaaxnyinz
เป๊ว	beuv
เดาฆาย	ndaunqaai
ท้อง	torngv
เต่ยปูงฮ์าน	deicbunghaanz
ฮนอยๆ	hnoihnoi
เหฒียม	ziemx
ฑั่ง	nzangh
เธงโฮล	cenghlo
ซ่าะ	saah
เป้ย	beih
เนีย	nie
อา​ดัม	Aandam
ฮา​วา	Haawaa
คา​อิน	Kaain
อา​แบน	Aambaen
ทอย	toi
ธา	caa
นีอา	niaa
หมอง	morngx
นะ	naqv
โฌ่ว	njouh
หฮวา	huaax
เอ​เดน	Enden
เอ​โน้ก	Enokv
ลา​เม้ก	Laamekv
อา​ดา	Aandaa
เซียง	siang
ตี๊	div
ฒวั้ง	zuangv
เอ​โน้ด	Enotv
เค​นัน	Kenan
มา​หะ​ลา​เลน	Maahaalaalen
ยา​เล้ด	Yaaletv
เม​ทู​เส​ลา	Metuselaa
โน​ยา	Noyaa
ยา​เฟ้ด	Yaafetv
อา	Aa
ฮ้าบ	haapv
โฆ	nqo
คา​นา​อัน	Kaanaaan
โก​เม	Gome
มา​โกก	Maagokc
มา​ได	Maandai
ยา​วาน	Yaawaan
ทู​บัน	Tumban
เม​เซ้ก	Mesekv
ทิ​ล้าด	Tilaatv
อัด​เค​นัด	Atckenatv
ลี​ฟ้าด	Lifaatv
โท​กาน​มา	Togaanmaa
เอ​ลี​เซ​อา	Eliseaa
ทาน​ซิด	Taansitv
คิด​ทิม	Kitvtim
โล​ดา​นิม	Londaanim
อี​ยิบ	Iyipv
พู้ด	Putv
เส​บา	Sembaa
ฮา​วิ​ลา	Haawilaa
สับ​ทา	Sapctaa
ลา​อา​มา	Laaaamaa
สับ​เท​คา	Sapctekaa
เช​บา	Qembaa
เด​ดาน	Ndendaan
นิม​โล้ด	Nimlotv
ต๊าม	daamv
นิ​นะ​เว	Ninaawe
ลู​ดิม	Lundim
อา​นา​มิม	Aanaamim
เล​หะ​บิม	Lehaambim
นับ​ทู​ฮิม	Napvtuhim
ฮี​ไว	Hiwai
อาน​คา	Aankaa
สี​นี	Sini
เอ​ลาม	Elaam
อัด​ซู	Atcsu
อาน​ฟา​ซัด	Aanfaasatv
ลู​เด	Lunde
อา​ลัม	Aalam
อูด	Utc
ฮูน	Hun
เก​เท	Gete
เช​ลา	Qelaa
เอ​เบ	Embe
โย้ก​ทาน	Yokvtaan
อัน​โม​ดัด	Anmondatc
เช​เล้บ	Qelepv
ฮา​ซาน​มา​เว้ด	Haasaanmaawetv
เย​ลา	Yelaa
ฮา​โด​ลัม	Haandolam
อุ​ซาน	Usaan
ดิก​ลา	Ndikclaa
อา​บี​มา​เอน	Aambimaaen
โอ​ฟี	Ofi
โย​บับ	Yombapc
ฟั่น	fanh
บา​เบน	Mbaamben
เป​เล้ก	Belekv
เล​อู	Leu
เส​ลุก	Selukv
นา​โฮ	Naaho
เท​ลา	Telaa
อับ​ลาม	Apclaam
ฮา​ลาน	Haalaan
ซา​ลาย	Saalaai
มิน​คา	Minkaa
เน​เกบ	Negepc
ฟา​โล	Faalo
เบด​เอน	Mbetcen
โส​โดม	Sondom
โก​โม​ลา	Gomolaa
อัด​มา	Atcmaa
เส​โบ​ยิม	Semboyim
เบ​ลา	Mbelaa
น้าย	Naaiv
โส​อา	Soaa
ฒี่ง	Zingh
ทา​มา	Taamaa
อา​มา​เล้ก	Aamaalekv
อา​โม​ไล	Aamolai
สิด​ดิม	Sitcndim
ดา​มัด​กัด	Ndaamatvgatc
เค​โด​ลา​โอ​เม	Kendolaaome
แอ๋ง	aengx
อา​เน	Aane
เอด​โค	Etcko
มัม​เล	Mamle
ท้องป้าย	torngvbaaih
เอ​ลี​เย​เซ	Eliyese
อับ​ลา​ฮัม	Apclaaham
ก๊บ	gopv
ญ่วน	nyuonh
ฮิด​ไท	Hitvtai
เป​ลิด​ซี	Belitvsi
เล​ฟา​อิม	Lefaaim
ฮา​กา	Haagaa
อิ​สะ​มา​เอน	Isaamaaen
ซา​ลา	Saalaa
นี	ni
หฒ่าม	zaamc
โล้	lov
เหฒี่ยว	ziouc
ฟ้ง	fongv
ปาน	baan
เก​ลา​อา	Gelaaaa
อา​บี​เม​เล้ก	Aambimelekv
อี​สัก	Isakc
โห่ว	houc
ฑิด	nzitv
เบ​เอ​เช​บา	Mbeeqembaa
ล่ม	lomh
โดะ	ndoqc
ฮา​โซ	Haaso
เบ​ทู​เอน	Mbetuen
เล​เบ​คา	Lembekaa
เฮ​โบ​โลน	Hembolon
โส​หา	Sohaax
เอ​โฟ​โลน	Efolon
ฒ่าง	zaangh
โค	ko
โล	lo
อง	ong
กู๋	gux
ลา​บาน	Laambaan
คั้ง	kangv
ฒ้อ	zorv
เค​ทู​ลา	Ketulaa
โย้ก​ซาน	Yokvsaan
มิด​มา	Mitvmaa
ดู​มา	Ndumaa
ฮา​ดัด	Haandatc
เท​มา	Temaa
เย​ทู	Yetu
นา​ฟิด	Naafitv
เค​เด​มา	Kendemaa
เอ​ซาว	Esaau
ยา​โค้บ	Yaakopv
ตบ	dopc
ฟี​ลิ​สะ​เตีย	Filisaadie
เบ​เอ​ลี	Mbeeli
เอ​โลน	Elon
บา​เส​มัด	Mbaasematv
ฮลัว	hluo
ฑ์ม	nzomz
ลา​เซน	Laasen
เสียง	siangx
เน์า	nauz
เปี๊ยด	bietv
ลา​บาน	Laambaan
เผียน	pienx
บิน​ฮา	Mbinhaa
เล​อา	Leaa
เล​วี	Lewi
นับ​ทา​ลี	Napvtaali
สิน​ปา	Sinxbaa
วิด	witv
ซาว	saau
ดู​ดา​อิม	ndundaaim
เจี้ย	jieh
ดี​นา	Ndinaa
เตี๊ยม	diemv
พุย	pui
พยัด	piatv
อิ​สะ​ลา​เอน	Isaalaaen
โย​เซ้บ	Yosepv
เส​อี	Sei
ฮา​โม	Haamo
เซ​เคม	Sekem
สิ​เม​โอน	Simeon
ปุ๋ย	buix
เอ​ฟา​ลา​ทา	Efaalaataa
เบน​ยา​มิน	Mbenyaamin
อา​เซ	Aase
เซ	se
เอ​ลี​ฟัด	Elifatv
เล​อู​เอน	Leuen
เท​มาน	Temaan
โอ​มา	Omaa
เส​โฟ	Sefo
นา​หัด	Naahatc
เฒ​ลา	Zelaa
อา​นา	Aanaa
เย​อูด	Yeutc
ยา​ลาม	Yaalaam
โค​ลา	Kolaa
โอ​โฮ​ลี​บา​มา	Oholimbaamaa
เอ​โดม	Endom
โฮ​ลี	Holi
โฮ​มัม	Homam
โล​ทาน	Lotaan
ทิม​นา	Timnaa
โซ​บาน	Sombaan
มา​นา​ฮ้าด	Maanaahaatv
เอ​บาน	Embaan
โอ​นัม	Onam
ดี​โซน	Ndison
เอด​บาน	Etcmbaan
อิด​ลาน	Itclaan
เค​ลาน	Kelaan
เอ​เซ	Ese
ดี​ซาน	Ndisaan
อา​ลัน	Aalan
สิ​เบ​โอน	Simbeon
เอ​โดม	Endom
ดิน​ฮา​บา	Ndinhaambaa
โบ​ซา​ลา	Mbosaalaa
หุ​ซาม	Husaam
เบ​ดัด	Mbendatc
โม​อับ	Moapc
มี​เดียน	Mindien
อา​วี้ด	Aawitv
สัม​ลา	Samxlaa
เล​โห​โบด	Lehoxmbotc
ซา​อุน	Saaun
อัก​โบ	Akcmbo
อัน​วา	Anwaa
เย​เท้ด	Yetetv
เอ​ลา	Elaa
ปี​โนน	Binon
เค​นัด	Kenatv
มิบ​ซา	Mipvsaa
โด​ทาน	Ndotaan
ลู​เบน	Lumben
ยู​ดา	Yundaa
ชู​อา	Quaa
เอ​อา	Eaa
โอ​นัน	Onan
ฮิบ​ลู	Hipvlu
เจย	jei
ไน​อา	Naiaa
ต๊อ	dorv
เหญา	nyaux
แล่	laeh
ซีง	sing
ฟี้ง	fingv
ฮา​โน้ก	Haanokv
ปัน​ลู	Banlu
เฮ้ด​โลน	Hetvlon
คาน​มี	Kaanmi
เย​มู​เอน	Yemuen
ยา​มีน	Yaamin
โอ​หาด	Ohaatc
ยา​คีน	Yaakin
เก​โซน	Geson
โค​ฮ้าด	Kohaatv
เม​ลา​ลี	Melaali
อิด​สา​คา	Itcsaaxkaa
โท​ลา	Tolaa
ซิม​โลน	Simlon
เส​บู​ลุน	Sembulun
เส​เล้ด	Seletv
ยา​เล​เอน	Yaaleen
ฮัก​กี	Hakvgi
ซู​นี	Suni
เอด​โบน	Etcmbon
เอ​เล​อี	Elei
อา​เล​ลี	Aaleli
อิม​นา	Imnaa
อิด​วา	Itcwaa
อิด​วี	Itcwi
เบ​ลี​ยา	Mbeliyaa
เซ​ลา​อา	Selaaaa
เฮ​เบ	Hembe
เบ​เค	Mbeke
อัด​เบน	Atcmben
เก​ลา	Gelaa
นา​อา​มาน	Naaaamaan
อาด	Aatc
หุ​ซิม	Husim
ยา​ซี​เอน	Yaasien
กุ​นี	Guni
เย​เซ	Yese
ซิน​เลม	Sinlem
โก​เซน	Gosen
ญิม	nyim
มะ​นัด​เส	Maanatvse
เอ​ฟา​อิม	Efaaim
ญ่า	nyaah
เธย	cei
จอ​แดน	Jorndaen
มา​คี	Maaki
โม​เซ	Mose
อา​โลน	Aalon
เฒียง	ziang
เหลว่ย	lueic
ลิบ​นี	Lipvni
ซิ​เม​อี	Simei
มา​ลี	maazli
มู​ซี	Musi
อิด​ฮา	Itchaa
เน​เฟ้ก	Nefekv
สิก​ลี	Sikcli
อุด​ซี​เอน	Utcsien
มิ​ซา​เอน	Misaaen
เอน​ซา​ฟาน	Ensaafaan
นา​โซน	Naason
นา​ดับ	Naandapc
อิ​ทา​มา	Itaamaa
อัด​สี	Atcsi
เอน​คา​นา	Enkaanaa
เอ​เล​อา​ซา	Eleaasaa
ฟี​เน​หัด	Finehatc
ย่าม	yaamh
ฒิ	ziqv
ไหธ	caix
เปย๊าเฮลน	biauvhlen
ฟ้าน	faanv
โต์วเหฑ่า	douznzauc
เปาะ	borqc
บา​ลี	mbaali
มับ	mapv
เฒี้ยว	Ziouv
ด๊าม	ndaamv
โหฒ่ว	zouc
สุก​โค้ด	Sukckotv
ธี่	cih
อา​บีบ	Aambipc
เหฒียด	zietc
มิ​เลียม	Miliem
เอ้าะ	orqv
เมาะ	morqv
เล​ฟี​ดิม	Lefindim
ฮู​อา	Huaa
โย​ซู​วา	Yosuwaa
หฒุด	zutc
เย​โท	Yeto
จ๊าง	jaangv
ซี​นาย	Sinaai
บง	Mbongningv
บงเหฆน	mbongnqenx
ฮั่น	hanh
ลู์ง	lungz
ปุ้ย	buih
เหล่ย	leic
แหว่ง	waengc
อา​บี​ฮู	Aambihu
ควีง	kuing
เค​ลู​บิม	kelumbim
แว่ง	waengh
ลุ่น	lunh
เน้ก	nekv
โคว	kou
หว่วน	wuonc
เอ​โฟ้ด	efotv
ผาน	paanx
ดี้ง	ndingh
ดามตอง	ndaamdorng
หฆัน	nqanx
ฮยวัง	hiuang
กีง	ging
เผว	peux
อุ​ลี	Uli
เบ​ซา​เลน	Mbesaalen
บ๊วน	mbuonv
ซ้อด	sortv
เซียวเซ้ด	siousetv
เย​บุด	Yembutc
แอ๊ง	aengv
โอ​โฮ​ลี​อับ	Oholiapc
กู้ง	gungh
กั่ง	gangc
ญัด	nyatv
แธะจ้าง	caeqvjaangh
ธาน	caan
เกาะ	gorqc
เควย	kuei
จุ๋ย	juix
แธง	caeng
น้าด	naatv
อุ​ลิม	Ulim
ทุม​มิม	Tummim
ปั๊วะ	buoqv
อ๋ม	omx
เซี้ยด	sietv
ปั์วฒ้าง	buozzaangv
แมง	maeng
กว้าย	guaaih
ล์าว	laauz
โม​เล้ก	Molekv
เซี่ยว	siouh
เฑี้ยบ	nziepv
ฮลาว	hlaau
เซ​โล​มิด	Selomitv
ป๊วนฝีง	buonvfingx
สู​ลิ​ซัด​ได	Suxlisatvndai
เซ​ลู​มิ​เอน	Selumien
อัม​มี​นา​ดับ	Amminaandapc
ฒู​อา	Zuaa
เน​ทัน​เอน	Netanen
เฮ​โลน	Helon
เอ​ลี​อับ	Eliapc
อัม​มี​ฮู้ด	Ammihutv
เอ​ลี​ซา​มา	Elisaamaa
เป​ดา​ซู	Bendaasu
กา​มา​ลิ​เอน	Gaamaalien
กิ​เด​โอ​นี	Gindeoni
อา​บี​ดัน	Aambindan
อา​หิ​เย​เซ	Aahiyese
โอ​คาน	Okaan
ปา​กี​เอน	Baagien
เด​อู​เอน	Ndeuen
เอ​ลี​ยา​สาบ	Eliyaasaapc
เอ​นัน	Enan
อา​หิ​ลา	Aahilaa
อัม​ลาม	Amlaam
เอ​ลี​ซา​ฟาน	Elisaafaan
บอง	mborng
มา​นา	maanaa
เหมวย	mueix
เฒ้บ	zepv
สัก​เก	Sakcge
ซัม​มุ​วา	Sammuwaa
ซา​ฟัด	Saafatv
เย​ฟุน​เน	Yefunne
คา​เล้บ	Kaalepv
อิ​กาน	Igaan
โฮ​เซ​ยา	Hoseyaa
มี​คา​เอน	Mikaaen
หย่าว	yaauc
เห่	hec
เฑีย	nzie
หฒิด	zitc
โฮ​มา	Homaa
ต๋อยเตก	doixdekc
ดา​ทาน	Ndaataan
อา​บี​ลัม	Aambilam
เซียงสี่	siangsic
เยี่ยม	yiemh
โล่ะ	loh
ฒ่อง	zorngh
เม​ลี​บา	Melimbaa
คา​เดด	Kaandetc
โฮ​อา	Hoaa
อา​ล้าด	Aalaatv
นางโตะ	naangdoqc
เฒ​เล้ด	Zeletv
สิ​โหน	Sihonx
เฮ้ด​โบน	Hetvmbon
เค​โม้ด	Kemotv
เบี่ย	mbiec
สิบ​โป	Sipcbo
บา​ล้าก	Mbaalaakv
บา​ลา​อัม	Mbaalaaam
หล่าย	laaic
บา​อัน	Mbaaan
เหฒง	zengx
เบ​โอ	Mbeo
เค​ไน	Kenai
เป​โอ	Beo
สิม​ลี	Simxli
โค้ด​บี	Kotvmbi
สู​อา	Suxaa
โอด​นี	Otcni
ยา​ซู้บ	Yaasupv
อัด​ลี​เอน	Atclien
เซ​มิ​ดา	Semindaa
เฮ​เฟ	Hefe
เส​โล​เฟ​หัด	Selofehatc
มา​ฮา​ลา	Maahaalaa
โฮ้ก​ลา	Hokvlaa
ที​ละ​ซา	Tilaasaa
ซู​ฮัม	Suham
กิ​เล​อาด	Gileaatc
มา​คี​เล	Maakile
อา​บา​ลิม	Aambaalim
เอ​วี	Ewi
เล​เคม	Lekem
เล​บา	Lembaa
จู์ง	jungz
มิก​โดน	Mikvndon
ลิบ​นา	Lipvnaa
ทา​หัด	Taahatc
โย้ด​บา​ทา	Yotvmbaataa
โอ​โบด	Ombotc
เน​โบ	Nembo
อัด​โมน	Atcmon
เม​ดิ​เต​เล​เนียน	Mendidelenien
ฮา​มัด	Haamatv
เส​ดัด	Sendatc
บุก​คี	Mbukcki
ฮัน​นี​เอน	Hannien
เค​มู​เอน	Kemuen
ปัน​ที​เอน	Bantien
อา​หิ​ฮู้ด	Aahihutv
เอ​เดน​อี	Endeni
อัด​ทา​โล้ด	Atctaalotv
บา​ซาน	Mbaasaan
โฮ​เล้บ	Holepv
ฒิ่น	Zinh
อา​น้าก	Aanaakv
ยา​ฮ้าด	Yaahaatv
อาน​โกบ	Aangopc
ซอน	sorn
เฮ​โมน	Hemon
ไซ​ดอน	Saindorn
เส​นี	Seni
โมว	mou
เป๊น	benv
อา​ลา​บา	Aalaambaa
ปิด​กา	Bitcgaa
จั๊วะ	juoqv
เจี้ยน	jienh
แฆะ	nqaeqv
หมะ	maqc
จั๊ม	jamv
ธ้าย	caaiv
ลง	long
เหว่ย	weic
ขูงปั์ว	kungxbuoz
เจี๋ยม	jiemx
ฟิน	fin
อัม​โมน	Ammon
ไง่	ngaih
หลิ่น	linc
โตว	dou
แป๋ง	baengx
ทุด	tutv
เก​ลิ​ซิม	Gelisim
ถง	tongx
อา​เมน	Aamen
ปัวะ	buoqc
ฆ้าด	nqaatv
ยัง	yang
ลา​หับ	Laahapc
กิน​กาน	Gingaan
เย​ลี​โค	Yeliko
สับ​ดี	Sapcndi
อา​คาน	Aakaan
ดั๊บ	ndapv
กิ​เบ​โอน	Gimbeon
เบ​เอ​โล้ด	Mbeelotv
เย​ลู​ซา​เลม	Yelusaalem
ยาน​มู้ด	Yaanmutv
ลา​คี้ด	Laakitv
ยา​เฟีย	Yaafie
เอก​โลน	Ekclon
เด​บี	Ndembi
อา​เซ​คา	Aasekaa
มัก​เค​ดา	Makvkendaa
ไอ​ยา​โลน	Aiyaalon
เก​เซ	Gese
ยา​บิน	Yaambin
มา​โดน	Maandon
อัก​ซ้าบ	Akcsaapv
มิด​ปา	Mitvbaa
เท้า	tauv
อา​ดุน​ลัม	Aandunlam
ทับ​ปู​วา	Tapvbuwaa
อา​เฟ้ก	Aafekv
เม​กิด​โด	Megitcndo
เค​เดด	Kendetc
คาน​เมน	Kaanmen
โย้ก​เน​อัม	Yokvneam
โก​ยิม	Goyim
เก​ซู	Gesu
มา​อา​คา	Maaaakaa
สา​เล​คา	Saaxlekaa
เค​เด​โม้ด	Kendemotv
เม​ฟา​อาด	Mefaaaatc
บา​อา​ลา	Mbaaaalaa
ทิม​นา​ฮา	Timnaahaa
อัก​สา	Akcsaax
โอด​นี​เอน	Otcnien
ต์าน	daanz
สิบ​อา	Sipcaa
เท​เลม	Telem
เบ​อา​โล้ด	Mbeaalotv
เซ​มา	Semaa
โม​ลา​ดา	Molaandaa
เอ​เซม	Esem
เอน​โท​ลัด	Entolatv
สิก​ล้าก	Sikclaakv
มัด​มัน​นา	Matvmannaa
โส​โค	Soko
โบด​ค้าด	Mbotckaatv
เอ​เท	Ete
อา​ชัน	Aaqan
อัด​นา	Atcnaa
อา​น้าบ	Aanaapv
เอด​เท​โม​อา	Etctemoaa
อา​หลับ	Aalapc
มา​โอน	Maaon
ยิด​เล​เอน	Yitvleen
เก​โด	Gendo
อา​ทา​โล้ด	Aataalotv
นา​อา​ลา	Naaaalaa
ซี​โล	Silo
อับ​วิม	Apcwim
โอ​ฟา​ลา	Ofaalaa
ลา​มา	Laamaa
โม​ซา	Mosaa
คี​ซิ​โอน	Kision
เอ​เบด	Embetc
ฮัม​มัด	Hammatv
คิน​เน​เล้ด	Kinneletv
โส​ลา	Solaa
เอด​ทา​โอน	Etctaaon
เอ​โค​โลน	Ekolon
เอน​เท​เค	Enteke
กิบ​เบ​โทน	Gipcmbeton
บา​อา​ลัด	Mbaaaalatv
เบ​เซ้ก	Mbesekv
เซ​ไซ	Sesai
อา​หิ​มาน	Aahimaan
ทัน​ไม	Tanmai
อัก​ซี้บ	Akcsipv
เล​โหบ	Lehopc
เอ​ฮู้ด	Ehutv
เบี่ยน	mbienc
อา​น้าด	Aanaatv
ซัม​กา	Samgaa
เด​โบ​ลา	Ndembolaa
อา​บี​โน​อัม	Aambinoam
ทา​โบ	Taambo
สิ​เส​ลา	Siselaa
ติ่ม	dimc
หญ่ม	nyomc
หธง	congx
กิ​เด​โอน	Gindeon
โย​อาด	Yoaatc
ววมเฮลน	wuomhlen
เบียด	mbietc
อา​บี​เย​เซ	Aambiyese
เฒ​บา	Zembaa
สัน​มุน​นา	Sanxmunnaa
เป​นู​เอน	Benuen
เฮ​เล้ด	Heletv
กาม	gaam
โย​ทาม	Yotaam
เบ​เอ	Mbee
เส​บุน	Sembun
กา​อัน	Gaaan
คีง	king
เฑ้า	nzauv
ฮ์า	haaz
เท​เบด	Tembetc
ซา​มี	Saami
จา​อี	Jaai
เย้บ​ทา	Yepvtaa
อา​โล​เอ	Aaloe
เบด​เล​เฮม	Mbetclehem
ปิ​ลา​โทน	Bilaaton
อับ​โดน	Apcndon
มา​โน​อา	Maanoaa
แซม​สัน	Saemsanx
แกว๋ง	guaengx
กา​ซา	Gaasaa
เด​ลิ​ลา	Ndelilaa
ฆั้ม	nqamv
มี​คา	Mikaa
ลา​อิด	Laaitc
กิ​เบ​อา	Gimbeaa
วั้ว	Wuov
นา​โอ​มี	Naaomi
เอ​ลี​เม​เล้ก	Elimelekv
ลู​เท	Lute
มา​โลน	Maalon
คิ​ลิ​โอน	Kilion
ญาม	Nyaam
จั้ว	juoh
เฮนี้ยๆ	hnievhniev
มา​ลา	Maalaa
โบ​อาด	Mboaatc
อ๋ง	ongx
ธั้มๆ	camvcamv
เฑียน	nzien
ท้ง	tongv
ลาม	Laam
สัน​โมน	Sanxmon
โอ​เบด	Ombetc
เจียด​ซี	Jetcsi
ดา​วิด	Ndaawitv
ป๊วนฒี่ง	buonvzingh
เอ​ลี	Eli
โฮ้บ​นี	Hopvni
เป​นิน​นา	Beninnaa
ฮัน​นา	Hannaa
แซงยู์ง	saengyungz
ซา​มู​เอน	Saamuen
อัด​โดด	Atcndotc
โล์ต๋อง	lozdorngx
อา​บี​นา​ดับ	Aambinaandapc
ดั๊ม	ndamv
เซา​โล	Saulo
โฒ่ว	zouh
ฝุย	fuix
ยา​เบด	Yaambetc
นา​หาด	Naahaatc
มิก​ม้าด	Mikvmaatv
ซู​อัน	Suan
โย​นา​ทาน	Yonaataan
อา​หิ​ยา	Aahiyaa
อับ​เน	Apcne
เน	Ne
อา​บี​เอน	Aambien
ซู​วา	Suwaa
อา​กัก	Aagakc
ซัม​มา	Sammaa
เฮมียนฝัง	hmienfangx
โก​ลิ​อัด	Goliatc
หนาม	naamx
ซา​อา​ลา​อิม	Saaaalaaim
เซียะโฮล	Sieqvhlo
เม​ล้าบ	Melaapv
มี​คาน	Mikaan
นา​โย้ด	Naayotv
อา​หิ​เม​เล้ก	Aahimelekv
อา​คิด	Aakitv
โด​เอก	Ndoekc
อา​หิ​ทู้บ	Aahitupv
อา​บี​ยา​ทา	Aambiyaataa
เค​อี​ลา	Keilaa
นา​บาน	Naambaan
อา​บี​กา​ยิน	Aambigaayin
อา​หิ​โน​อัม	Aahinoam
เส​ลุ​ยา	Seluyaa
โย​อาบ	Yoaapc
อา​บี​ไช	Aambiqai
ซู​เนม	Sunem
กิน​โบ​อา	Ginmboaa
โป๋	box
เตียน	dien
เค​เล​ที	Keleti
เยียะ	yieqv
ลา​โม้ด	Laamotv
ย้าด​ที	Yaatvti
เย​ลา​เม​เอน	Yelaameen
อ๊อบ	orpv
เจี้ยม	jiemh
ยา​ซา	Yaasaa
อิด​โบ​เซ้ด	Itcmbosetv
มา​หะ​นา​อิม	Maahaanaaim
ฌ่าง	njaangh
อา​สา​เฮน	Aasaaxhen
อัม​โนน	Amnon
อา​โด​นี​ยา	Aandoniyaa
ฮัก​กีด	Hakvgitc
เซ​ฟา​ทิ​ยา	Sefaatiyaa
กิด​ทา​อิม	Gitctaaim
ลิม​โมน	Limmon
เล​ค้าบ	Lekaapv
บา​อา​นา	Mbaaaanaa
มิน​โล	Minlo
นา​ทัน	Naatan
ซา​โล​มอน	Saalomorn
อิบ​ฮา	Ipchaa
เอ​ลี​ซู​วา	Elisuwaa
เอ​ลี​ยา​ดา	Eliyaandaa
เอ​ลี​เฟ​เล้ด	Elifeletv
เก​บา	Gembaa
อุด​ซา	Utcsaa
หวี่ง	wingc
หลาม	laamx
สี​ดา	sindaa
โส​บา	Sombaa
ฮา​ดัด​เอ​เซ	Haandatcese
ยู​เฟ​ติด	Yufeditc
ซี​เลีย	Silie
เย​โฮ​ยา​ดา	Yehoyaandaa
เบ​ไน​ยา	Mbenaiyaa
เพ​เล้ด	Peletv
ซิ​บา	Simbaa
เม​ฟี​โบ​เซ้ด	Mefimbosetv
ฮา​นูน	Haanun
บัด​เช​บา	Mbatcqembaa
อุ​ลี​อา	Uliaa
ลับ​บา	Lapvmbaa
อับ​ซา​โลม	Apcsaalom
โย​นา​ดับ	Yonaandapc
เท​โค​อา	Tekoaa
อิด​ไท	Itctai
สา​โดก	Saaxndokc
อา​หิ​มา​อัด	Aahimaaatc
อา​หิ​โท​เฟน	Aahitofen
หุ​ไซ	Husai
บา​ซิน​ไล	Mbaasinlai
อา​มา​สา	Aamaasaax
บีก​ลี	Mbikcli
อิ​ละ	Ilaa
ไอ​อา	Aiaa
ลิด​ปา	Litvbaa
ซี​เม​ฮา	Simehaa
เหฑ่น	nzenc
แหฆ่ง	nqaengc
เต้า	Dauh
อา​โห​ไฮ	Aahoxhai
โด​โด	Ndondo
ฮา​ลา	Haalaa
เอน​ฮา​นัน	Enhaanan
ฮา​โล้ด	Haalotv
เฮ​เล้ด​เท	Heletvte
อิก​เขด	Ikcketc
อา​นา​โท้ด	Aanaatotv
หุ​ซา	Husaa
เน​โท​ฟา	Netofaa
มา​หะ​ไล	Maahaalai
ลี​ไบ	Limbai
กา​อัด	Gaaatc
บา​ฮู​ลิม	Mbaahulim
อัด​มา​เว้ด	Atcmaawetv
อา​หิ​ยัม	Aahiyam
กิ​โลน	Gilon
เฮ้ด​โล	Hetvlo
บา​นี	Mbaani
เส​เล้ก	Selekv
นา​หะ​ไล	Naahaalai
อิด​ไล	Itclai
กา​เล้บ	Gaalepv
อุ​ลี​ยา	Uliyaa
ยา​เซ	Yaase
อา​ลาว​นา	Aalaaunaa
นิ่น	Ninh
อา​บี​ช้าก	Aambiqaakv
อา​ซา​ลิ​ยา	Aasaaliyaa
อา​หิ​ลู้ด	Aahilutv
อิด​โด	Itcndo
เย​โฮ​ซา​ฟัด	Yehosaafatv
ไจ	jai
ฮี​ลาม	Hilaam
เล​บา​นอน	Lembaanorn
อา​โด​นี​ลัม	Aandonilam
หลอง	lorngx
เทย	tei
เดี๋ยงเป๊น	ndiangxbenv
ตาว	daau
ฑิบ	nzipv
ย่วน	yuonh
ไท​ละ	Tailaqv
ล์ง	longz
เซ่ง	sengh
หฑ่อม	nzormc
สิ​โอน	Sion
กา​ลิ​ลี	Gaalili
ทา​เป​เน้ด	Taabenetv
เย​โล​โบ​อัม	Yelomboam
เล​โห​โบ​อัม	Lehoxmboam
โล์เฒี้ยว	lozziouv
อา​บี​ยา	Aambiyaa
จาด่าง	jaandaangc
ซิ​ซัก	Sisakv
เน​บัด	Nembatc
อา​บี​ยัม	Aambiyam
อา​บี​ชา​โลม	Aambiqaalom
อา​สา	Aasaax
บา​อา​ชา	Mbaaaaqaa
โอม​ลี	Omli
สะ​มา​เลีย	Saamaalie
อา​หับ	Aahapc
อา​เซ​ลา	Aaselaa
เอ​ลี​ยา	Eliyaa
โอ​บา​ดี	Ombaandi
เย​เซ​เบน	Yesemben
คี​โซน	Kison
เย​ฮู	Yehu
เอ​ลี​ซา	Elisaa
ฮา​ซา​เอน	Haasaaen
นา​โบด	Naambotc
อิม​ลา	Imlaa
มี​คา​ยา	Mikaayaa
อา​หัด​ยา	Aahatcyaa
ซิน​หิ	Sinhi
อา​ซุ​บา	Aasumbaa
โย​ลัม	Yolam
เย​โฮ​ลัม	Yeholam
ไซเตี๋ย	SaiDiex
โอ๊	Ov
เก​หะ​ซี	Gehaasi
ต่น	donc
ไฟ	fai
ซี่	sih
อาน​โนน	Aannon
เย​โฮ​อา​หาด	Yehoaahaatc
อา​ทา​ลิ​ยา	Aataaliyaa
ล่วน	luonh
ไบ๋	mbaix
ฌับ	njapv
ฌิ้ว	njiuv
เย​โฮ​อาด	Yehoaatc
อา​มา​ซิ​ยา	Aamaasiyaa
ดาว	ndaau
เส​คา​ลิ​ยา	Sekaaliyaa
ซัน​ลูม	Sanlum
อุด​ซี​ยา	Utcsiyaa
กา​ดี	Gaandi
เม​นา​เฮม	Menaahem
อัด​ซี​เลีย	Atcsilie
เป​คา​หิ​ยา	Bekaahiyaa
เล​มา​ลิ​ยา	Lemaaliyaa
เป​คา	Bekaa
อา​หัด	Aahatc
เล​ซิน	Lesin
คี​อา	Kiaa
มี​เดีย	Mindie
บา​บี​โลน	Mbaambilon
เส​ฟาน​วา​อิม	Sefaanwaaim
เฮ​เซ​คี​ยา	Hesekiyaa
เซน​นา​เค​ลิบ	Sennaakelipv
อิ​สะ​ยา	Isaayaa
อาน​ปัด	Aanbatc
เฮ​นา	Henaa
อิบ​วา	Ipcwaa
อ๊บ	opv
อา​โมน	Aamon
โย​สิ​ยา	Yosiyaa
อา​ดา​ยา	Aandaayaa
เม​ซุน​ลาม	Mesunlaam
อา​ซา​ไล​ยา	Aasaalaiyaa
ซา​ฟาน	Saafaan
ฮิน​คี​ยา	Hinkiyaa
อา​หิ​คัม	Aahikam
อา​สา​ยา	Aasaaxyaa
ฮุน​ดา	Hunndaa
ขิด​โลน	Kitclon
ป๊วนซิน	buonvsin
ฮา​มุ​ทาน	Haamutaan
เย​เล​มี	Yelemi
ลิบ​ลา	Lipvlaa
เย​โฮ​ยา​คิม	Yehoyaakim
เป​ดา​ยา	Bendaayaa
เย​โฮ​ยา​คีน	Yehoyaakin
เอน​นา​ทัน	Ennaatan
เส​เด​คี​ยา	Sendekiyaa
อาน​วัด	Aanwatv
มัด​สา	Matvsaax
กา​ทาม	Gaataam
มิด​ซา	Mitvsaa
อัน​วาน	Anwaan
บิน​ฮาน	Mbinhaan
สา​วาน	Saaxwaan
มัด​เล​คา	Matvlekaa
มัก​ดี​เอน	Makvndien
อิ​ลาม	Ilaam
เป​เล้ด	Beletv
ฮา​มูน	Haamun
เอ​ทาน	Etaan
เฮ​มาน	Hemaan
คาน​โค	Kaanko
ดาน​ดา	Ndaanndaa
เย​เท	Yete
เส​กุบ	Segupc
ซัม​ไม	Sammai
อา​บี​ฮา​อิน	Aambihaain
อิด​อี	Itci
เซ​ซัน	Sesan
อัก​ไล	Akclai
สา​บาด	Saaxmbaatc
เอ​เล​อา​สา	Eleaasaax
เย​คา​มิ​ยา	Yekaamiyaa
เป​เหลด	Beletc
เอ​ฟา	Efaa
ซา​อับ	Saaapc
เช​วา	Qewaa
ซิ​เม​อา	Simeaa
โน​กา	Nogaa
เส​ลุบ​บา​เบน	Selupvmbaamben
ฮา​นัน​ยา	Haananyaa
เบ​เล​คิ​ยา	Mbelekiyaa
เป​ลา​ที​ยา	Belaatiyaa
เย​ซา​ยา	Yesaayaa
เล​ไฟ​ยา	Lefaiyaa
เซ​คา​นิ​ยา	Sekaaniyaa
เซ​ไม​อา	Semaiaa
ฮัด​ทัด	Hatvtatv
เน​อา​ลี​ยา	Neaaliyaa
เอ​ลี​โอ​ไน	Elionai
อัด​ลี​คัม	Atclikam
โฮ​ดา​วิ​ยา	Hondaawiyaa
เอ​ลี​ยา​ซี้บ	Eliyaasipv
เป​ไล​ยา	Belaiyaa
อัก​ขูบ	Akckupc
โย​ฮา​นัน	Yohaanan
เด​ไล​ยา	Ndelaiyaa
เล​อา​ยา	Leaayaa
ยา​หาด	Yaahaatc
เอ​ตาม	Edaam
อิด​มา	Itcmaa
เฮ​ลา	Helaa
ปา​เส​อา	Baaseaa
เส​ไล​อา	Selaiaa
เอด​ลา	Etclaa
เม​เล้ด	Meletv
เอ​เฟ	Efe
เค​นัน	Kenan
มา​หะ​ลา​เลน	Maahaalaalen
เอ​โน้ก	Enokv
เม​ทู​เส​ลา	Metuselaa
โน​ยา	Noyaa
อา​ลัม	Aalam
เช​ลา	Qelaa
อี​สัก	Isakc
โล​ทาน	Lotaan
ดี​โซน	Ndison
ฮา​ดัด	Haandatc
ยู​ดา	Yundaa
อัม​มี​นา​ดับ	Amminaandapc
นา​โซน	Naason
สัน​โมน	Sanxmon
โอ​เบด	Ombetc
จา​อี	Jaai
เซ​ซัน	Sesan
นา​ทัน	Naatan
เย​ฮู	Yehu
ดา​วิด	Ndaawitv
เล​โห​โบ​อัม	Lehoxmboam
อา​บี​ยา	Aambiyaa
อา​สา	Aasaax
อา​มา​ซิ​ยา	Aamaasiyaa
อา​ซา​ลิ​ยา	Aasaaliyaa
อา​หัด	Aahatc
เฮ​เซ​คี​ยา	Hesekiyaa
อัม​โมน	Ammon
เย​โฮ​ยา​คีน	Yehoyaakin
เส​ลุบ​บา​เบน	Selupvmbaamben
เย​ซา​ยา	Yesaayaa
เล​ไฟ​ยา	Lefaiyaa
โอ​บา​ดี	Ombaandi
เซ​ไม​อา	Semaiaa
ยา​หาด	Yaahaatc
มา​เล​ซา	Maalesaa
เก​เด​ลา	Gendelaa
เน​มู​เอน	Nemuen
ยา​ลี้บ	Yaalipv
ซัน​ลูม	Sanlum
มิบ​สัม	Mipvsamx
สัก​เก	Sakcge
อา​ยิน	Aayin
โย​เอน	Yoen
อา​สิ​เอน	Aasien
อา​ดี​เอน	Aandien
ฒี​ฒา	Zizaa
เย​ดา​ยา	Yendaayaa
ซิม​ลี	Simli
มี​คา	Mikaa
กิ​เล​อาด	Gileaatc
มี​คา​เอน	Mikaaen
บุด	Mbutc
อา​หิ	Aahi
เอ​ลี​เอน	Elien
ฟี​เน​หัด	Finehatc
อา​บี​ชู​วา	Aambiquwaa
บุก​คี	Mbukcki
อุด​ซี	Utcsi
เส​ลา​หิ​ยา	Selaahiyaa
เส​ลา​หิ​ยา	Selaahiyaa
เม​ลา​โย้ด	Melaayotv
อา​มา​ลิ​ยา	Aamaaliyaa
อา​มา​ลิ​ยา	Aamaaliyaa
สา​โดก	Saaxndokc
ฮิน​คี​ยา	Hinkiyaa
เย​โฮ​ซา​ดัก	Yehosaandakc
เน​บู​คัด​เน้ด​ซา	Nembukatvnetvsaa
สิม​มา	Simxmaa
โย​อา	Yoaa
เฒ​ลา	Zelaa
เอน​คา​นา	Enkaanaa
เอ​บี​ยา​สาบ	Embiyaasaapc
เอ​บี​ยา​สาบ	Embiyaasaapc
ทา​หัด	Taahatc
อุ​ลี​เอน	Ulien
อุด​ซี​ยา	Utcsiyaa
เอ​ลี​อับ	Eliapc
เย​โล​ฮัม	Yeloham
เย​โล​ฮัม	Yeloham
ซิ​เม​อา	Simeaa
มา​ฮ้าด	Maahaatv
อา​มา​ไส	Aamaasaix
โย​เอน	Yoen
เส​ฟัน​ยา	Sefanyaa
อัด​สี	Atcsi
อิด​ฮา	Itchaa
โค​ฮ้าด	Kohaatv
เล​วี	Lewi
อา​สาบ	Aasaapc
อา​สาบ	Aasaapc
เบ​เล​คิ​ยา	Mbelekiyaa
มัน​คิ​ยา	Mankiyaa
สิม​มา	Simxmaa
เก​โซน	Geson
อับ​ดี	Apcndi
มัน​ลุก	Manlukv
ฮา​ซา​ปิ​ยา	Haasaabiyaa
ฮา​ซา​ปิ​ยา	Haasaabiyaa
อัม​ซี	Amsi
อัม​ซี	Amsi
บา​นี	Mbaani
เช​เม	Qeme
มา​ลี	maazli
เม​ลา​ลี	Melaali
อุด​ซี	Utcsi
เม​ลา​โย้ด	Melaayotv
ดา​เบ​ลัด	Ndaambelatv
พู​อา	Puaa
เย​ดี​ยา​เอน	Yendiyaaen
เย​ลี​โม้ด	Yelimotv
เย​เล​โม้ด	Yelemotv
อา​เล​เม้ด	Aalemetv
เค​นา​อะ​นา	Kenaaaanaa
หุบ​ปิม	Hupcbim
ซุบ​ปิม	Supvbim
เป​แล้ด	Belaetv
อุ​ลาม	Ulaam
เท​ลา	Telaa
ทา​ฮัน	Taahan
ลา​ดาน	Laandaan
ลา​ดาน	Laandaan
มัน​คี​เอน	Mankien
ยา​เฟ​เล้ด	Yaafeletv
โซ​เม	Some
โฮ​ทาม	Hotaam
โส​ฟา	Sofaa
เบ​เซ	Mbese
อา​ลา	Aalaa
อัด​ดา	Atcndaa
เม​ซา	Mesaa
เอน​ปา​อัน	Enbaaan
อา​หิ​โย	Aahiyo
ซา​ซัก	Saasakv
เส​บา​ดิ​ยา	Sembaandiyaa
เอ​เด	Ende
โย​ฮา	Yohaa
ยา​คิม	Yaakim
สิน​เล​ไท	Sinxletai
ฮา​นัน	Haanan
เย​อี​เอน	Yeien
เซา​โล	Saulo
ปิ​โทน	Biton
เม​เล้ก	Melekv
ทา​เลีย	Taalie
สิม​ลี	Simxli
บิ​เน​อา	Mbineaa
บิ​เน​อา	Mbineaa
เอ​เล​อา​สา	Eleaasaax
อา​เซน	Aasen
โบ​เค​ลู	Mbokelu
เซ​อา​ลิ​ยา	Seaaliyaa
อิ​สะ​ลา​เอน	Isaalaaen
เย​อู​เอน	Yeuen
สัน​ลู	Sanxlu
หัด​เส​นู​อา	Hatcsenuaa
เอ​ลา	Elaa
เม​ซุน​ลาม	Mesunlaam
เซ​ฟา​ทิ​ยา	Sefaatiyaa
เล​อู​เอน	Leuen
อา​ดา​ยา	Aandaayaa
ปาด​เฮ	Baatche
ปาด​เฮ	Baatche
มัน​คิ​ยา	Mankiyaa
อิม​เม	Imme
กา​ลาน	Gaalaan
มัด​ทา​นิ​ยา	Matvtaaniyaa
สิก​ลี	Sikcli
เย​ดู​ทูน	Yendutun
เย​ดู​ทูน	Yendutun
มิก​โล้ด	Mikvlotv
เย​บุด	Yembutc
เป​โลน	Belon
สิบ​เบ​ไค	Sipcmbekai
ซา​อัน​โบน	Saaanmbon
เอ​ลี​ยา​บา	Eliyaambaa
กิม​โซ	Gimso
ฮา​เซม	Haasem
อู​อา	Uaa
อิด​ไล	Itclai
ยา​อา​ซี​เอน	Yaaaasien
เซ​มา​ลิ​ยา	Semaaliyaa
อิด​ซี​ยา	Itcsiyaa
อา​ซา​เลน	Aasaalen
ยา​โซ​เบ​อัม	Yaasombeam
ค้า	kaav
ควัด	kuatv
หฑวน	nzuonx
อา​บี​ไช	Aambiqai
ซี​เลีย	Silie
ซา​ตาน	Saadaan
หนัม	namx
เซ​โล​โม้ด	Selomotv
เก​โซม	Gesom
ฮา​ลิม	Haalim
มิ​ยา​มิน	Miyaamin
ฮัก​โขด	Hakvkotc
เย​ซู​อา	Yesuaa
บิน​กา	Mbingaa
เฮ​ซี	Hesi
เป​ทา​หิ​ยา	Betaahiyaa
มา​อา​ซิ​ยา	Maaaasiyaa
ยา​อา​ซี​ยา	Yaaaasiyaa
เก​ดา​ลิ​ยา	Gendaaliyaa
มัด​ที​ทิ​ยา	Matvtitiyaa
เซ​บู​เอน	Sembuen
ฮา​นา​นี	Haanaani
เย​โฮ​ฮา​นัน	Yehohaanan
โฮ​สา	Hosaax
กวั้น	guanh
หฮญัง	hnyangx
เฮน​ได	Henndai
เอ​ลี​ฮู	Elihu
อิด​ไม​อา	Itcmaiaa
อาน​คี	Aanki
ซา​โล​มอน	Saalomorn
ลู์ง	lungz
ไท​ละ	Tailaqv
ยับ​ฟา	Yapvfaa
เค​ลู​บิม	kelumbim
เหยียด	yietc
ปูง	bung
ล์ง	longz
ปุ้น	bunh
อิ​สะ​ลา​เอน	Isaalaaen
ซา​โล​มอน	Saalomorn
เซ​เคม	Sekem
เย​โล​โบ​อัม	Yelomboam
มา​หะ​ลัด	Maahaalatv
เย​ลู​ซา​เลม	Yelusaalem
ยู​ดา	Yundaa
โอ​เดด	Ondetc
ปวั๊ง	buangv
เตีย	die
บา​อา​ชา	Mbaaaaqaa
เย​โฮ​ซา​ฟัด	Yehosaafatv
เน​ทา​นิ​ยา	Netaaniyaa
โท​บี​ยา	Tombiyaa
เย​โฮ​ซา​บาด	Yehosaambaatc
อา​หับ	Aahapc
แปะ	baeqc
’	’
ยา​ฮา​ซี​เอน	Yaahaasien
เส​คา​ลิ​ยา	Sekaaliyaa
เบ​ไน​ยา	Mbenaiyaa
ตู๋ง	dungx
อา​หัด​ยา	Aahatcyaa
เย​โฮ​ลัม	Yeholam
เย​ฮี​เอน	Yehien
เอ​ที​โอ​เปีย	Etiobie
โย​ลัม	Yolam
เย​ฮู	Yehu
โก๊ว	gouv
เย​โฮ​ยา​ดา	Yehoyaandaa
ฮู่ง	hungh
ซิ​เม​อัด	Simeatc
เย​โฮ​อาด	Yehoaatc
เย​โค​ลี​ยา	Yekoliyaa
ฒี่ง	zingh
ฟี​ลิ​สะ​เตีย	Filisaadie
อา​ม้อด	Aamortv
โอ​เฟน	Ofen
โย​ทาม	Yotaam
มา​อา​เส​อา	Maaaaseaa
เม​ซิน​เล​โม้ด	Mesinlemotv
ป๋าว	baaux
เตี๋ย	diex
ธั้ม	camv
ฮม์	hmz
มะ​นัด​เส	Maanatvse
อา​โมน	Aamon
หฒ่อ	zorc
โย​ซา​บาด	Yosaambaatc
ยู่ง	yungh
โย​อา​หาด	Yoaahaatc
เย​เล​มี	Yelemi
เป​เซีย	Besie
ไซ​ลัด	Sailatv
โหลด	Lotc
ฮา​ดิด	Haanditc
โอ​โน	Ono
เส​นา​อา	Senaaaa
อาน​ทา​เซ​ซี้ด	Aantaasesitv
มิด​เล​ดาด	Mitvlendaatc
ดา​ลิ​อัด	Ndaaliatc
ฮัก​ไก	Hakvgai
ยิว​ไท	Yiutai
อา​หิ​ทู้บ	Aahitupv
อา​บี​ชู​วา	Aambiquwaa
เอ​เล​อา​ซา	Eleaasaa
เอ​สะ​ลา	Esaalaa
อา​หะ​วา	Aahaawaa
เฮง	heng
เอ​สะ​ลา	Esaalaa
ซับ​เบ​ไท	Sapvmbetai
เค​ลิ​ทา	Kelitaa
เม​เล​โม้ด	Melemotv
มัด​เท​ไน	Matvtenai
เซ​เล​มิ​ยา	Selemiyaa
ฮา​คา​ลิ​ยา	Haakaaliyaa
เน​หะ​มี	Nehaami
สุ​สา	Susaax
ฮนั้ม	hnamv
สัน​บาน​ลัด	Sanxmbaanlatv
โท​บี​อา	Tombiaa
เก​เซม	Gesem
อิม​ลี	Imli
เม​เซ​ซา​เบน	Mesesaamben
โย​ยา​ดา	Yoyaandaa
ฮา​ซับ​เน​ยา	Haasapvneyaa
หัด​ซู้บ	Hatcsupv
ฮัน​โล​เหด	Hanlohetc
เล​ฮูม	Lehum
สับ​ไบ	Sapcmbai
บา​ลุก	Mbaalukv
หัด​ซู้บ	Hatcsupv
เฮ​นา​ดัด	Henaandatc
บิน​นุย	Mbinnui
ปา​ลาน	Baalaan
ปา​โล้ด	Baalotv
ล่าน	laanh
โท​บี​อา	Tombiaa
โหย่ว	youc
โม​เด​ไค	Mondekai
บิน​ซาน	Mbinsaan
บิก​ไว	Mbikcwai
จ้อย	joih
ขัด​มี​เอน	Katcmien
เช​บา​นี​ยา	Qembaaniyaa
บุน​นี	Mbunni
เซ​เล​ปี​ยา	Selebiyaa
โฮ​ดี​ยา	Hondiyaa
เกน	gen
ค้อย	koiv
ดา​นี​เอน	Ndaanien
กิน​เน​โทน	Ginneton
ปัด​โล้ด	Batclotv
สัด​ทู	Satctu
อัด​กาด	Atcgaatc
เบ​ไบ	Mbembai
อา​ดีน	Aandin
อา​เท	Aate
ฮา​ซูม	Haasum
เบ​ไซ	Mbesai
ฮา​ลิบ	Haalipv
ย้าด​ดู​วา	Yaatvnduwaa
อา​นา​ยา	Aanaayaa
สัน​ไล	Sanxlai
โย​ยา​ลิบ	Yoyaalipv
อัด​ลี​คัม	Atclikam
สี​หะ	Sihaqc
เซ​อัน​ทิ​เอน	Seantien
โย​ยา​คิม	Yoyaakim
โย​นา​ทาน	Yonaataan
มิน​ยา​มิน	Minyaamin
อา​โม้ก	Aamokv
ทัน​โมน	Tanmon
โฮ​ซา​ยา	Hosaayaa
มัด​ทา​นิ​ยา	Matvtaaniyaa
มี​คา​ยา	Mikaayaa
เอ​ลี​ยา​คิม	Eliyaakim
อา​หะ​สุ​เอ​ลัด	Aahaasuelatv
อิน​เดีย	Inndie
ยิ่น	yinh
วัด​ชา​ที	Watvqaati
ห่า	haac
เย​โค​นี​ยา	Yekoniyaa
โม​เด​ไค	Mondekai
เอ​เซ​เท	Esete
เอ​เซ​เท	Esete
เอ​เซ​เท	Esete
ดิ๋ว	ndiux
ฮา​มาน	Haamaan
ฮา​มาน	Haamaan
ลั์ม	lamz
ฮา​ท้าก	Haataakv
ฮา​ท้าก	Haataakv
เคน​เดีย	Kenndie
มับ	mapv
เหฒียว	zioux
เล​วี​อา​ทาน	Lewiaataan
เฮ่น	henh
เซี่ยน	sienh
หฮวา	huaax
หฆับ	nqapc
เหฮลียน	hlienx
หมิด	mitc
เยีย’	yie’
ฑุ์ย	nzuiz
หฮลา	hlaax
ม์วน	muonz
โก้	goh
ชู​วา	Quwaa
บิน​ดัด	Mbinndatc
ลวั่ง	luangh
โหล่ว	louc
ฒิ่ม	zimh
นา​อา​เม	Naaaame
โถว	toux
ซูง	sung
สู	sux
ฮ่าง	haangh
โปย้	bioh
เสี่ยน	sienc
ว้วด	wuotv
แกว๊ะ	guaeqv
หฑุ่น	nzunc
เธียน	cien
ห่อย	hoic
ฟับ	fapv
น่าน	naanh
หมะ	maqc
เบี๊ยะ	mbieqv
หวั่ง	wangc
เกว๋น	guenx
ฮล้อ	hlorv
ญ่า	nyaah
เบว	mbeu
เบว	mbeu
เฆาะ	nqorqv
เยีย	Yie
โก๋	gox
เอ​ลี​ฮู	Elihu
เฒว่ย	zueih
หว่า’	waac’
โซะ	soqv
เยี่ยม	yiemh
อ๋าว	aaux
ดั่น	ndanc
ฮมัด	hmatv
ฮลบ	hlopv
ป์าม	baamz
เยี์ยน	yienz
โต่	doc
หอบ’	horpc’
กวิ้น	guinh
กวิ้น	guinh
กี๋ง	gingx
มวั่ง	muangh
ลั์ม	lamz
ค้ม	komv
เด่า	ndauc
ธ้าย	caaiv
ญ้าย	nyaaiv
เบ​เฮ​โม้ด	Mbehemotv
ติ๋ว	diux
ธุด	cutv
เซ​ลา	Selaa
เซ​ลา	Selaa
ตอเหฒี่ย	dorziec
เธี่ยน	cienh
โต้	doh
หว่า	waac
โล่ว	louh
หฒาว	zaaux
ถาน	taanx
ฒัวะ	zuoqv
ลิ์ว	liuz
หฮวัง	huangx
โก๋ว	goux
เฒี่ยง	ziangh
ฒุ์ยเมี่ยน	zuizmienh
ธ่อง	corngh
ว้วด	wuotv
เล​บา​นอน	Lembaanorn
ฝิน	finx
เอ๊าะ	orqv
ตั๋งต๋น	dangxdonx
ฮ้า	Haav
ฮ้า	haav
เมี์ยน	mienz
ปั๊ด	batv
ตุ๋น	dunx
เจี๋ย	jiex
ไหล่	laic
เญี์ยม	nyiemz
เนี้ยว	niouv
เหฑียว	nzioux
สิน	sinx
เหญีย	nyiex
ฮลบ	hlopv
ญ้วด	nyuotv
บย์าว	mbiaauz
ม์า	maaz
เบ๋ว	mbeux
เก​บาน	Gembaan
ป๋วน	buonx
ที่	tih
อา​เมน	Aamen
เบ๋ย	mbeix
ววมหล่าง	wuomlaangc
ปยบ	biopc
เฒี่ยน	Zienh
ฆ้าด	nqaatv
ไล่	laih
เมน​คี​เซ​เดก	Menkisendekc
จอ​แดน	Jorndaen
ก๊าด	gaatv
ยา​โค้บ	Yaakopv
เอ​ฟา​ทา	Efaataa
ซีงเฉีย	singqiex
บง	mbong
มุน	mun
ย้าบ	yaapv
เฮ้ย	heiv
ก๊องหฌาว	gorngvnjaaux
โย่ว	youh
ชบ	qopv
นุ	nuqv
หญ่าง	nyaangc
ล์อ	lorz
เดี๊ยบ	ndiepv
เหฌียว	njoux
ลม	lom
ตี๊	div
ฟิด	fitv
ท่าย	taaih
ญ่าน	nyaanh
หฮงง	hngongx
คอย	koi
เคาะ	korqv
อิ​ที​เอน	Itien
อิ​ที​เอน	Itien
หมวัง	muangx
เญย	nyei
สาว	saaux
แล์ง	laengz
ซา​โลน	Saalon
จั๋น	Janxmuangz
เหาะ	horqc
เหาะ	horqc
จิ่ว	jiuc
จิ่ว	jiuc
ไบ๊	mbaiv
อัน​มัน	anman
เญว์ย	nyueiz
สี่ต้อง	sicdorngh
ปี๋งเธี้ยว	bingxciouv
เปย๊าฮวาง	biauvhuaang
ววมต้ม	wuomdomh
หฒวน	zuonx
ดา​มัด​กัด	Ndaamatvgatc
ฟิ้ว	fiuv
เอ​ฟา​อิม	Efaaim
แป่งง์าย	baengcngaaiz
เดี๋ยงด๋น	ndiangxndonx
บา​บี​โลน	Mbaambilon
โม​อับ	Moapc
อาน	Aan
ต๊อ	dorv
ไน​อา	Naiaa
บัด	mbatc
อี​ยิบ	Iyipv
อัด​ซี​เลีย	Atcsilie
หม่าย	maaic
ต๋อย	doix
เซ้บ​นา	Sepvnaa
ไลหฮนาง	laihnaangx
อา​ลี​เอน	Aalien
อา​ลี​เอน	Aalien
ฒิบ	zipv
บ๋อง	mborngx
โซว	Sou
หฑยาวเจี๊ยะ	nziaauxjieqv
สิ​โอน	Sion
คู่	kuh
กั๊วะ	guoqv
อิ​สะ​ยา	Isaayaa
ไซ​ปัด	Saibatc
หัว	huox
ญิม	nyim
ฟาน​เกน​เซน	faangensen
เปี๊ยวจ้อย	biouvjoih
พิด	pitv
อ๊ะ’	aqv’
โล์แกง	lozgaeng
เหฮยียน	hienx
เลี่ยม	liemh
หฒุน	zunx
นิน	nin
เนีย	nie
บา​อัน	Mbaaan
ปั์วเหฒา	buozzaux
มัน​คี​อา	Mankiaa
โย​สิ​ยา	Yosiyaa
สี​ดา	sindaa
กว๊าด	guaatv
อัด​เค​โลน	Atckelon
หฒวัง	zuangx
อุ​ลี​อา	Uliaa
เก​มา​ลิ​ยา	Gemaaliyaa
โค​ลา​ยา	Kolaayaa
เน​เฮ​ลาม	Nehelaam
เส​ฟัน​ยา	Sefanyaa
ปู๋งหฒัวะ	bungxzuoqc
หฌาว	njaaux
เส​เด​คี​ยา	Sendekiyaa
เคน​เดีย	Kenndie
ฉง	qongx
เน​ลิ​ยา	Neliyaa
บา​ลุก	Mbaalukv
เก๊าะเมี่ยน	gorqvmienh
โค​นิ​ยา	Koniyaa
เย​ฮู​คัน	Yehukan
เบน​ยา​มิน	Mbenyaamin
มัด​ทาน	Matvtaan
ปั๊ว	buov
คา​เล​อา	Kaaleaa
ทัน​หุ​เม้ด	Tanhumetv
คา​เล​อา	Kaaleaa
เก​ดา​ลิ​ยา	Gendaaliyaa
ปิ่น	binc
ทา​ปาน​เหด	Taabaanhetc
เมม​ฟิด	Memfitv
เฮลี้ยว	hliouv
คี​ลิ​ยา​ทา​อิม	Kiliyaataaim
ดี​โบน	Ndimbon
หฌัง	njangx
เอ​โดม	Endom
เอ​โดม	Endom
ดุย	ndui
ดิน	ndin
ฟองธัง	forngcang
ด่ง	ndongc
ฝูง	fungx
บา​บี​โลน	Mbaambilon
เฒ่ม	zemh
เบี้ยว	mbiouh
เหฮลง	hlengx
เน​บู​คัด​เน้ด​ซา	Nembukatvnetvsaa
หฒุ่น	zunc
เหฒีย	ziex
เม์ว	meuz
หฌับ	njapc
ป๊วนกั๊วะ	buonvguoqv
ฒิ	ziqv
ฮบ	hopv
แซงฮม์	saenghmz
เยียม	Yiem
เค​บา	Kembaa
ยา​อา​ซัน​ยา	Yaaaasanyaa
แธง	caeng
ลุยจั๊วะ	luijuoqv
เตี๊ย	diev
ฮู่ง	hungh
คู้	kuv
ไพ้	paiv
ทับ	tapv
โอ​โฮ​ลา	Oholaa
โอ​โฮ​ลี​บา	Oholimbaa
ป่าย	baaic
เอ​ที​โอ​เปีย	Etiobie
โอน	On
แซงเธี้ยด	saengcietv
โหฌะ	njoqc
เบ๋ง	mbengx
เมี้ยเธี้ยง	mievciangv
ยั่ง	yangh
โกก	Gokc
โกก	Gokc
ฒ่าง	zaangh
สีง	singx
โฮ​เม	home
ห่อ	horc
ดา​นี​เอน	Ndaanien
ไล	lai
เบ๋ย	mbeix
เบน​เท​ซัด​ซา	Mbentesatvsaa
ซัด​ลัก	Satvlakv
เม​ซ้าก	Mesaakv
อา​เบด​เน​โก	Aambetcnego
อา​เบด​เน​โก	Aambetcnego
เฮญี้ยว	hnyouv
เบน​ซัด​ซา	Mbensatvsaa
ไต๋	daix
เม​เน	Mene
เท​เคน	Teken
ปา​ซิน	Baasin
เต้า	dauh
กา​เบ​เลียน	Gaambelien
ถิว	tiux
โฮ​เซ​ยา	Hoseyaa
ลิ่ม	limh
อา​โม้ด	Aamotv
อา​โม้ด	Aamotv
เค​ลิ​โอด	Keliotc
ธี้	civ
ลี้	liv
กิน​กาน	Gingaan
มวั้ง	muangv
ฟี​นี​เซีย	Finisie
สา​เล​ฟัด	Saaxlefatv
โย​นา	Yonaa
โย​นา	Yonaa
นิ​นะ​เว	Ninaawe
ง์อง	ngorngz
หฆัน	nqanx
ดุ้น	ndunh
เปย๊ยเฒ้ย	bieivzeiv
นา​ฮูม	Naahum
ลิ​เบีย	Limbie
หญอ	nyorx
ฮา​บา​กุก	Haambaagukc
พ้วด	puotv
คู​ซี	Kusi
เฒี้ยง	ziangv
มิน​โคม	Minkom
จายห่อง	jaaihorngc
ฌังหล่าง	njanglaangc
โย​ซู​วา	Yosuwaa
หฆาย	nqaaix
ฝีง	fingx
เสย	seix
ไธต๋อย	caidoix
ตุ๊	duqv
เป​เล้ด	Beletv
เฮ้ด​โลน	Hetvlon
ลาม	Laam
โบ​อาด	Mboaatc
เจียด​ซี	Jetcsi
เอ​ลี​ยา​คิม	Eliyaakim
โย​เซ้บ	Yosepv
มา​ลี​ยา	Maaliyaa
มา​ลี​ยา	Maaliyaa
เย​ซู	Yesu
เย​ซู	Yesu
กี​ตู่	Giduc
เย​ซู	Yesu
อี​มา​นู​เอน	Imaanuen
เอ๋ย	eix
เฮ​โล้ด	Helotv
ยู​เดีย	Yundie
นา​ซา​เล้ด	Naasaaletv
นา​ซา​เล้ด	Naasaaletv
โย​ฮัน	Yohan
โย​ฮัน	Yohan
โย​ฮัน	Yohan
หฑบ	nzopc
ตอน	Dornhnamv
เส​เบ​ดี	Sembendi
ยา​กอบ	Yaagorpc
โท้ด​บุ​ลี	Totvmbuli
ฆบ	nqopv
ป้าย	baaih
หญัวะ	nyuoqc
กี​โล	gilo
โปว	bou
ฮลาว	hlaau
แง้ง	ngaengv
แง้ง	ngaengv
ตู์ง	dungz
ตู์ง	dungz
ตู์ง	dungz
ขัม	kamx
ฟี​ลิบ	Filipv
บา​โท​โล​มิว	Mbaatolomiu
โท​มัด	Tomatv
มัด​ทาย	Matvtaai
อัน​เฟ​อัด	Anfeatc
ทัด​เด​อัด	Tatvndeatc
ซี​โมน	Simon
ยู​ดาด	Yundaatc
อิ​สะ​คา​ลิ​โอด	Isaakaaliotc
เหญ่ย	nyeic
เธี่ยว	ciouh
ตุ่น	dunc
โตะ	doqc
เฮง	heng
ฟา​ลิ​สี	Faalisi
ฟา​ลิ​สี	Faalisi
เมี้ยน	mienv
เบ​เอน​เซ​บูน	Mbeensembun
ซา​ตาน	Saadaan
แหล่ง	laengc
เฮ​โล​เดียด	Helondietc
เย​ซู	Yesu
เบย์าตอน	mbiauzdorn
สะ​ดู​สี	Saandusi
สะ​ดู​สี	Saandusi
ปี​เต	Bide
ปี​เต	Bide
ไซ	Saigorx
จั๊ว	juov
ซา	saa
เบ​ทา​นี	Mbetaani
ซี​ซา	Sisaa
เต้า’	dauh’
กี​ตู่	Giduc
ฮ์า	Haaz
คา​ยา​ฟ้าด	Kaayaafaatv
แอ๋	aex
ปี​เต	Bide
โล​มา	Lomaa
ปี​ล้าด	Bilaatv
ยู​ดาด	Yundaatc
ปี​ล้าด	Bilaatv
ปี​ล้าด	Bilaatv
บา​ลับ​บัด	Mbaalapvmbatc
บา​ลับ​บัด	Mbaalapvmbatc
กวัด	guatc
ไซ​ลีน	Sailin
ซี​โมน	Simon
เอ​ลี	Eli
ลา​มา​ซา​บัก​ทา​นี	laamaasaambakctaani
มัก​ดา​ลา	Makvndaalaa
อัน​ดา​ลู	Anndaalu
คา​เป​นา​อุม	Kaabenaaum
เย​ซู	Yesu
ไกว๊	guaiv
ฆ์ม	nqomz
ล์าง	laangz
เฮ​โล้ด	Helotv
บ์ม	mbomz
เบด​ไซ​ดา	Mbetcsaindaa
โม​เซ	Mose
โฮ​ซา​นา	Hosaanaa
โล​มา	Lomaa
อา​เล้ก​ซาน​เด	Aalekvsaannde
ลู​ฟัด	Lufatv
เอ​ลี​ซา​เบด	Elisaambetc
มัด​ทัด	Matvtatv
มัด​ทัด	Matvtatv
เมน​คี	Menki
เมน​คี	Menki
มัด​ทา​ที​อัด	Matvtaatiatc
มัด​ทา​ที​อัด	Matvtaatiatc
เอ​อา	Eaa
สิ​เม​โอน	Simeon
อับ​ลา​ฮัม	Apclaaham
นา​โฮ	Naaho
เส​ลุก	Selukv
เล​อู	Leu
เป​เล้ก	Belekv
เอ​เบ	Embe
อาน​ฟา​ซัด	Aanfaasatv
ลา​เม้ก	Laamekv
ยา​เล้ด	Yaaletv
เอ​โน้ด	Enotv
อา​ดัม	Aandam
เก​ลา​ซา	Gelaasaa
ไย​ลัด	Yailatv
เธียว	ciou
สะ​มา​เลีย	Saamaalie
เปย๊าเฒี้ยว	biauvziouv
มา​ทา	Maataa
ด้าง	ndaangh
กา​ลิ​ลี	Gaalili
สี​โล​อัม	Siloam
ปู๋ง	bungx
หว่าน	waanc
โห่ว	houc
ธุ	cuqv
แฒะตาน	zaeqvdaan
ลา​ซา​ลัด	Laasaalatv
สัก​เคี้ยด	Sakckietv
’	’
สิ	siqc
หญม	nyomx
เฮ​โล้ด	Helotv
คี่	kih
ค้าด	kaatv
ดั้น	ndanh
ฟี​ลิบ	Filipv
นา​ทา​นา​เอน	Naataanaaen
นี​โค​เด​มัด	Nikondematv
ลี่ง	lingh
ยิว​ไท	Yiutai
คา​นา	Kaanaa
งี่	ngih
สูง	sungx
ซับ	sapv
บอ	mbor
ลา​ซา​ลัด	Laasaalatv
ลา​ซา​ลัด	Laasaalatv
มา​ทา	Maataa
พ้าย	paaiv
ยู​ดาด	Yundaatc
เสียน	sienx
ล่าน	laanh
ฮิ้ว	hiuv
อัน​น้าด	Annaatv
อา​นา​เนีย	Aanaanie
อา​นา​เนีย	Aanaanie
ทิม	tim
สะ​เท​เฟน	Saatefen
อัน​ที​โอก	Antiokc
นี​โค​เลา	Nikolau
ตับ	dapc
เซา​โล	Saulo
ไอ​เน​อัด	Aineatc
ลิด​ดา	Litvndaa
ซั่ม	samh
โค​เน​ลิ​อัด	Koneliatc
โค​เน​ลิ​อัด	Koneliatc
ซี​ซา​ลี​ยา	Sisaaliyaa
บา​นา​บัด	Mbaanaambatc
บา​นา​บัด	Mbaanaambatc
ทา​ซัด	Taasatv
ฒิ่ว	ziuh
มา​โค	Maako
เปา​โล	Baulo
เปา​โล	Baulo
อี​โค​นี​ยูม	Ikoniyum
เฮ​เม้ด	Hemetv
เป​กา	Begaa
ซี​ลา	Silaa
มา​ซี​โด​เนีย	Maasindonie
เปา​โล	Baulo
ซี​ลา	Silaa
เท​สะ​โล​นิ​กา	Tesaalonigaa
ยา​โสน	Yaasonx
อา​เทน	Aaten
ทิ​โม​ไท	Timotai
เฟียว	fiou
โค​ลิน​โท	Kolinto
คะ​ลิด​ปัด	Kaalitvbatc
กัน​ลิ​โอ	Ganlio
อา​คา​ยา	Aakaayaa
เอ​เฟ​โซ	Efeso
ปิด​สิน​ลา	Bitcsinxlaa
อา​ควิน​ลา	Aakuinlaa
อา​ปอ​โล	Aaborlo
อาน​เท​มิด	Aantemitv
เอ​เซีย	Esie
เด​เม้ด​ลิ​อัด	Ndemetvliatc
เบ​โล​อา	Mbeloaa
อา​ลิด​ทา​คัด	Aalitvtaakatv
กาย​อัด	Gaaiatc
ที​คิ​กัด	Tikigatc
โต​ฟี​มัด	Dofimatv
โต​อัด	Doatc
ซี​ลี​เซีย	Silisie
เฟ​ลิก	Felikv
เฟ​ลิก	Felikv
คา​ลาว​ดิ​อัด	Kaalaaundiatc
ลี​เซี้ยด	Lisietv
เฟ​สะ​ทัด	Fesaatatv
เฟ​สะ​ทัด	Fesaatatv
อา​ฆี​พา	Aanqipaa
อา​ฆี​พา	Aanqipaa
ธ่ง	congh
อับ​ลา​ฮัม	Apclaaham
กี​ตู่	Giduc
อา	Aa
สะ​เปน	Saaben
ลู​สิ​อัด	Lusiatc
สะ​เท​ฟา​นัด	Saatefaanatv
อา​ปอ​โล	Aaborlo
หฒ่าน	zaanc
โน่ว	nouh
ฮน้ม	hnomv
มา​ซี​โด​เนีย	Maasindonie
กี​ตู่	Giduc
ทิ​ตัด	Tidatc
ทิ​ตัด	Tidatc
โหฒะ	zoqc
เถง	tengx
เธง	ceng
ฟุ	fuqv
ฮนั้ม	hnamv
เอ​ปา​ฟา	Ebaafaa
เลา​ดี​เซีย	Laundisie
ซิน	sin
โหฒว	zoux
น่าน	naanh
บัว	mbuo
ฮี​เม​เน​อัด	Himeneatc
หลอ	lorx
เฟียม	fiem
แฑง	nzaeng
เด​ม้าด	Ndemaatv
กา​ลา​เทีย	Gaalaatie
ลู​กา	Lugaa
โอ​เน​สิ​โฟ​ลัด	Onesifolatv
เอ​ลัด​ทัด	Elatvtatv
มิ​เล​ทัด	Miletatv
ส่วน	suonc
ฟี​เล​โมน	Filemon
โอ​เน​สิ​มัด	Onesimatv
ซา​เลม	Saalem
ฑย้าม	nziaamv
โม​เซ	Mose
เญย	nyei
กั้น	ganh
ล่าม	laamh
บา​ลา​อัม	Mbaalaaam
คา​อิน	Kaain
โค​ลา	Kolaa
เม้า	mauv
โก๊ว	gouv
บ๊บ	mbopv
หธา	caax
เดี๋ยงน่อม	ndiangxnormh
ฮา​วา	Haawaa
ไม	maiv
เหลียงเด่ย	liangxndeic
อิ​ล้าด	Ilaatv
เม​หู​ยา​เอน	Mehuxyaaen
เม​ทู​ซา​เอน	Metusaaen
ยา​บาน	Yaambaan
ยา​บาน	Yaambaan
องถายแงะ	ongtaaixngaeqv
ยู​บาน	Yumbaan
ยู​บาน	Yumbaan
องถายแงะ	ongtaaixngaeqv
ฒวั้ง	zuangv
ฟามแป๊ะ	faambaeqv
ฟามแป๊ะ	faambaeqv
กงโปว	gongbou
โต์เมี่ยน	dozmienh
ฮนั้มหฑวน	hnamvnzuonx
เอ๊าเจว๊ย	auvjueiv
ตอนบวั์ง	dornmbuangz
เบี้ยว	mbiouh
ววมหมิ่น	wuomminc
ฮ้าบ	haapv
อา​ลา​ลัด	Aalaalatv
ฮ้าบ	haapv
โฆ	nqo
ฑั้งลิ่ว	nzangvliuh
ตอนบวั์ง	dornmbuangz
บ๋วน	mbuonx
คา​นา​อัน	Kaanaaan
เอ​เล้ก	Elekv
อัก​คัด	Akckatv
ซี​นา	Sinaa
เล​โห​โบด​อี	Lehoxmbotci
ปัด​ลุ​สิม	Batclusimx
คัด​ลู​ฮิม	Katvluhim
คับ​โท​ลิม	Kapvtolim
เฮ้ด	Hetv
ธั้มฝีง	camvfingx
เก​กา​ซี	Gegaasi
ลา​ซา	Laasaa
เส​ฟา	Sefaa
ฟั่น	fanh
เท​ลา	Telaa
ฮา​ลาน	Haalaan
อับ​ลาม	Apclaam
ฮา​ลาน	Haalaan
อับ​ลาม	Apclaam
อับ​ลาม	Apclaam
ววมซุ้ย	wuomsuiv
แป๊ะฟุน	baeqvfun
โส​โดม	Sondom
ซ้าว	saauv
อัม​ลา​เฟน	Amlaafen
เอน​ลา​สา	Enlaasaax
อา​ลี​โอก	Aaliokc
ทิ​ดาน	Tindaan
ต๋อง	dorngx
เอน​ปา​ลาน	Enbaalaan
ทิ​ดาน	Tindaan
อัม​ลา​เฟน	Amlaafen
เอน​ลา​สา	Enlaasaax
อา​เล​โอก	Aaleokc
ขัด​โม​ไน	Katcmonai
ฮา​กา	Haagaa
ซา​ลาย	Saalaai
ฮา​กา	Haagaa
ฮา​กา	Haagaa
อิ​สะ​มา​เอน	Isaamaaen
ธั้มฝีง	camvfingx
ซา​ลา	Saalaa
เดี๋ยงกอน	ndiangxgorn
นี	ni
ฟิ้วมู้ง	fiuvmungv
โก​โม​ลา	Gomolaa
โต์วเสียวตน	douzsiouxdon
ธุดๆ	cutvcutv
เซียะโฮล	Sieqvhlo
เบน​อัม​มี	Mbenammi
เบน​อัม​มี	Mbenammi
อา​บี​เม​เล้ก	Aambimelekv
เบ่น	mbenc
ตอนหม่า	dornmaac
ฟี​โค	Fiko
ฟี​โค	Fiko
ซาเฒียว	saaziou
เบ​เอ​เช​บา	Mbeeqembaa
เบ​ทู​เอน	Mbetuen
เอ๊าตอน	auvdorn
เล​อู​มา	Leumaa
เท​บา	Tembaa
กา​ฮัม	Gaaham
ทา​หาด	Taahaatc
ฮิด​ไท	Hitvtai
เอ​โฟ​โลน	Efolon
เฮนี้ยต้าว	hnievdaauh
มัก​เป​ลา	Makvbelaa
โล์เต่ยปูง	lozdeicbung
ธินหม่าน	Cinmaanc
ลา​บาน	Laambaan
เซียะฟุน	sieqvfun
เล​เบ​คา	Lembekaa
เล​เบ​คา	Lembekaa
เค​ทู​ลา	Ketulaa
สิม​ลาน	Simxlaan
เม​ดาน	Mendaan
อิด​บาก	Itcmbaakc
เด​ดาน	Ndendaan
อา​บี​ดา	Aambindaa
เอน​ดา​อา	Enndaaaa
เน​บา​โย้ด	Nembaayotv
เค​ดา	Kendaa
อัด​เบ​เอน	Atcmbeen
ซุๆ	suqvsuqv
ด๊บลุย	ndopvlui
เอ​ซาว	Esaau
ซูงโก๊ว	sunggouv
ซูงโก๊ว	sunggouv
ค้อฟิ	korvfiqv
ซูงโก๊ว	sunggouv
อี​สัก	Isakc
เอ​เสก	Esekc
สิด​นา	Sitcnaa
อา​หุด​ซัด	Aahutcsatv
อี​สัก	Isakc
ชี​บา	Qimbaa
ยา​โค้บ	Yaakopv
ยา​โค้บ	Yaakopv
ธั้มนอม	camvnorm
จังๆ	jangjang
เอ​ซาว	Esaau
บยู่งซุ้ย	mbiungcsuiv
ยา​โค้บ	Yaakopv
เอ๊าฟาม	auvfaam
ลา​เซน	Laasen
ลา​เซน	Laasen
ลา​เซน	Laasen
ธีงจาหฮนาง	cingjaahnaangx
เล​อา	Leaa
ลา​เซน	Laasen
เล​อา	Leaa
บิน​ฮา	Mbinhaa
เจี้ย	jieh
เจี้ย	jieh
เตี๊ยม	diemv
เตี๊ยม	diemv
โอ๋ย	Oeix
เตี๊ยม	diemv
ป๊วนเต่ยปูง	buonvdeicbung
เฒี์ยน	zienz
ป์อง	borngz
ป์อง	borngz
เฮมียน	hmien
เป​นี​เอน	Benien
ดี​นา	Ndinaa
งว์ากอน	nguaazgorn
ฮา​โม	Haamo
เอ​ฟา​ลา​ทา	Efaalaataa
ลู​เบน	Lumben
เส​อี	Sei
ทิม​นา	Timnaa
โอ​โฮ​ลี​บา​มา	Oholimbaamaa
ไอ​ยา	Aiyaa
อา​นา	Aanaa
ววมจอม	wuomjorm
โย​บับ	Yombapc
หุ​ซาม	Husaam
สัม​ลา	Samxlaa
ลุยเมว์ย	luimueiz
โย​เซ้บ	Yosepv
โด​ทาน	Ndotaan
ลุยเมว์ยด๊าว	luimueizndaauv
เดี๋ยงฒูง	ndiangxzung
เดียดาง	ndiendaang
มู​หย่อ	muyorc
โย​เซ้บ	Yosepv
ลุยเมว์ยด๊าว	luimueizndaauv
โป​ทิ​ฟา	Botifaa
ฮี​ลา	Hilaa
ทา​มา	Taamaa
เปย๊าเฒี้ยว	biauvziouv
ฟา​โล	Faalo
ไฮ์	haiz
ฟา​โล	Faalo
หฮญังฒี่ง	hnyangxzingh
โป​ทิ​เฟ​ลา	Botifelaa
อา​เส​นัด	Aasenatv
ง่อง	ngorngh
มั์วตอน	muozdorn
ด๊ามเจ๊า	ndaamvjauv
มั์วตอน	muozdorn
ดามต้าว	ndaamdaauh
ไบ้	mbaih
หวิน	winx
โม่ว	mouh
ตอนฟุน	dornfun
ซา​อุน	Saaun
สิ​ฟิ​โยน	Sifiyon
หลัวะ	luoqc
โก​เซน	Gosen
โย่ว	youh
ววมเสย	wuomseix
เดียไซ	ndiesai
เดียววม	ndiewuom
เซย	sei
เดียไซ	Ndiesai
โฒ้วโม่ว	zouvmouh
เดียววม	ndiewuom
สิบ​โป​ลา	Sipcbolaa
สิบ​โป​ลา	Sipcbolaa
โค้วฒี่ง	kouvzingh
เดี๋ยงตอนฟ้ม	ndiangxdornfomv
เดี๋ยงตอนฟ้ม	ndiangxdornfomv
กงโปวเปย๊ย	gongboubieiv
โค้วหลัด	kouvlatc
โค้วหลัด	kouvlatc
เจ๊าตี้ง	jauvdingh
แกว๋ง	guaengx
นางเตว๊ย	naangdueiv
นางเตว๊ย	naangdueiv
ลุยเกม	luigem
ลุยเกม	luigem
ลุยเกม	luigem
ลุยเกม	luigem
เย​โท	Yeto
อา​โลน	Aalon
อา​โลน	Aalon
กงโปวเปย๊ย	gongboubieiv
กงโปวเปย๊ย	Gongboubieiv
อัม​ลาม	Amlaam
โย​เค​เบด	Yokembetc
โย​เค​เบด	Yokembetc
อัม​ลาม	Amlaam
เอ​ลี​เช​บา	Eliqembaa
อี​ยิบ	Iyipv
ไกวเก๊าะ	guaigorqv
แก๊งไต่	gaengvdaic
ดุยๆ	nduindui
แกงบูง	gaengmbung
แกงบูง	gaengmbung
แกงบูง	gaengmbung
แกงบูง	gaengmbung
แกงบูง	Gaengmbung
เนียบูงหม่วน	niembungmuonc
บูง	mbung
กุ๋น	gunx
หน่ง	nongc
เปาะ	borqc
หฑยาว	nziaaux
ค้อยซิ	KoivSiqv
เซียงหฮญัง	sianghnyangx
ไลอิม	laiim
ไหธ	caix
ฌั้วเญี์ยม	njuovnyiemz
บ๋วนเดี้ยว	mbuonxndiouh
โต์วเดี้ยว	douzndiouh
เจ๊าฆาย	jauvnqaai
เจ๊าฆาย	jauvnqaai
เอ​ลิม	Elim
งบ	ngopv
บุ้น	mbunh
โฒ้ว	zouv
คัง	kang
เล​ฟี​ดิม	Lefindim
เหว่ย	weic
ไฝฟิ้ว	faixfiuv
ไฝฟิ้ว	Faixfiuv
ควัด	kuatv
บงเหฆน	mbongnqenx
ตานซิน	daansin
ตานซิน	daansin
เอ๊าโฮล	auvhlo
เอ๊าโฮล	auvhlo
ป่าๆ	baacbaac
ฮั่น	hanh
ค้วด	kuotv
ค้วดเฒี้ยว	kuotvziouv
จั๋นหฒะ	janxzaqc
ลั่น	lanh
ฌิ้มเบยาะ	njimvmbiorqc
ลั่น	lanh
วินจา	winjaa
เมว์ยเฌ้ย	mueiznjeiv
อิ​สะ​ลา​เอน	Isaalaaen
เจียมควีง	jiemkuing
ฟางเหฒา	faangzaux
เจียมควีง	jiemkuing
แหฒง	zaengx
ตังจ๋า	dangjaax
ตังซิน	dangsin
ตังซิน	Dangsin
หธา	caax
ตังซิน	Dangsin
เญว์ย	nyueiz
หธาๆ	caaxcaax
ตังจ๋า	dangjaax
ตังซิน	dangsin
ฌิ้ว	njiuv
ตัง	dang
คว้ายๆ	Kuaaivkuaaiv
เฌี้ยด	njietv
ลุ่น	lunh
เดียบั๊ว	ndiembuov
เดียเฮลน	ndiehlen
เน้ก	nekv
คว้ายๆ	kuaaivkuaaiv
เฌี้ยด	njietv
เดียเฮลน	ndiehlen
ฟัวะ	fuoqv
เจียม	jiem
หฌ่งลาน	njongclaan
หฌ่งลาน	njongclaan
บอง	mborng
เจียมลี่ง	jiemlingh
ไหฒ	zaix
อา​โลน	Aalon
ปั์วเหฒา	buozzaux
เจี๋ยโล่ว	jiexlouh
เดี๋ยงด๊บ	ndiangxndopv
เตี้ย	dieh
เจียมตัง	jiemdang
เจียมตัง	jiemdang
เซียงเบย้า	SiangMbiauh
หฮญังเตว๊ย	hnyangxdueiv
แกงหฒวัง	GaengZuangx
พ้ายโผว	paaivpoux
ตังฒ้าน	dangzaanv
ต่ง	dongc
ธอง	corng
เบ​ซา​เลน	Mbesaalen
กั่ง	gangc
ววมดาง	wuomndaang
เฮนี้ยต้าว	hnievdaauh
ท้าบ	taapv
ท้าบ	taapv
เจียมตังจ๋า	jiemdangjaax
เจียมเตี้ย	jiemdieh
ซิ	siqv
เหฒี่ยต้อง	ziecdorngh
หญุด	nyutc
หญุด	nyutc
หฒอบ	zorpc
เหฒาฒุ่ย	zauxzuih
เฮมย	hmei
โย์วเตี๋ย	youzdiex
แป๊ะมั์วต่อย	baeqvmuozdoic
จ๊างง่ง	jaangvngongh
จ๊างบั๊ว	jaangvmbuov
จ๊างเตว๊ยด๊าว	jaangvdueivndaauv
จ๊างเจี๊ยะ	jaangvjieqv
จ๊างเหนาะ	jaangvnorqc
จ๊างยั่ง	jaangvyangh
แกงถิว	gaengtiux
จ๊บตอน	jopvdorn
เหฒาเป๊น	zauxbenv
แซงคู้ไต่	saengkuvdaic
อ๋ม	omx
อ๊อซิ	orvsiqv
อ๊อหลุน	orvlunx
อ๊อหลุน	orvlunx
อ๊อหลุน	orvlunx
อ๊อหลุน	orvlunx
โบ๋ว	mboux
แป่ง	baengc
เซียะ	sieqv
โกวหม่า	goumaac
หมั่วหม่า	muocmaac
เฑี์ยหม่า	nziezmaac
แป๊ะเตี๋ย	baeqvdiex
เฑี์ยหม่า	nziezmaac
เอ๊าแฑงปวัง	auvnzaengbuang
โล้	lov
เด่ยเฮลน	ndeichlen
ป๊วนซิน	buonvsin
มั์วหม่า	muozmaac
เญย	nyei
เญย	nyei
ปุ้ย	buih
เก๊าะเมี่ยน	gorqvmienh
หฮญังโสว	hnyangxsoux
ด๊าวต้าว	ndaauvdaauh
แป๊ะมั์ว	baeqvmuoz
หฮญังโสว	hnyangxsoux
หฮญังโสว	hnyangxsoux
หฮญังโสว	hnyangxsoux
หฮญังโสว	hnyangxsoux
หฮญังโสว	hnyangxsoux
เปี๊ยวเด่ย	Biouvndeic
โล์เบย้า	lozmbiauh
ฟามฒิ่น	faamzinh
ป๊วนฒิ่น	buonvzinh
ป๊วนฒิ่น	buonvzinh
ป๊วนฒิ่น	buonvzinh
ป๊วนฒิ่น	buonvzinh
อิด​สา​คา	Itcsaaxkaa
เส​บู​ลุน	Sembulun
อา​เซ	Aase
นับ​ทา​ลี	Napvtaali
สู​ลิ​เอน	Suxlien
เดียซิ	ndiesiqv
เดียบั๊ว	ndiembuov
เดียหลัวะ	ndieluoqc
เก​โซน	Geson
เหฒาเบี่ย	zauxmbiec
เนียแป้ง	niebaengh
ววมอิม	wuomim
นา​สี	Naasi
กวาววม	guaawuom
กวาต๋ม	guaadomx
จั๋นแคะ	JanxKaeqv
ธง	cong
มา​นา	Maanaa
ซี	si
ดาม	ndaam
เอน​ดาด	Enndaatc
เม​ดาด	Mendaatc
หว่าเม้ย	waacmeiv
โม​เซ	Mose
เฮ้น	henv
หย่าว	yaauc
เฮ​โบ​โลน	Hembolon
โส​อัน	Soan
อา​มา​เล้ก	Aamaalekv
ฆี่ง	nqingh
โฆว	nqou
ลุยเก๊าะ	luigorqv
ฆี่ง	nqingh
โฆว	nqou
อน	On
อน	On
อา​บี​ลัม	Aambilam
คว้าย	kuaaiv
ฟินโค้ว	finkouv
โฮ​อา	Hoaa
โฮ​อา	Hoaa
อาน​โนน	Aannon
สุ​ฟา	Sufaa
วา​เฮ้บ	Waahepv
เบ​เอ	Mbee
ลง	long
มัด​ทา​นา	Matvtaanaa
นา​หะ​ลี​เอน	Naahaalien
บา​โม้ด	Mbaamotv
เฮ้ด​โบน	Hetvmbon
สิ​โหน	Sihonx
เฮ้ด​โบน	Hetvmbon
โต์วเบียด	douzmbietc
บา​ซาน	Mbaasaan
เป​โท	Beto
บา​ลา​อัม	Mbaalaaam
บา​ลา​อัม	Mbaalaaam
หฌาบ	njaapc
บา​ลา​อัม	Mbaalaaam
บา​ลา​อัม	Mbaalaaam
เหฒง	zengx
แบ๋งนี้ง	mbaengxningv
โส​ฟิม	Sofim
อา​โล	aalo
เมี้ยดาง	mievndaang
ปั์วฒ้างท้าด	buozzaangvtaatv
สา​ลู	Saaxlu
เป​โอ	Beo
ฮา​โน้ก	Haanokv
ปัน​ลู	Banlu
คาน​มี	Kaanmi
เน​มู​เอน	Nemuen
ยา​มีน	Yaamin
ยา​คีน	Yaakin
เส​โฟน	Sefon
เส​โฟน	Sefon
ฮัก​กี	Hakvgi
ซู​นี	Suni
โอด​นี	Otcni
เอ​เล​อี	Elei
อา​โล้ด	Aalotv
อา​เล​ลี	Aaleli
ฮา​มูน	Haamun
โท​ลา	Tolaa
พู​อา	Puaa
ยา​ซู้บ	Yaasupv
ซิม​โลน	Simlon
เส​เล้ด	Seletv
เอ​โลน	Elon
ยา​เล​เอน	Yaaleen
มา​คี​เล	Maakile
มา​คี​เล	Maakile
กิ​เล​อาด	Gileaatc
อี​เย​เซ	Iyese
อี​เย​เซ	Iyese
เฮ​เล้ก	Helekv
เฮ​เล้ก	Helekv
อัด​ลี​เอน	Atclien
เซ​มิ​ดา	Semindaa
เฮ​เฟ	Hefe
ซู​เท​ลา	Sutelaa
ซู​เท​ลา	Sutelaa
เบ​เค	Mbeke
ทา​ฮัน	Taahan
ซู​เท​ลา	Sutelaa
เอ​ลาน	Elaan
เอ​ลาน	Elaan
เบ​ลา	Mbelaa
อัด​เบน	Atcmben
อา​หิ​ลัม	Aahilam
อา​หิ​ลัม	Aahilam
เซ​ฟู​ฟาม	Sefufaam
หุ​ฟาม	Hufaam
อาด	Aatc
นา​อา​มาน	Naaaamaan
ซู​ฮัม	Suham
อิม​นา	Imnaa
อิด​วี	Itcwi
เบ​ลี​ยา	Mbeliyaa
เฮ​เบ	Hembe
มัน​คี​เอน	Mankien
ยา​เซ​เอน	Yaaseen
ยา​เซ​เอน	Yaaseen
กุ​นี	Guni
เย​เซ	Yese
ซิน​เลม	Sinlem
เซียงเบย้า	siangmbiauh
เอ​เล​อา​ซา	Eleaasaa
เปย๊ย	bieiv
คัง	kang
เอ​ลิม	Elim
ค้อยซิ	KoivSiqv
โด​ฟะ​คา	Ndofaakaa
อา​ลู้ด	Aalutv
ลิด​สา	Litvsaax
เค​เฮ​ลา​ทา	Kehelaataa
เซ​เฟ	Sefe
ฮา​ลา​ดา	Haalaandaa
มัก​เฮ​โล้ด	Makvhelotv
มิด​คา	Mitvkaa
ฮัด​โม​นา	Hatvmonaa
สัน​โม​นา	Sanxmonaa
ปู​โนน	Bunon
เย​ลี​โค	Yeliko
ค้อยไต่	KoivDaic
เม​ดิ​เต​เล​เนียน	Mendidelenien
ฮา​ซา​เล​นัน	Haasaalenan
เซ​ฟาม	Sefaam
ค้อยไต่	KoivDaic
เมี้ยเธี้ยง	mievciangv
เมี้ยเธี้ยง	mievciangv
ฒี่ง	zingh
เดี๋ยงจาสี่	ndiangxjaasic
ปั์วจ้วน	buozjuonh
ทิม	tim
โฮ​เล้บ	Holepv
เย	Yie
ีย	ziouc
ธั้มฮนอย	camvhnoi
เฒ​เล้ด	Zeletv
อาน	Aan
เฮ​โมน	Hemon
เหฒ่ง	Zengc
บา​ซาน	Mbaasaan
โต์วเสียว	douzsioux
กอน	gorn
เก้า	gauh
โก​ลาน	Golaan
โต์เล์ย	dozleiz
ววมเบ๋ว	wuommbeux
โหย่ว	youc
อา​น้าก	Aanaakv
ยา​อา​คัน	Yaaaakan
โม​เส​ลา	Moselaa
กุด​โก​ดา	Gutcgondaa
เดาเป้ย	ndaubeih
หวุย	uix
อา​บีบ	Aambipc
ฒองเหฒง	zorngzengx
เธว	ceu
โบ๊ว	mbouv
เซียงเปย๊า	siangbiauv
ดามตอง	ndaamdorng
ลุยซยามเจี๊ยะ	luisiaamjieqv
เอ๊า	auv
เม​โส​โป​เต​เมีย	Mesobodemie
เซียงเอ๊า	siangauv
เฑียงต้อ	nziangdorh
เซ้กๆ	sekvsekv
เดาเต่ย	ndaudeic
กั๊บเหฆน	gapvnqenx
มาเตี๊ย	maadiev
เฮม้ยดาน	hmeivndaan
เฮม้ยดาน	hmeivndaan
เฮมียนเหมว่ย	hmienmueic
ป๋าย	baaix
บยู่งบ๊วน	mbiungcmbuonv
เมี้ยหลุน	mievlunx
บยู่งกอง	mbiungcgorng
เมี้ยเญี์ยม	mievnyiemz
ตุ๊เอ๋ย	duqveix
ฮลุ	hluqv
เย​ซู​ลุน	Yesulun
จอง	jorng
เย​ซู​ลุน	Yesulun
ตาวหล่ม	DaauLomc
ต๊าม	daamv
เจ๊าโป่ว	jauvbouc
ฮลางซิ	hlaangsiqv
ลา​หับ	Laahapc
ฮลางซิ	hlaangsiqv
อา​ลา​บา	Aalaambaa
โย​ซู​วา	Yosuwaa
จอ​แดน	Jorndaen
เบ้ย	mbeih
ปู้ง	bungh
เหยียด	yietc
อา​คาน	Aakaan
โต์วเสียว	douzsioux
เบี๊ย	mbiev
โล์เฮ่	lozheh
โล์ลุยโหว	lozluihoux
กิ​เบ​โอน	Gimbeon
แปงม่าน	baengmaanh
มัก​เค​ดา	Makvkendaa
ลิบ​นา	Lipvnaa
เอก​โลน	Ekclon
ฮา​โซ	Haaso
ฮา​ลัก	Haalakv
บา​อัน​กาด	Mbaaan
ฮ์อง	Horngzhlen
ยับ​บอก	Yapvmborkc
ซิ​โห	Sihox
เม​อา​ลา	Meaalaa
เม​เด​บา	Mendembaa
เม​เด​บา	Mendembaa
มา​คี	Maaki
เฮ​โบ​โลน	Hembolon
อาก​ลับ​บิม	Aakclapvmbim
คาน​คา	Kaankaa
บงเฮลน	mbonghlen
ซิก​เค​โลน	Sikvkelon
ยับ​เน​เอน	Yapvneen
โอด​นี​เอน	Otcnien
คา​เล้บ	Kaalepv
ววมฒี้ง	wuomzingv
ขับ​เซ​เอน	Kapcseen
ยา​กูน	Yaagun
เล​บา​โอด	Lembaaotc
ซิน​ฮิม	Sinhim
อา​ดี​ทา​อิม	Aanditaaim
เก​เด​โล​ทา​อิม	Gendelotaaim
ฒี่ง	zingh
โฮ​โลน	Holon
เบด​เอน	Mbetcen
ฒะ	zaqv
ฒะ	zaqv
เฮลียะเธีย	hlieqvcie
มา​เล​อัน	Maalean
ดับ​เบ​เซ้ด	Ndapcmbesetv
ขัด​ตาด	Katcdaatc
นา​หะ​ลาน	Naahaalaan
อิ​ดา​ลา	Indaalaa
เค​สุน​โล้ด	Kesunxlotv
เฮน​ขัด	Henkatc
ฮา​ลี	Haali
เบ​เทน	Mbeten
เอ​โบน	Embon
ฮัม​โมน	Hammon
มา​หะ​ล้าบ	Maahaalaapv
อุม​มา	Ummaa
อัน​โมน	Anmon
มิ​ซาน	Misaan
คาน​ทา	Kaantaa
ดิม​นา	Ndimnaa
เส​ฟัด	Sefatv
อา​โม​ไล	Aamolai
เซ​เอ​ลา	Seelaa
โบ​คิม	Mbokim
เอ​ฮู้ด	Ehutv
เอ​ฮู้ด	Ehutv
เอ​ฮู้ด	Ehutv
เส​อี​ลา	Seilaa
เอ​ฮู้ด	Ehutv
เฮลียะม์าเธีย	hlieqvmaazcie
เด​โบ​ลา	Ndembolaa
เด​โบ​ลา	Ndembolaa
สิ​เส​ลา	Siselaa
สิ​เส​ลา	Siselaa
ยา​เอน	Yaaen
ยา​เอน	Yaaen
สิ​เส​ลา	Siselaa
ยา​เอน	Yaaen
ยา​เอน	Yaaen
ยา​เอน	Yaaen
ยา​เอน	Yaaen
หญอบัวะ	nyorxmbuoqc
สิ​เส​ลา	Siselaa
ยา​เอน	Yaaen
เจ๊าตอน	jauvdorn
เจ๊าฌ้วด	jauvnjuotv
คี​โซน	Kison
เม​โล้ด	Melotv
เม​โล้ด	Melotv
หญอเหฌียด	nyorxnjietc
เธียเยี่ยน	cieyienh
จวังโญ์ว	juangnyouz
มี​เดียน	Mindien
มี​เดียน	Mindien
ปั์วเดี๊ย	buozndiev
จุนเฒ้ย	junzeiv
กิ​เด​โอน	Gindeon
กิ​เด​โอน	Gindeon
ฒ่า	zaah
กิ​เด​โอน	Gindeon
กิ​เด​โอน	Gindeon
พวั้ง	puangv
บิ๊ด	mbitv
โต์วป๊า	douzbaav
เบด​บา​ลา​อา	Mbetcmbaalaaaa
ววมโป่ว	wuombouc
เบด​บา​ลา​อา	Mbetcmbaalaaaa
สัน​มุน​นา	Sanxmunnaa
ฌิ้มโธว	njimvcou
ฌิ้มหม่วน	njimvmuonc
จุนแปง	junbaeng
โน​บา	Nombaa
โย้ก​เบ​ฮา	Yokvmbehaa
สุก​โค้ด	Sukckotv
สัน​มุน​นา	Sanxmunnaa
ฌิ้มโธว	njimvcou
ฌิ้มหม่วน	njimvmuonc
เดี๋ยงฟ้ม	ndiangxfomv
อา​ลู​มา	Aalumaa
กา​อัน	Gaaan
เส​บุน	Sembun
หว่าเหมา	waacmaux
กา​อัน	Gaaan
อา​ลู​มา	Aalumaa
โท้บ	Topv
เย้บ​ทา	Yepvtaa
เย้บ​ทา	Yepvtaa
เย้บ​ทา	Yepvtaa
เย้บ​ทา	Yepvtaa
มิด​ปา	Mitvbaa
เย้บ​ทา	Yepvtaa
เย้บ​ทา	Yepvtaa
เซียะตอนต่อย	sieqvdorndoic
บงไอ๊ต๋อง	mbongaivdorngx
เย้บ​ทา	Yepvtaa
เซียะตอนต่อย	sieqvdorndoic
ชิบ​โบ​เล้ด	Qipvmboletv
สิบ​โบ​เล้ด	Sipcmboletv
ฟ่า	faah
อับ​โดน	Apcndon
มา​โน​อา	Maanoaa
มา​โน​อา	Maanoaa
มา​โน​อา	Maanoaa
ทิม​นา​ฮา	Timnaahaa
แซม​สัน	Saemsanx
แซม​สัน	Saemsanx
แซม​สัน	Saemsanx
หว่าอ๊อม	waacormv
หว่าอ๊อม	waacormv
เอ​ตาม	Edaam
เซียงฮลาง	sianghlaang
เบี่ยนปั์ว	mbiencbuoz
เด​ลิ​ลา	Ndelilaa
เธ้วฟ่าน	ceuvfaanh
ดา​โกน	Ndaagon
เปย๊าตู์ง	biauvdungz
เปย๊าตู์ง	biauvdungz
เบด​เล​เฮม	Mbetclehem
ฟามลู์ง	faamlungz
มี​คา	Mikaa
เอด​ทา​โอน	Etctaaon
ม์าน	maanz
เฑี้ยวๆ	nziouvnziouv
กิ​เบ​อา	Gimbeaa
กิ​เบ​อา	Gimbeaa
เฆน	nqen
ธา	Caa
เบน​ยา​มิน	Mbenyaamin
นา​โอ​มี	Naaomi
บวั์งหม่า	mbuangzmaac
นา​โอ​มี	Naaomi
มา	maa
ญาม	nyaam
จั้ว	juoh
นา​โอ​มี	Naaomi
มาปั่ว	maabuoc
มาปั่ว	maabuoc
มาปั่ว	maabuoc
เอนฒี่ง	enzingh
โบ​อาด	Mboaatc
ทุด	tutv
โบ​อาด	Mboaatc
ลา​มา​ทา​อิม	Laamaataaim
โท​หุ	Tohu
โท​หุ	Tohu
เป​นิน​นา	Beninnaa
ฮัน​นา	Hannaa
ฮัน​นา	Hannaa
ฮัน​นา	Hannaa
ฮัน​นา	Hannaa
เซียงลุยด๊าว	siangluindaauv
ซา​มู​เอน	Saamuen
ซา​มู​เอน	Saamuen
ซา​มู​เอน	Saamuen
ซา​มู​เอน	Saamuen
ซา​มู​เอน	Saamuen
ซา​มู​เอน	Saamuen
ซา​มู​เอน	Saamuen
ซา​มู​เอน	Saamuen
ซา​มู​เอน	Saamuen
ซี​โล	Silo
เอ​เบน​เอ​เซ	Embenese
ฟี​ลิ​สะ​เตีย	Filisaadie
จุนเฒ้ย	junzeiv
อี​คา​โบด	Ikaambotc
องปั่ว	ongbuoc
ดา​โกน	Ndaagon
แบ๊ะ	mbaeqv
เจียมน์าว	jiemnaauz
เจียมเฒว่ย	jiemzueih
ฮลับ	hlapv
เส​โล	Selo
เบ​โค​ลัด	Mbekolatv
เบ​โค​ลัด	Mbekolatv
อา​ฟี​ยา	Aafiyaa
เหลง	lengx
โล์ฮนอย	Lozhnoi
จังๆ	jangjang
เซียงเมี่ยน	siangmienh
เต่ยปูง	deicbung
ฮิบ​ลู	Hipvlu
เฮลียะหฒั่ง	hlieqvzaangc
พอง	porng
บงฉัง	mbongqangx
แบ๋งธิด	mbaengxcitv
โบ​เซ้ด	Mbosetv
เส​เน	Sene
แบ๋งธิด	mbaengxcitv
อา​หิ​ยา	Aahiyaa
โย​นา​ทาน	Yonaataan
เน	Ne
เค​ไน	Kenai
เฮมียนเซ้ด	hmiensetv
เซา​โล	Saulo
ธังแป๋ง	Cangbaengx
ตอนลาย	dornlaai
ธ้าว	caauv
ดา​วิด	Ndaawitv
ตอนหลุน	dornlunx
ญิ้ว	nyiuv
ญิ้ว	nyiuv
เฮลียะลุย	hlieqvlui
หฑั่น	nzanc
ดา​วิด	Ndaawitv
ไจ๋เฒว้ย	jaixzueiv
ฑ์มเต้า	nzomzdauh
มี​คาน	Mikaan
นา​โย้ด	Naayotv
นา​โย้ด	Naayotv
อา​หิ​เม​เล้ก	Aahimelekv
อา​หิ​เม​เล้ก	Aahimelekv
อา​คิด	Aakitv
ปุ๊ดดิน	butvndin
เฮ​เล้ด​ที	Heletvti
อา​บี​ยา​ทา	Aambiyaataa
เค​อี​ลา	Keilaa
เค​อี​ลา	Keilaa
โฮ​เล้ด	Holetv
โฮ​เล้ด	Holetv
โฮ​เล้ด	Holetv
โฮ​เล้ด	Holetv
ฮา​คี​ลา	Haakilaa
เย​ซิ​โมน	Yesimon
เปย๋า	biaux
จู๊ไต่	juvdaic
จู๊มัว	juvmuo
นา​บาน	Naambaan
นา​บาน	Naambaan
นา​บาน	Naambaan
เฟียมฝีง	fiemfingx
อา​บี​กา​ยิน	Aambigaayin
นา​บาน	Naambaan
นา​บาน	Naambaan
อา​บี​กา​ยิน	Aambigaayin
อับ​เน	Apcne
อับ​เน	Apcne
ซินเฮลน	sinhlen
หว่านๆ’	waancwaanc’
เดาฌัง	ndaunjang
กุ๊น	gunv
อิด​โบ​เซ้ด	Itcmbosetv
โย​อาบ	Yoaapc
อา​สา​เฮน	Aasaaxhen
อา​สา​เฮน	Aasaaxhen
โย​อาบ	Yoaapc
เบ​เอ​โล้ด	Mbeelotv
หฮญังเปี๋ยน	hnyangxbienx
เซียงง่ง	siangngongh
เซียงเธีย	siangcie
นา​โคน	Naakon
ง่ง	ngongh
ฮา​ดัด​เอ​เซ	Haandatcese
ฮา​ดัด​เอ​เซ	Haandatcese
โท​อี	Toi
เฑ้าฮ์อง	NzauvHorngz
ซิ​บา	Simbaa
ซิ​บา	Simbaa
เม​ฟี​โบ​เซ้ด	Mefimbosetv
ฮา​นูน	Haanun
ด๊ามกู้	ndaamvguh
ค้วดนอม	kuotvnorm
ซี​เลีย	Silie
เฮ​ลาม	Helaam
โซ​บัก	Sombakc
อุ​ลี​อา	Uliaa
อุ​ลี​อา	Uliaa
เอ๊า	auv
เย​ดี​ดิ​ยา	Yendindiyaa
กีงฒี่ง	gingzingh
ลับ​บา	Lapvmbaa
อัม​โนน	Amnon
อัม​โนน	Amnon
อัม​โนน	Amnon
อับ​ซา​โลม	Apcsaalom
อับ​ซา​โลม	Apcsaalom
กิ​โลน	Gilon
เซียงฮู่ง	sianghungh
อา​หิ​โท​เฟน	Aahitofen
หุ​ไซ	Husai
ฝุย	fuix
เจี๊ยบเญ์ย	jiepvnyeiz
อา​มา​สา	Aamaasaax
อิด​ทา​ลา	Itctaalaa
อิด​ทา​ลา	Itctaalaa
สวังติ่ม	suangxdimc
ตบ	dopc
แปงเปย๊ย	baengbieiv
เฮงๆ	hengheng
อา​หิ​มา​อัด	Aahimaaatc
อา​หิ​มา​อัด	Aahimaaatc
เม​ฟี​โบ​เซ้ด	Mefimbosetv
บา​ซิน​ไล	Mbaasinlai
บา​ซิน​ไล	Mbaasinlai
คิม​ฮาม	Kimhaam
บีก​ลี	Mbikcli
โกบ	Gopc
สับ​เป	Sapcbe
ววมหล่าง	wuomlaangc
ววมโด	wuomndo
ดั่ม	ndamc
ววมปั่ม	wuombamc
ด้อง	ndorngh
ฮา​โล้ด	Haalotv
ยา​เซน	Yaasen
อา​ลาว​นา	Aalaaunaa
อา​ลาว​นา	Aalaaunaa
ยาง	yaang
เซียะเหฑว่ย	sieqvnzueic
อา​โด​นี​ยา	Aandoniyaa
บัด​เช​บา	Mbatcqembaa
บัด​เช​บา	Mbatcqembaa
บัด​เช​บา	Mbatcqembaa
กี​โฮน	Gihon
กี​โฮน	Gihon
อา​โด​นี​ยา	Aandoniyaa
อา​บี​ช้าก	Aambiqaakv
เบ​ไน​ยา	Mbenaiyaa
ซิ​เม​อี	Simei
ซิ​เม​อี	Simei
ชี​ชา	Qiqaa
เอ​ลี​โฮ​เล้บ	Eliholepv
สา​บุด	Saaxmbutc
อา​หิ​ชา	Aahiqaa
เก​เบ	Gembe
ขอฒิ่น	korxzinh
ทิบ​สา	Tipvsaax
ม์าล่าน	maazlaanh
ม์าเซี้ยบ	maazsiepv
ไกว	guai
มา​โฮ	Maaho
ฮี​ลาม	Hilaam
ฒ่ง	zongh
ฒ่ง	zongh
ฑิบ	nzipv
ม่วน	muonh
ม่วน	muonh
แกงเมา	gaengmau
เฮญี้ยว	hnyouv
ฒุ์ย	zuiz
โต์วโล่ว	douzlouh
ฑั้งโน่ว	nzangvnouh
ฑั้งโน่ว	nzangvnouh
โล์เป๊น	lozbenv
อา​ละ​เบีย	Aalaambie
ฒ์างญ่า	zaangznyaah
ฒ์างญ่า	zaangznyaah
บีง	mbing
บีงเจี๊ยะ	mbingjieqv
ธิน	cin
คู​เอ	Kue
คู​เอ	Kue
ซา​โล​มอน	Saalomorn
ปา​ลาน	Baalaan
ทา​เป​เน้ด	Taabenetv
เก​นู​บัด	Genumbatc
เล​โซน	Leson
เล​โซน	Leson
เล​โซน	Leson
เล​โซน	Leson
เล​โซน	Leson
เส​เล​ดา	Selendaa
เส​ลุ​วา	Seluwaa
เซียงลุย	sianglui
เซียงลุย	sianglui
โต์เล์ย	dozleiz
เย​โล​โบ​อัม	Yelomboam
ปั์วโด๊ะตอน	buozndoqvdorn
เจียมง่ง	jiemngongh
เจียมง่ง	jiemngongh
เหฒี่ยต่อง	ziecdorngc
โฮยว	hiou
โฮยว	hiou
เดี๋ยงฝัง	ndiangxfangx
อา​บี​ยัม	Aambiyam
อา​บี​ยัม	Aambiyam
บา​อา​ชา	Mbaaaaqaa
เช​เม	Qeme
ฮี​เอน	Hien
ทิด​บี	Titvmbi
ทิด​บี	Titvmbi
สา​เล​ฟัด	Saaxlefatv
อ๋ง	Ongx
เอ​ลี​ยา	Eliyaa
เอ​ลี​ยา	Eliyaa
เอ​ลี​ยา	Eliyaa
ธังนั้ง	cangnangv
เกว๊ด	guetv
เย​เซ​เบน	Yesemben
ฮา​ซา​เอน	Haasaaen
เอ​ลี​ซา	Elisaa
เอ​ลี​ซา	Elisaa
เมี้ยนๆ	mienvmienv
นา​โบด	Naambotc
แหมง	maengx
ด๊บฮลาง	ndopvhlaang
แหมง	maengx
เซียงหฑ่อม	siangnzormc
เก​หะ​ซี	Gehaasi
เดียโตะ	ndiedoqc
เฮลียะโป๊ว	hlieqvbouv
เมาะ	morqv
นุๆ	nuqvnuqv
เย​เซ​เบน	Yesemben
เย​ฮู	Yehu
อา​ทา​ลิ​ยา	Aataaliyaa
ล่วน	luonh
ติ่น	dinc
โย​อาด	Yoaatc
โย​ซา​คา	Yosaakaa
เย​โฮ​อา​หาด	Yehoaahaatc
เย​โฮ​อา​หาด	Yehoaahaatc
ธุนเกน	cungen
เย​โฮ​อัด​ดิน	Yehoatcndin
โย้ก​เท​เอน	Yokvteen
ปู​ลา	Bulaa
เป​คา​หิ​ยา	Bekaahiyaa
เป​คา	Bekaa
เป​คา	Bekaa
เย​ลู​ซา	Yelusaa
เอ​ลัด	Elatv
ดา​มัด​กัด	Ndaamatvgatc
สะ​มา​เลีย	Saamaalie
โล์เล์ย	lozleiz
อัด​ซี​เลีย	Atcsilie
แกว๊งบ๋าย	guaengvmbaaix
กั๊วะ	guoqv
หว่าหฑยาว	waacnziaaux
ที​ละ​หะ​คา	Tilaahaakaa
ฮู่ง	hungh
เมี้ยยาง	mievyaang
หฒั่ง	zaangc
เม​ซุน​เล​เม้ด	Mesunlemetv
โย้ด​บา	Yotvmbaa
ฮา​ลุด	Haalutv
ซา​ฟาน	Saafaan
ซา​ฟาน	Saafaan
เน​บู​คัด​เน้ด​ซา	Nembukatvnetvsaa
เน​บู​ซา​ละ​ดาน	Nembusaalaandaan
ซินเฮลน	sinhlen
เน​บู​ซา​ละ​ดาน	Nembusaalaandaan
เน​บู​ซา​ละ​ดาน	Nembusaalaandaan
ลิบ​ลา	Lipvlaa
ยา​เฟ้ด	Yaafetv
คับ​โท	Kapvto
โย้ก​ทาน	Yokvtaan
บัด​ซู​วา	Mbatcsuwaa
ฮู​อา	Huaa
บุ​นา	Mbunaa
โอ​เลน	Olen
มา​อัด	Maaatc
เอ​เค	Eke
อา​บี​ชู	Aambiqu
สา​ซา	Saaxsaa
ยา​ละ​ฮา	Yaalaahaa
อัด​ไท	Atctai
สา​บาด	Saaxmbaatc
เซ​มา	Semaa
คา​เซ้ด	Kaasetv
คา​เซ้ด	Kaasetv
เซ​เบ	Sembe
ที​ละ​หะ​นา	Tilaahaanaa
ทิ​ลา​ไท	Tilaatai
สุ​คา	Sukaa
ฮา​นัน​ยา	Haananyaa
เน​อา​ลี​ยา	Neaaliyaa
โซ​บาน	Sombaan
ฮู​วา	Huwaa
นา​อา​ลา	Naaaalaa
อา​หุด​ซาม	Aahutcsaam
เท​เม​นี	Temeni
ฮา​อา​หัด​ทา​ลี	Haaaahatctaali
โขด	Kotc
โขด	Kotc
อา​นู้บ	Aanupv
โส​เบ​บา	Sombembaa
ฮา​ลูม	Haalum
อา​หาน​เฮน	Aahaanxhen
ยา​เบด	Yaambetc
นา​ฮัม	Naaham
เก​เลม	Gelem
มา​อา​คัด	Maaaakatv
โค​เซ​บา	Kosembaa
โย​คิม	Yokim
มิด​มา	Mitvmaa
เม​อู​นิม	Meunim
โย​ไล	Yolai
ยา​คาน	Yaakaan
ฒี​อา	Ziaa
โย​ฮา​นัน	Yohaanan
ลิบ​นี	Lipvni
อัด​สี	Atcsi
อา​หิ​โม้ด	Aahimotv
นา​หัด	Naahatc
ลิบ​นี	Lipvni
เฮ​มาน	Hemaan
โท​อา	Toaa
อา​มา​ไส	Aamaasaix
มัน​ลุก	Manlukv
บิ​เล​อัม	Mbileam
อา​เนม	Aanem
หุ​กอก	Hugorkc
ลิม​โม​โน	Limmono
เย​ลี​เอน	Yelien
ยา​ไม	Yaamai
อิบ​สัม	Ipcsamx
อิ​สะ​ลา​หิ​ยา	Isaalaahiyaa
อิ​สะ​ลา​หิ​ยา	Isaalaahiyaa
อี​ละ	Ilaqv
อา​เฮ	Aahe
เบ​ดาน	Mbendaan
เบ​เล้ด	Mbeletv
เบ​เล้ด	Mbeletv
เอ​เล​อา​ดา	Eleaandaa
เอ​เล​อา​ดา	Eleaandaa
เอ​เล​อัด	Eleatc
กัด	Gatc
เอ​ลี​ซา​มา	Elisaamaa
นา​อา​ลัน	Naaaalan
ไอ​ยา	Aiyaa
เอน​ปา​อัน	Enbaaan
มิด​อัม	Mitvam
เซ​เม้ด	Semetv
เซ​เม้ด	Semetv
มิก​โล้ด	Mikvlotv
โม​ซา	Mosaa
อา​เซน	Aasen
อุ​ไท	Utai
โอม​ลี	Omli
อิม​ลี	Imli
อา​สา​ยา	Aasaaxyaa
หัด​เส​นู​อา	Hatcsenuaa
โค​เล	Kole
ด่าง	ndaangc
เม​เซ​เล​มิ​ยา	Meselemiyaa
ฉงๆ	qongxqongx
ฮัก​โม​นี	Hakvmoni
เต๋ย	deix
จุนเฒ้ย	junzeiv
โด๊ะเฮลน	ndoqvhlen
โย​ซา​บาด	Yosaambaatc
แปงกวั้น	baengguanh
เอน​เพ​เล้ด	Enpeletv
หญี่	nyic
แกง	gaeng
คู​ซา​ยา	Kusaayaa
อุน​นี	Unni
อา​ลา​โม้ด	aalaamotv
มู้ง	mungv
โท​อู	Tou
ซา​วะ​ซา	Saawaasaa
นา​หาด	Naahaatc
โซ​ฟ้าก	Sofaakv
สิบ​ไป	Sipcbai
ลา​มี	Laami
เหฒาโด๊ะ	zauxndoqv
เฮลียะฌับ	hlieqvnjapv
เก​โซม	Gesom
กงป่วน	gongbuonc
เซ​บู​เอน	Sembuen
เย​เด​ยา	Yendeyaa
เซ​โล​โม้ด	Selomotv
อิด​ซี​ยา	Itcsiyaa
เบ​โน	Mbeno
โซ​ฮัม	Soham
อิบ​ลี	Ipcli
อา​ชา​เล​ลา	Aaqaalelaa
เป๊ด	betv
ซู​บา​เอน	Sumbaaen
เล​ฟา​เอน	Lefaaen
เส​มา​คิ​ยา	Semaakiyaa
เล​หับ​ยา	Lehapcyaa
เล​หับ​ยา	Lehapcyaa
อัม​มี​ซะ​บาด	Ammisaambaatc
อา​ซา​ซิ​ยา	Aasaasiyaa
ซิด​ไล	Sitvlai
อัด​ไล	Atclai
เจียมจาต๋อง	jiemjaadorngx
เจียมเธีย	jiemcie
กงเมี่ยน	gongmienh
โม​ลิ​ยา	Moliyaa
ธิหธุน	ciqvcunx
ธิหธุน	ciqvcunx
เจียมตีง	Jiemding
โต์วถาน	douztaanx
เจียมแก้ง	jiemgaengh
เปย๊ยเฒ้ย	bieivzeiv
ก๊อย	goiv
กงโปวเฮนี้ย	gongbouhniev
ฑั้งเจียน	nzangvjien
ฑั้งเจียน	nzangvjien
เจียมฒิ่น	jiemzinh
สุ​คี​อิม	Sukiim
อา​บี​ยา	Aambiyaa
ฟิ้วท้องป้าย	fiuvtorngvbaaih
อา​มัด​ยา	Aamatvyaa
มี​คา​ยา	Mikaayaa
สิด	Sitc
เย​ลู​เอน	Yeluen
ฮ์องคู้	horngzkuv
จุนแปงเปย๊ย	junbaengbieiv
อา​หัด​ยา	Aahatcyaa
เย​โฮ​ยา​ดา	Yehoyaandaa
ม์าแก้ง	MaazGaengh
ฮ์องแก้ง	HorngzGaengh
อา​หัด	Aahatc
เย​ฮู​เอน	Yehuen
เย​ลู​ซา​เลม	Yelusaalem
อา​ซา​ซิ​ยา	Aasaasiyaa
อิด​สะ​มา​คิ​ยา	Itcsaamaakiyaa
โด๊ะตอน	ndoqvdorn
ธั้มหญู่ง	camvnyungc
ฟิ้วแปงเปย๊ย	fiuvbaengbieiv
โย​สิ​ยา	Yosiyaa
โย​อา​หาด	Yoaahaatc
ไซ​ลัด	Sailatv
ไซ​ลัด	Sailatv
มิด​เล​ดาด	Mitvlendaatc
เซ้ด​บัด​ซา	Setvmbatcsaa
เจียมปุ้น	Jiembunh
เจียมหฑ่อม	jiemnzormc
เซ้ด​บัด​ซา	Setvmbatcsaa
เล​เอ​ไล​ยา	Leelaiyaa
สัก​ไค	Sakckai
อา​โด​นี​คัม	Aandonikam
เฒ้ยฟุน	zeivfun
โย​ลา	Yolaa
กิบ​บา	Gipcmbaa
ต่อย	doic
เฒ้ยฟุน	zeivfun
ฮา​ทิ​ทา	Haatitaa
โซ​ไบ	Sombai
ฮา​สู​ฟา	Haasuxfaa
ทับ​บา​โอด	Tapvmbaaotc
เค​โล้ด	Kelotv
สี​อา​ฮา	Siaahaa
พา​โดน	Paandon
เล​บา​นา	Lembaanaa
ฮา​กา​บา	Haagaambaa
ฮา​กาบ	Haagaapc
ซัน​ไม	Sanmai
กิด​เดน	Gitcnden
กา​ฮา	Gaahaa
เน​โค​ดา	Nekondaa
กัด​ซาม	Gatcsaam
เบ​ไส	Mbesaix
เน​ฟิ​สิม	Nefisimx
บัก​บูก	Mbakcmbukc
ฮา​คู​ฟา	Haakufaa
ฮาน​ฮู	Haanhu
บัด​ลู้ด	Mbatclutv
เม​หิ​ดา	Mehindaa
ฮาน​ซา	Haansaa
บา​โขด	Mbaakotc
เน​ซิ​ยา	Nesiyaa
ฮา​ทิ​ฟา	Haatifaa
โส​ไท	Sotai
หัด​โส​เฟ​เล้ด	Hatcsofeletv
เป​ลุ​ดา	Belundaa
ยา​อา​ลา	Yaaaalaa
ดาน​โคน	Ndaankon
กิด​เดน	Gitcnden
เน​โค​ดา	Nekondaa
เอ​สาน​ฮัด​โดน	Esaanxhatvndon
ซิม​ไซ	Simsai
ต่อยๆ	doicdoic
ซิม​ไซ	Simsai
โย​ซา​ดัก	Yosaandakc
โถว	toux
คา​สิ​เฟีย	Kaasifie
มา​อา​เส​อา	Maaaaseaa
เอ​ลา​สา	Elaasaax
ลา​มี​ยา	Laamiyaa
อา​ซี​ซา	Aasisaa
เซ​อัน	Sean
อิด​ซี​จา	Itcsijaa
ชี​เม​โอน	Qimeon
มัด​ทัด​ตา	Matvtatvdaa
เย​เล​ไม	Yelemai
มา​อา​ได	Maaaandai
อู​เอน	Uen
เส​บิ​นา	Sembinaa
ย้าด​ได	Yaatvndai
โล์เจ๊า	lozjauv
ฮาน​ฮา​ยา	Haanhaayaa
เจียมหฒั่ง	jiemzaangc
บิน​นุย	Mbinnui
ววมแก้ง	WuomGaengh
เจียมหฒั่ง	jiemzaangc
ฮา​มี​ปา​คัด	Haamibaakatv
เดาป่วน	ndaubuonc
แก้ง	gaengh
หฑุ่นๆ	nzuncnzunc
หฑุ่นๆ	Nzuncnzunc
เอ​ลูน	Elun
โท​บี​อา	Tombiaa
เฮ​เซ​คี​ยา	Hesekiyaa
โฮ​ดา​วิ​ยา	Hondaawiyaa
ยฟุน	zeivfun
สี​อา	Siaa
เน​ฟู​เซ​สิม	Nefusesimx
บัด​ลี้ด	Mbatclitv
โส​เฟ​เล้ด	Sofeletv
เป​ลี​ดา	Belindaa
เดี๋ยงพ่าง	ndiangxpaangh
ฮัด​บัด​ดา​นา	Hatvmbatcndaanaa
โต่ว	douc
แซงเหญ่ย	saengnyeic
โต์วเดี้ยว	douzndiouh
อา​ซัน​ยา	Aasanyaa
โฮ​ดี​ยา	Hondiyaa
อา​ทา​ยา	Aataayaa
โย​เอด	Yoetc
โย​เอด	Yoetc
เป​ดา​ยา	Bendaayaa
โค​ลา​ยา	Kolaayaa
เป​ลา​ลิ​ยา	Belaaliyaa
เป​ลา​ลิ​ยา	Belaaliyaa
อา​ม้าด​ไส	Aamaatvsaix
อัก​ไซ	Akcsai
อัก​ไซ	Akcsai
เม​ซิน​เล​โม้ด	Mesinlemotv
หัก​เก​โด​ลิม	Hakcgendolim
เม​โค​นา	Mekonaa
เย​ซู​อา	Yesuaa
อุน​โน	Unno
สา	saax
มิ​ลา​ไล	Milaalai
กิ​ลา​ไล	Gilaalai
มา​ไอ	Maaai
ฮา​ดา​ซา	Haandaasaa
ฮัม​เม​ดา​ทา	Hammendaataa
เจียนเม่ง	jienmengh
ฮัม​เม​ดา​ทา	Hammendaataa
ฮาน​โบ​นา	Haanmbonaa
สิ​วัน	Siwan
ม์าเซี้ยบ	maazsiepv
ฟิ้วเจียน	fiuvjien
เบ่น	mbenc
บ๋วนโฮ์	mbuonxhoz
เฉียโดะ	qiexndoqc
ซินเปยย	sinbiei
เหยียะ	yieqc
ทินแป้ง	tinbaengh
เหฑียง	nziangx
ฟองธัง	forngcang
โด๊ะหฒวน	ndoqvzuonx
ปั์วเดี๊ย’	buozndiev’
ต้าย’	daaih’
แฑะ	nzaeqv
ปวน	buon
ววมฑุ่ย	wuomnzuih
แกงหญ่อ	gaengnyorc
แหง่ง	ngaengc
หญอเฮมยแหง่ง	nyorxhmeingaengc
เซียงจุนแปง	siangjunbaeng
ธั้มปูง	camvbung
บะ	mbaqc
หว่าผุย	waacpuix
หฮลาโสว	hlaaxsoux
เดี๋ยงหลุน	ndiangxlunx
อ๊อจุ่น	orvjunc
ปู๊จา	buvjaa
ปู๊จา	buvjaa
เหฒาโฆ	zauxnqo
แหนะ	naeqc
เหฒาโฆ	zauxnqo
เฮม้ยเน้า	hmeivnauv
เซาะ	sorqv
ฟุโหละ	fuqvloqc
เฮลียะจาสี่	hlieqvjaasic
บู๊งฟิม	mbungvfim
ทินแปง	tinbaeng
นางฑูง	naangnzung
ฮล้อ	hlorv
ฮ้าๆ	haavhaav
บยู่งซุ้ย	mbiungcsuiv
ชะเหละ	qaqvleqc
เมี้ยฑู่ง	mievnzungh
เดี๋ยงฑู่ง	ndiangxnzungh
เดาค้วด	ndaukuotv
ทุ้ย	tuiv
ฮลัม	hlam
ฑิ้วๆ	nziuvnziuv
ลุยจาง	luijaang
ฟานเฟย	faanfei
เดาหฒวน	ndauzuonx
โล์เดาเฒี้ยว	lozndauziouv
เมี้ยเหฒวย	mievzueix
บุ​ซี	Mbusi
บา​ลา​เคน	Mbaalaaken
เตา	dau
ววมเดี๊ยบ	wuomndiepv
ววมทาน	wuomtaan
หฒ่งๆ	zongczongc
ล่ม	lomh
ค้อยโด๊ะ	koivndoqv
เมี้ยแมง	mievmaeng
ฟามธีง	FaamCing
ววมอ๋ง	wuomongx
เนียดุ้น	niendunh
กงเฮนี้ย	gonghniev
เธี้ยวๆ	ciouvciouv
เฮลียะปย๊า	hlieqvbiaav
เดี๋ยงฌิ้ม	ndiangxnjimv
ซุ้ยเลี่ยม	suivliemh
โต์วฟีง	douzfing
อ๊อฑิว	orvnziu
เดี๋ยงลัด	ndiangxlatv
โล์แกง	lozgaeng
ฒง	zong
ขัมปุย	kamxbui
จางโฮ่	jaanghoh
ซินเซย	sinsei
หฑยาวจอม	nziaauxjorm
ฟามปูง	faambung
ฟิ้วแฑง	fiuvnzaeng
เจ๊าแป้ง	jauvbaengh
ซีงเฉีย	singqiex
กีงต์ง	gingdongz
หฒ่ง	zongc
ต๋อยเตก	doixdekc
พานๆ	paanpaan
พัวะๆ	puoqvpuoqv
พานๆ	paanpaan
พัวะๆ	puoqvpuoqv
ฮวางๆ	huaanghuaang
ฒางๆ	zaangzaang
ด๊าดเดี๊ย	ndaatvndiev
เฟยฟั้ง	feifangv
เซียวเซ่ง	siousengh
จางเดี๊ย	jaangndiev
ฟิ้วบง	fiuvmbong
เบี๊ยด	mbietv
ผวน	puonx
เจียมหลิ่ม	jiemlimc
เกว๋ย	gueix
ตอเหฒี่ย	dorziec
หว่าเหมา	waacmaux
หว่ากาม	waacgaam
ธุเหมา	cuqvmaux
บา​คา	Mbaakaa
ฟางปวั้ง	faangbuangh
เฒียนๆ	zienzien
ม์วนหฒั่น	muonzzanc
โพว	pou
เซียงโย่ว	siangyouh
โฒ์ๆ	zozzoz
ด๊ามเสย	ndaamvseix
ปุ๋ย	buix
วินจา	winjaa
อา​เมน	Aamen
เจ๊าหฒะ	jauvzaqc
เยียมๆ	yiemyiem
เฮลียะแก้ง	hlieqvgaengh
เดาจุ่น	ndaujunc
ท้องป้าย	torngvbaaih
ฌิ้มหล่ม	njimvlomc
ตอเหฒี่ย	dorziec
เบด	Mbetc
เฟยฟั้ง	feifangv
เฟยฟั้ง	feifangv
ฒา​ยิน	Zaayin
เหด	Hetc
ติ่วๆ	diucdiuc
เถด	Tetc
ยด	Yotv
คับ	Kapv
ซา​เม้ก	Saamekv
เฮลียะไฆ้	hlieqvnqaiv
ฒา​เด	Zaande
โด๊ะหฑวน	ndoqvnzuonx
ไหล่	laic
เธ้น	cenv
เปย๊าเก๊าะ	biauvgorqv
เฮลียะหลิ่ม	hlieqvlimc
ชมชาว	qomqaau
เม้ย	meiv
จายต้าว	jaaidaauh
ก๊องหฌาว	gorngvnjaaux
เฮ้ย	heiv
ฒิ่ม	zimh
ดุ๊ด	ndutv
เจ๊าหธา	jauvcaax
หฮลาจุ้น	hlaaxjunh
จ๊าบม์า	jaapvmaaz
ค้อยหมิ่น	koivminc
เฌียนโย่ว	njienyouh
ตั๊งต้อ	dangvdorh
เหฑียงต้อ	nziangxdorh
ก๊องแปะ	gorngvbaeqc
ฒุ์ย	zuiz
หว่าหลง	waaclongx
เมว์ยต้อง	mueizdorngh
ววมหนัม	wuomnamx
ววมญ่วน	wuomnyuonh
เมี้ยฆาย	mievnqaai
ปั์วฒ้างออ	buozzaangvor
ววมปยม	Wuombiom
ไจก๋อง	Jaigorngx
ลุยเซี้ยว	luisiouv
ววมฌ่าง	wuomnjaangh
สาว	saaux
ปวั้ง	buangh
ว่วน	wuonh
ฮลางเซี้ยด	hlaangsietv
ฌิ้มญัง	njimvnyang
หว่าไฝ	waacfaix
หฮญัง	Hnyangxjeiv
ววมค้วดฑุ่ย	wuomkuotvnzuih
ธั้มติ้ว	camvdiuh
ตู์งแฮ่ง	dungzhaengh
แซ่ง	saengh
บงธิด	mbongcitv
ววมญ่วน	wuomnyuonh
ซวังซุ้ย	suangsuiv
มู​หย่อ	muyorc
แกงซอน	gaengsorn
แป๊ดๆ	baetvbaetv
เก๊าะจัง	gorqvjang
ซูงตอน	sungdorn
ตาว	daau
หมั่วไฝ	muocfaix
ติ๊วคู้	diuvkuv
บงฮลัง	mbonghlang
โผวๆ	pouxpoux
ท้อง	torngv
แบ	mbae
เส​ลา​ฟิม	selaafim
โต์วถาน	douztaanx
โต์วถาน	douztaanx
เย​เบ​เล​คี​ยา	Yembelekiyaa
หว่าหฌ่ม	waacnjomc
แหล่งๆ	laengclaengc
เต๋ยๆ	deixdeix
หล่มเดี๊ย	lomcndiev
ลม	lom
โป๊ว	bouv
เดี๋ยงด๋น	ndiangxndonx
บงฌัง	mbongnjang
จู๊เปน	juvben
ก๋อย	goix
หล่มเบยาะ	lomcmbiorqc
โกๆ	gogo
เบี๊ยะโธว	mbieqvcou
ก๋อโย์ว	gorxyouz
ววมหฒวน	wuomzuonx
ซา​กอน	Saagorn
อา​ละ​เบีย	Aalaambie
ฟ้อเฒ่ย	forvzeih
เดี๋ยงตีง	ndiangxding
ฟิ้วจาต๋อง	fiuvjaadorngx
ติ๊วก่อง	diuvgorngc
ทาน​ซิด	Taansitv
เหญา	nyaux
ฮลัง	hlang
เหฒาธ้าย	zauxcaaiv
ฮ์องต้าว	horngzdaauh
เตียน	dien
เป​ลา​ซิม	Belaasim
หงัน	nganx
ท่ง	tongh
เฮา	hau
หงัน	nganx
ท่ง	tongh
เฮา	hau
หม่อ	morc
หงัน	nganx
ฒาง	zaang
เดาจุ่น	ndaujunc
ฮา​เน้ด	Haanetv
เดาหลง	ndaulongx
เดาหลง	ndaulongx
เดาหลง	ndaulongx
เดาโย่ว	ndauyouh
ปูงฮวาง	caux
แธะ	caeqv
ฮลังๆ	Hlanghlang
ไอ๊ๆ	aivaiv
ปั์วหนาม	buoznaamx
ทินแป้ง	tinbaengh
ลัด	latv
เหฮลยกวั้น	hleixguanh
ห่อน	hornc
ห่อน	Hornc
ตีง	ding
เญย’	nyei’
ขูงหฑยาว	kungxnziaaux
เฮลียะเฒว่ย	hlieqvzueih
ซูงๆ	Sungsung
จาด่าง	jaandaangc
ซี​นิม	Sinim
จูงฮู่ง	junghungh
ธั้มกั๊วะ	camvguoqv
เจ๊า	jauv
เดี๋ยงโควฆาย	ndiangxkounqaai
ฟี้ง	fingv
เซียงเหธย	SiangCeix
เฮลียะจ๊าบ	hlieqvjaapv
เฮลียะหมั่ว	hlieqvmuoc
ฑั้งกวั้น	nzangvguanh
เซียงบั๋ว	siangmbuox
ห่ง	hongc
เต้า	dauh
เซียงเดา	siangndau
เฮลียะเดี้ยว	hlieqvndiouh
ไซ​ปัดค้อยโฑว	SaibatcKoivNzou
เซียงโหฒว	siangzoux
สาน	saanx
เต่ยปูง’	deicbung’
เหฒะ	zeqc
ขูงๆ	kungxkungx
บงตอน	mbongdorn
เฝียวฒ่อย	fiouxzoih
เซียงเฒี้ยว	siangziouv
ววมโตะ	wuomdoqc
ม์าเญี่ยน	maaznyienh
อุ​ฟ้าด	Ufaatv
เซ้ด	setv
เฮลียะโล่ว	hlieqvlouh
จายห่อง	jaaihorngc
อา​นา​โท้ด	Aanaatotv
ธั้มหฑุ่น	camvnzunc
หฒ	zuqc
เญี้ยม	nyiemv
ฑ่าย	nzaaih
หลาย	laaix
เซียงแก้ง	SiangGaengh
บา​บี​โลน	Mbaambilon
เฮลียะก์า	hlieqvgaaz
โล์บง	lozmbong
นุ์น	nunz
นุ์น	nunz
เซียงแหง่ง	siangngaengc
ฮา​นัน​เอน	Haananen
เก๊าะแก้ง	GorqvGaengh
ฮา​นัม​เอน	Haanamen
อัน​นา​โท้ด	Annaatotv
ฮา​นัม​เอน	Haanamen
เดาโซว	ndausou
เดาโซว	ndausou
เดาโซว	ndausou
เนียอ๋ง	nieongx
เดาโซว	ndausou
ฮา​บา​ซิน​ยา	Haambaasinyaa
เก​มา​ลิ​ยา	Gemaaliyaa
เย​ฮู​ดี	Yehundi
เย​โฮ​ยา​คิม	Yehoyaakim
เคน​เดีย	Kenndie
เน​ทา​นิ​ยา	Netaaniyaa
ท้าด	taatv
บา​อา​ซา	Mbaaaasaa
เน​ทา​นิ​ยา	Netaaniyaa
เฮ​ลี​โอ​บุ​ลี	Heliombuli
ลิ​เดีย	Lindie
ติ๊วฒา	diuvzaa
แปง’	baeng’
โม​อับ	Moapc
เค​ดา	Kendaa
เอ​ลาม	Elaam
เม​ลา​ทา​อิม	Melaataaim
เป​โขด	Bekotc
หญม	nyomx
จวังหฒิน	juangzinx
เดียล่าง	ndielaangh
แซ้งเฒี้ยว	saengvziouv
เหมียด	mietc
เส​เด​คี​ยา	Sendekiyaa
หฑ่อมไฝ	nzormcfaix
ฮวางๆ	huaanghuaang
เนียดุย	niendui
เจี๊ยบต๊าม	jiepvdaamv
เนียมอ	niemor
โต์วเหมี่ย	douzmiec
โหย่วๆ	youcyouc
โมว	mou
เซี้ยว	siouv
เยี้ยนเปี๋ยน	yienvbienx
ฮวุยแปะ	huibaeqc
ฮวุยแปะ	huibaeqc
ออน	orn
ปั์วโคว	buozkou
ปั์วโคว	buozkou
โต์วกั๋น	douzganx
เน์ว	neuz
ฑย้ามด้อง	nziaamvndorngh
ถิน	tinx
เต่ยปูง	Deicbung
ดามตอง	ndaamdorng
คู้	kuv
เซียงเฮญี้ยว	sianghnyouv
เซียงลี่ง	sianglingh
เฮมยหม่า	hmeimaac
น่าม	naamh
ม์าโก๊ว	maazgouv
โช​อา	Qoaa
โค​อา	Koaa
ปั์วฒุ่ย	buozzuih
ม์าแปง	maazbaeng
เดียบวั้ง	ndiembuangh
ฑั้งเฒ่ย	nyei
ค้อยโฑว	Saibatc
ฑั้งพ่าง	nzangvpaangh
เฮ​เหลก	Helekc
กา​มัด	Gaamatv
เดี๋ยงเจี๊ยะ	ndiangxjieqv
ม์าเก้	maazgeh
คาน​เน	Kaanne
คิน​ม้าด	Kinmaatv
สิ​เอ​เน	Siene
ววมฑัง	wuomnzang
ฟิ้วบง	fiuvmbong
บู๊งฆาย	Mbungvnqaai
เท้า	Tauv
โฒ้ว	zouv
เฒ้ยฟะ	zeivfaqv
เจี๋ย	jiex
ฮา​โมน	Haamon
ฮา​โม​นา	Haamonaa
ขูงต๋อง	kungxdorngx
เหฒาเหมว่ย	zauxmueic
โด๊ะเฮลน	ndoqvhlen
ววมฑ่าย	wuomnzaaih
ววมฒ้าม	wuomzaamv
เม​ลิ​บัด​คา​เดด	Melimbatc
โลน	wuov
ฮา​ซา​เอ​โนน	Enon
ฮา​มัด	Haamatv
ววมแปะ	wuombaeqc
โซวหฑั่ง	sounzaangc
ไกวช้าว	guaiqaauv
ไกวช้าว	guaiqaauv
ไกวช้าว	guaiqaauv
ไกวช้าว	guaiqaauv
ไกวช้าว	guaiqaauv
ไกวช้าว	guaiqaauv
ไกวช้าว	guaiqaauv
ไกวช้าว	guaiqaauv
ดู​ลา	Ndulaa
จ้าม	jaamh
เบน​เท​ซัด​ซา	Mbentesatvsaa
ค้วดโด๊ะ	kuotvndoqv
ด๊ามหธาม	ndaamvcaamx
กา​เบ​เลียน	Gaambelien
ยิด​เล​เอน	Yitvleen
เอ​ฟา​อิม	Efaaim
เธียวเกน	ciougen
ฌั้ว	njuov
เดี๋ยงเผยฒา	ndiangxpeixzaa
โคว	kou
เป​ทุ​เอน	Betuen
ญ่า	nyaah
ตงเกน	donggen
เหฮลย	Hleix
สัก​คุด	Sakckutv
ไค​วัน	Kaiwan
เปย๊าตอน	biauvdorn
เมี้ยด	mietv
เมี้ยด	mietv
เค​ลี้ด	Kelitv
แบ๋งฉัง	mbaengxqangx
โม​เล​เซ้ด	Molesetv
ลู้ง	lungv
ฌิ้มบย์อง	njimvmbiorngz
เท​เบด	Tembetc
คู​ชัน	Kuqan
เด์นๆ	ndenzndenz
เฑ้าค้วด	nzauvkuotv
เย​โฮ​ซา​ดัก	Yehosaandakc
ฆั้ม	nqamv
หฑ่อม	Nzormc
ตังฒ้าน	dangzaanv
ตังกุ๊น	danggunv
ม์าเจี๊ยะ	Maazjieqv
ม์าแปะ	maazbaeqc
เจี๊ยะแปะ	jieqvbaeqc
เฒว์ย	zueiz
หัด​ล้าก	Hatclaakv
ววมค้วดฆาย	wuomkuotvnqaai
เอน	En
ฮ์อง	horngz
เดาต์ง	ndaudongz
เหฒะ	zeqc
มา​ลา​คี	Maalaaki
ค้อเลี่ยน	korvlienh
ฟูสู	fusux
ตู์งดิน	dungzndin
แป่งไบ	baengcmbai
แหวะ	waeqc
เว่ะ	weqv
กา​ดา​ลา	Gaandaalaa
แป่งไบ	baengcmbai
มัด​ทาย	Matvtaai
ปุ๊ดแป่ง	butvbaengc
เซียงเดีย	siangndie
โล์ลุย	lozlui
เซียงเดีย	Siangndie
เด่ยเฒี้ยว	ndeicziouv
เด่ยเฒี้ยว	Ndeicziouv
เด่ยเฒี้ยว	Ndeicziouv
ไลจ๋าย	laijaaix
แหล่ง	laengc
เฮ​โล​เดียด	Helondietc
ดู่ง	ndungc
ฌ์อย	njoiz
ไว์ๆ	waizwaiz
ววมหมิ่น	wuomminc
เกน​เน​ซา​เล้ด	Gennesaaletv
เอยโต้ว	eidouh
เอยโต้ว	eidouh
เอยโต้ว	eidouh
ไซเตี๋ย	SaiDiex
หฮนางเฮม้ย	nzauz
มา​กา​ดาน	Maagaandaan
ปยา	biaa
ฟี​ลิบ​พอย	Filipvpoi
ยา​กอบ	Yaagorpc
ธั้มติ่ว	camvdiuc
ซิมบยุ่ย	simmbiuic
กงฮนอย	gonghnoi
เดี๋ยงน่อม	ndiangxnormh
ธีงจาหฮนาง	cingjaahnaangx
เฮลี้ยง	hliangv
ไซเตี๋ย’	SaiDiex’
โตะ	doqc
ฒุ	zuqv
เกด​เส​มา​นี	Getcsemaani
ลุยด๊าวซิ	luindaauvsiqv
ลุยด๊าวซิ	luindaauvsiqv
อา​ลิ​มา​เทีย	Aalimaatie
โฒ้วแก้ง	zouvgaengh
เหน่าๆ	naucnauc
เซียงหฌาว	Siangnjaaux
โล์เดีย	lozndie
เนี้ยด	nietv
โหธวเดี๊ย	couxndiev
ไลจ๋าย	laijaaix
จ๋อง	jorngx
เญี้ยดฮนอย	nyietvhnoi
เทาะเสียน	torqvsienx
เด่ยลิ่ว	ndeicliuh
บ์ม	mbomz
เด่ยลิ่ว	ndeicliuh
ฟา​ลิ​สี	Faalisi
แธงเยี้ยน	caengyienv
เบี๋ยงหฑยาว	mbiangxnziaaux
ดาน​มา​นู​ทา	Ndaanmaanutaa
ไญ้	nyaiv
หฌัง	njangx
แกงเมา	gaengmau
โล์เอ๊า	lozauv
เซียงโหฆ	siangnqox
โล​มา	Lomaa
เอ๊ากว๊าจ่ม	auvguaavjomc
เดียแหล่ง	ndielaengc
เท​โอ	Teofilatv
ฟี​ลัด	aac
ออ​กัด​ตัด	Orgatcdatc
เฒียวตี้ง	zioudingh
กว๊า	guaav
ย่วน	yuonh
ขัมบาง	kamxmbaang
น้ม	nomv
ฒุ์ยเมี่ยน	zuizmienh
ฌิ้มหล่ม	njimvlomc
เก​ลา​ซา	Gelaasaa
เซียะโดะ	sieqvndoqc
ไย​ลัด	Yailatv
เฆ่ม	nqemh
ตอน	Dorn
หวี่ง	wingc
โล์ปิ๊ว	lozbiuv
เบ​เอน​เซ​บูน	Mbeensembun
โล์เปย๊า	lozbiauv
โล์เปย๊า	lozbiauv
ด๊าม	ndaamv
แป่งโฟ่ว	baengcfouh
ฟิ้วเจ๊า	fiuvjauv
ด๊ามจูง	ndaamvjung
นีอา	niaa
ฒิว	ziu
หฮนางเฮม้ยด๊อด	hnaangxhmeivndortv
สัก​เคี้ยด	Sakckietv
เบี๊ยนเบ๋ว	mbienvmbeux
เอม​มา​อูด	Emmaautc
กอนญ่วน	gornnyuonh
ลับ​บี	Lapvmbi
ลับ​บี	Lapvmbi
เดี๋ยงกอน	ndiangxgorn
ฝาวๆ	faauxfaaux
เหฌี่ยๆ	njiecnjiec
ดั๊ม	ndamv
อ๋งฑุ่ย	ongxnzuih
ธีงซุ้ย	cingsuiv
ฮลางปิน	hlaangbin
เซียงยู์ง	siangyungz
เซียงยู์ง	siangyungz
เซียงยู์ง	siangyungz
เจี๋ย’	jiex’
ไซก๋อ	saigorx
กอนญ่วน	gornnyuonh
ทิ​เบ​เลี้ยด	Timbelietv
ด๊ามตี้ง	ndaamvdingh
จั๋นกีก	JanxGikc
สี​โล​อัม	Siloam
ฆ่ง	Nqongh
อิ​สะ​ยา	Isaayaa
เดง	ndeng
เซียงหลี่ง	sianglingc
เหฮนง	hnengx
ลับ​โบ​นี	Lapvmboni
ฑั้งเฮลน	nzangvhlen
ฮยางปูง	hiaangbung
ปาน​เทีย	Baantie
คับ​ปา​โด​เซีย	Kapvbaandosie
ปอน​ทัด	Borntatv
ฟา​ลี​เจีย	Faalijie
ปัม​ฟี​เลีย	Bamfilie
ฮยางปูง	hiaangbung
เดียตั้ม	ndiedamh
ตั้ม	damh
ปุ๊ดแป่ง	butvbaengc
เซียงแหม่ง	siangmaengc
เล​ฟาน	Lefaan
ง้าวๆ	ngaauvngaauv
โด​คัด	Ndokatv
อิ​ตา​ลี	Idaali
ด๊บหฒั่ง	ndopvzaangc
โค​เน​ลิ​อัด	Koneliatc
ด๊บหฒั่ง	ndopvzaangc
เมี่ยน	Mienh
อัน​ที​โอก	Antiokc
บะ​ละ​สะ​ทัด	Mbaalaasaatatv
นี​เก	Nige
มา​นา​เอน	Maanaaen
มา​นา​เอน	Maanaaen
เซ​ลู​เคีย	Selukie
ซา​ลา​มิด	Saalaamitv
ปา​โฟ้ด	Baafotv
บา​เย​ซู	Mbaayesu
บา​เย​ซู	Mbaayesu
เส​จี​อัด	Sejiatc
เส​จี​อัด	Sejiatc
ปา​โฟ้ด	Baafotv
ปิ​สิ​เดีย	Bisindie
ลิ​สะ​ตา	Lisaadaa
แฑงแหง่ง	nzaengngaengc
ฟิ้วหธง	fiuvcongx
ทิ​โม​ไท	Timotai
มิ​เซีย	Misie
ฟี​ลิบ​พอย	Filipvpoi
ดั๊บอ๋อน	ndapvornx
เซียงเล์ย	siangleiz
อา​เล้ก​ซาน​เด​เลีย	Aalekvsaanndelie
ฟ้าดโซว	faatvsou
อาน​เท​มิด	Aantemitv
เธ้วๆ	ceuvceuv
ทอ​เล​มี	Torlemi
มะ​นา​สัน	Maanaasanx
มะ​นา​สัน	Maanaasanx
เทยกอน	teigorn
เทยต้าว	teidaauh
แปงเปย๊ย	baengbieiv
อัน​ทิ​ปา​ตี	Antibaadi
ดู​สิน​ลา	Ndusinxlaa
ยู​เลี้ยด	Yulietv
อัด​ลา​มิด​ทิ​ยุม	Atclaamitvtiyum
สุน	sunx
ลี​เซีย	Lisie
มิ​ลา	Milaa
คา​นี​ดัด	Kaanindatc
สุน	sunx
ป์าย	baaiz
สัน​โม​เน	Sanxmone
คาว​ดา	Kaaundaa
ฑั้งตอน	nzangvdorn
ฑั้งตอน	nzangvdorn
มอน​ตา	Morndaa
อับ​ปี​อัด	Apcbiatc
แคะเปย๊า	KaeqvBiauv
หฒีง	zingx
หว่าโตะ	waacdoqc
อับ​ลา​ฮัม	Apclaaham
เซียงเฒี่ยง	siangziangh
โล์เฮญี้ยว	lozhnyouv
ค้อเลี่ยน	korvlienh
กีง	GingSou
กิ๋น	ginx
อิน​ลี​ลี​คุม	Inlilikum
เฟ​บี	Fembi
เคน​เค​เลีย	Kenkelie
เอ​เป​เน​ทัด	Ebenetatv
อัน​โด​นิ​คัด	Anndonikatv
ยู​นี​อัด	Yuniatc
อัม​พะ​ลี​อา​ทัด	Ampaaliaatatv
อู​บา​นัด	Umbaanatv
สะ​ทา​คิด	Saataakitv
เฮ​โล​ดิ​โอน	Helondion
นา​ซิด​สัด	Naasitvsatc
อา​สิน​คี​ทัด	Aasinxkitatv
ฟะ​เล​โกน	Faalegon
ปัด​โล​บัด	Batclombatc
เฮ​ม้าด	Hemaatv
คาน​ทัด	Kaantatv
โส​สะ​เท​เน้ด	Sosaatenetv
คะ​โล​เอ	Kaaloe
ตอนฮนั้ม	dornhnamv
โล์ปี๊ง	lozbingv
โล์ปี๊ง	lozbingv
ฟินโค้ว	finkouv
กิ๊ดๆ	gitvgitv
ฮู้	huv
ตั๋น	Danx
ตั๋น	Danx
เซียงแหง่ง	siangngaengc
เซียงเหฒย	siangzeix
ฮนั้มหฑวน	hnamvnzuonx
ต๋อยตั่ง	doixdangc
ผอ	porx
กั้น	ganh
กงโฒ่	gongzoh
หว่าเหมา	waacmaux
อา​เล​ทัด	Aaletatv
เควย	kuei
เฒ้ยฟุน	zeivfun
เฮมียนหมิ่น	hmienminc
เฒ้ยฟุน	zeivfun
ตี่งฒิ่น	dingczinh
โจ๋ว	joux
ฮลัง	hlang
หฮลัม	hlamx
หฮลัม	hlamx
เฮมียนเป้ย	hmienbeih
โล์แหม่ง	lozmaengc
โล์แหม่ง	lozmaengc
โล์แหม่ง	lozmaengc
เฝียน	fienx
ตั๋งโต้ว	dangxdouh
โค​โล​สี	Kolosi
ชะ	qaqv
หวัก	wakc
เอ้ย	eih
เซียงแหม่ง	siangmaengc
ฮี​เอ​ลา​บุ​ลี	Hielaambuli
นิม​ฟา	Nimfaa
เลา​ดี​เซีย	Laundisie
หฒวด	zuotc
อา​คา​ยา	Aakaayaa
จั๋น	Janx
เหลว่ย	lueic
เฒ้ยๆ	zeivzeiv
หฑั่งแหวะ	nzaangcwaeqc
เซียงเสียน	Siangsienx
ขวิน	kuinx
เอ๊ากว๊าหลุน	auvguaavlunx
โหธ	cox
โล​อิด	Loitc
ยู​นิด	Yunitv
โอ​เน​สิ​โฟ​ลัด	Onesifolatv
โต่วๆ	Doucdouc
ตอง	dorng
คาน​ปัด	Kaanbatc
ยู​บู​ลัด	Yumbulatv
ปู​เดน	Bunden
ลี​นัด	Linatv
คา​ลาว​เดีย	Kaalaaundie
เค​ลี้ด	Kelitv
อาน​เท​ม้าด	Aantemaatv
นิ​โค​บุ​ลี	Nikombuli
อับ​เฟีย	Apcfie
อาน​คิบ​ปัด	Aankipvbatc
ฟี​เล​โมน	Filemon
โล์	Loz
ต๋อง	dorngx
บู๊งต๋าว	mbungvdaaux
พานเพย	paanpei
บยู่งววม	mbiungcwuom
โล์เล์ยหลัด	lozleizlatc
ฑย้าม	nziaamv
เซียงเจ๊า	siangjauv
กวั่ง	guangc
หฮนางต๋น	hnaangxdonx
ฮลางโค้ว	hlaangkouv
ฑั้งเบียด	nzangvmbietc
เฒ์ย	zeiz
บิ​ที​เนีย	Mbitinie
เจียนโฟ้ว	jienfouv
หั่น	hanc
กิ๊น	ginv
เบี์ยว	mbiouz
ถายแปะ	taaixbaeqc
ฟีง	fing
ฮี่	hih
ววมฒี้งฆาย	wuomzingvnqaai
เหญี่ยม	nyiemc
หวั่ง	wangc
เด​เม้ด​ลิ​อัด	Ndemetvliatc
สะ​เม​นา	Saamenaa
เป​กา​มัม	Begaamam
ฟี​ลา​เดน​เฟีย	Filaandenfie
เซียงเย​ลู​ซา​เลม	siangYelusaalem
ลุย	luihouxbaeqc
เจียมนี้ง	jiemningv
ม์าซิ	maazsiqv
แมงหลุน	maenglunx
ลุยด๊าวแปะ	luindaauvbaeqc
อา​บัด​โดน	Aambatcndon
อา​ปอ​ลิ​โยน	Aaborliyon
ธ้าย	caaiv
จูงฮู่ง	Junghungh
จูงฮู่ง	junghungh
ลิ่ม	limh
เซี้ยน	sienv
โหม่ว	mouc
บยุ่ย	mbiuic
ฒ่อง	zorngh
โต์วค้อย	douzkoiv
โล์ลู่ง	lozlungh
โล์เดา	lozndau
เจียมปย๊าเดาะ	jiembiaavndorqc
ฟิน	Fin
เยซู	Yesu
จั๋น	Janx
ไท้	Taiv
ทิน	tin
ฮู่ง	hungh
ธีง	cing
เหฑ่ง	nzengc
เจ๊า	jauv
โหล่ว	louc
เดา	ndau
เดี๊ย	ndiev
เนีย	nie
บูง	mbung
แซง	saeng
คู้	kuv
ด๊าม	ndaamv
ลู่ง	lungh
ตอน	dorn
เจว๊ย	jueiv
ฟุน	fun
ฟะ	faqv
เป้ย	beih
ไล	lai
แมง	maeng
เมี้ย	miev
เฒ้ย	zeiv
บยู่ง	mbiungc
ซุ้ย	suiv
อิ๋ม	imx
หว่า	waac
เอ๋ย	eix
เต่ย	deic
ปูง	bung
กง	gong
โฒ่	zoh
เหฒี่ย	ziec
ต้อง	dorngh
หฮญัง	hnyangx
เจ๊ย	jeiv
เดี๋ยง	ndiangx
หล่ม	lomc
ด๊บ	ndopv
ลิ่ว	liuh
ธั้ม	camv
เต้า	dauh
จา	jaa
ตี้ง	dingh
ววม	wuom
ค้วด	kuotv
ฮวาง	huaang
ฟิน	fin
เมี่ยน	mienh
เล์ย	leiz
ฝีง	fingx
หมิ่ว	miuc
ฝัง	fangx
ลุย	lui
โหว	houx
มั์ว	muoz
ต่อย	doic
โฮล	hlo
แปง	baeng
เปย๊ย	bieiv
โย์ว	youz
ลาย	laai
เหมว่ย	mueic
วิน	win
วั้ง	wangv
ด๊าว	ndaauv
โท้ว	touv
ค้อย	koiv
เฮลน	hlen
ฑั้ง	nzangv
โป่ว	bouc
กั๊บ	gapv
จ๋าย	jaaix
จั๋ง	jangx
โห่	hoc
หลัด	latc
ฮู่งเยีย	Hunghyie
อง	ong
ตา	daa
ซิ	siqv
ห่ง	hongc
เดีย	ndie
หม่วน	muonc
หละเปย๊ย	labieiv
ต๋อง	dorngx
เฝย	feix
หฒั่ง	zaangc
ปั์ว	buoz
เป๊น	benv
ฟู	fu
สู	sux
เจียม	jiem
ฝิน	finx
เยี้ยด	yietv
บ๊วน	mbuonv
ธะ	caqv
เหญ่ย	nyeic
อ๊อ	orv
บย์อง	mbiorngz
เก๊าะ	gorqv
ฮูง	hung
โล่ว	louh
มอ	mor
ซุย	sui
ฮนอย	hnoi
เหญียะ	nyieqc
ไต่	daic
สี่	sic
เหฑียม	nziemx
ย่าง	yaangh
ปย๊า	biaav
บย่า	mbiaac
ถาย	taaix
เญ์ย	nyeiz
โด๊ะ	ndoqv
แป้ง	baengh
ต๋อย	doix
หง่าน	ngaanc
ววน	wuon
แป่ง	baengc
เซียะ	sieqv
ป๋าย	baaix
เอ๊า	auv
กว๊า	guaav
เล่ย	leih
ม์าน	maanz
หฮมวัง	hmuangx
ม์า	maaz
เธีย	cie
ต้าย	daaih
ก๋อ	gorx
ธุน	cun
แกง	gaeng
ติ่ว	diuc
ปอง	borng
บง	mbong
ไอ๊	aiv
จั๊วะ	juoqv
เปี๋ยน	bienx
เฑ้า	Nzauv
เตว๊ย	dueiv
เมว์ย	mueiz
หธง	congx
ฒี้ง	zingv
แบ๋ง	mbaengx
ง่าม	ngaamh
ต้าว	daauh
จ๊า	jaav
เฒ่ย	zeih
ล่าง	laangh
เธียน	cien
เธะ	ceqv
กะน้าย	ganaaiv
เธ้น	cenv
ไฝ	faix
ปุ๊ด	butv
ฒ่อย	zoih
จวัง	juang
หฒิน	zinx
ฮลาง	hlaang
จุน	jun
เฌียน	njien
โย่ว	youh
ฑย้าม	nziaamv
เฟย	fei
ธง	cong
เม่ง	mengh
นี้ง	ningv
เปี๊ยว	biouv
ฆาย	nqaai
บัวะ	mbuoqc
โซว	sou
ปิ๊ว	biuv
ตาน	daan
แซ้ง	saengv
เฒี้ยว	ziouv
เหฒา	zaux
หฮนาง	hnaangx
เตี้ย	dieh
ฒอง	zorng
ฒุ	zuqv
ติ๊ว	diuv
ฒ้าน	zaanv
กวั้น	guanh
โธว	cou
เหฒียบ	ziepc
จั๊ว	juov
เตี๋ย	diex
ป๊วน	buonv
ฟิ้ว	fiuv
ล์าง	laangz
เธี้ยง	ciangv
ท้อง	torngv
ป้าย	baaih
ต้าน	daanh
บั๊ว	mbuov
เมา	mau
เซียง	siang
หฮลา	hlaax
ฌัง	njang
หล่าง	laangc
เหธย	ceix
เป๊ย	beiv
โฑว	nzou
ฒิ่น	zinh
ต่ง	dongc
มู้ง	mungv
ออน	orn
เหลาะ	lorqc
ฝุเจว๊ย	fujueiv
เฮล้า	hlauv
ด้ง	ndongh
กอน	gorn
แป๋ง	baengx
เด่ย	ndeic
เหฆน	nqenx
หฑยาว	nziaaux
หฒุ่น	zunc
ฑ่าย	nzaaih
จ๋า	jaax
ธัง	cang
โฟว	fou
ซับ	sapv
หฒวัง	zuangx
ก๊อง	gorngv
เหม	hemx
แปะ	baeqc
เธียว	ciou
บวั์ง	mbuangz
เผง	pengx
นาง	naang
เจี๊ยะ	jieqv
ด่าง	ndaangc
ค้อ	korv
เลี่ยน	lienh
จ๊บ	jopv
ตัง	dang
โธ้	cov
กู้งว์า	gunguaaz
ฟิม	fim
ฆว่า	nquaah
ก์า	gaaz
หฌุ่น	njunc
ฟอง	forng
ฒุน	zun
เปี้ยง	biangh
หลุน	lunx
ฮลบ	hlopv
เหฒง	zengx
ฒุ์ย	zuiz
หนิบ	nipc
หฒะ	zaqc
ไซ	Sai
ดอม	ndorm
เฑี้ยว	nziouv
บ๋วน	mbuonx
โพว	pou
ทง	tong
หฮวีง	huingx
เปย๊า	biauv
ง่อ	ngorh
โฒ้ว	zouv
เก้ม	gemh
ยิ่น	yinh
เยียม	yiem
ทอย	toi
เฮมย	hmei
ปิน	bin
หลัวะ	luoqc
ซูง	sung
จิว	jiu
ปาง	baang
โยว	you
เฑ่า	nzauh
กีก	Gikc
หฒ่าน	zaanc
ขูง	kungx
โฒ่เยีย	zohYie
เฮญี้ยว	hnyouv
เอน	en
ฒี่ง	zingh
โก๊ว	gouv
ไหล่	laic
ฮู้	huv
จ๋าน	jaanx
เจียน	jien
โฟ้ว	fouv
กีง	Ging
โล์	loz
แฑง	nzaeng
นอม	norm
เดาะ	ndorqc
ฑูง	nzung
ฟาง	faang
หฆาย	nqaaix
เฮย	hei
ห่อง	horngc
ปู๋ง	bungx
ซีง	sing
เฉีย	qiex
ซ้าย	saaiv
ดุย	ndui
แฒะ	zaeqv
ม่อง	morngh
หฮวา	huaax
ญิ์น	nyinz
ฮ์าน	haanz
เธง	ceng
โต์ว	douz
เหฑ่า	nzauc
ดาม	ndaam
ตอง	dorng
เซียว	siou
เซ้ด	setv
แธะ	caeqv
จ้าง	jaangh
ฒ้าง	zaangv
เตก	dekc
โตะ	doqc
ยู์ง	yungz
เฮมียน	hmien
ซิน	sin
ตอ	dor
ตั๋ง	dangx
ต๋น	donx
หฌาว	njaaux
ปี๋ง	bingx
เธี้ยว	ciouv
ต้ม	domh
ง์าย	ngaaiz
ด๋น	ndonx
จ้อย	joih
หฒัวะ	zuoqc
กั๊วะ	guoqv
ฮม์	hmz
เธี้ยด	cietv
จาย	jaai
ไธ	cai
เบย์า	mbiauz
น่อม	normh
เหลียง	liangx
แงะ	ngaeqv
ฟาม	faam
แป๊ะ	baeqv
โปว	bou
โต์	doz
ฮนั้ม	hnamv
หฑวน	nzuonx
หมิ่น	minc
เสียว	sioux
ตน	don
หม่า	maac
ซา	saa
เฒียว	ziou
เฮนี้ย	hniev
ธิน	Cin
หม่าน	maanc
ฟิ	fiqv
งว์า	nguaaz
จอม	jorm
ฒูง	zung
ดาง	ndaang
เสย	seix
โม่ว	mouh
โค้ว	kouv
ฟ้ม	fomv
เกม	gem
ไกว	guai
แก๊ง	gaengv
อิม	im
ฌั้ว	njuov
เญี์ยม	nyiemz
เดี้ยว	ndiouh
ฌิ้ม	njimv
เบยาะ	mbiorqc
เฌ้ย	njeiv
ควีง	kuing
หฌ่ง	njongc
ลาน	laan
ลี่ง	lingh
เจี๋ย	jiex
เบย้า	mbiauh
พ้าย	paaiv
โผว	poux
ฒุ่ย	zuih
จ๊าง	jaangv
ง่ง	ngongh
เหนาะ	norqc
ยั่ง	yangh
ถิว	tiux
โกว	gou
หมั่ว	muoc
เฑี์ย	nziez
ปวัง	buang
โสว	soux
เบี่ย	mbiec
กวา	guaa
ต๋ม	domx
แคะ	Kaeqv
เม้ย	meiv
เบียด	mbietc
ท้าด	taatv
จ้วน	juonh
เบ๋ว	mbeux
ซยาม	siaam
เฑียง	nziang
ต้อ	dorh
มา	Maa
เตี๊ย	diev
เฮม้ย	hmeiv
ดาน	ndaan
กอง	gorng
ตุ๊	duqv
ตาว	Daau
เฮ่	heh
ม่าน	maanh
ฮ์อง	Horngz
เฮลียะ	hlieqv
หญอ	nyorx
ฌ้วด	njuotv
เหฌียด	njietc
เยี่ยน	yienh
โญ์ว	nyouz
ป๊า	baav
เหมา	maux
อ๊อม	ormv
เบี่ยน	mbienc
เธ้ว	ceuv
ฟ่าน	faanh
ตู์ง	dungz
ลู์ง	lungz
ปั่ว	buoc
น์าว	naauz
เฒว่ย	zueih
ฉัง	qangx
ธิด	citv
ไจ๋	jaix
เฒว้ย	zueiv
ฑ์ม	nzomz
ดิน	ndin
จู๊	juv
มัว	muo
เฟียม	fiem
กู้	guh
เจี๊ยบ	jiepv
สวัง	suangx
ติ่ม	dimc
โด	ndo
ปั่ม	bamc
เหฑว่ย	nzueic
ขอ	korx
ล่าน	laanh
เซี้ยบ	siepv
โน่ว	nouh
ฒ์าง	zaangz
ญ่า	nyaah
บีง	mbing
ต่อง	dorngc
นั้ง	nangv
หฑ่อม	nzormc
โป๊ว	bouv
เกน	gen
แกว๊ง	guaengv
บ๋าย	mbaaix
ยาง	yaang
ฌับ	njapv
ป่วน	buonc
ธิ	ciqv
หธุน	cunx
ตีง	ding
ถาน	taanx
แก้ง	Gaengh
หญู่ง	nyungc
ปุ้น	bunh
ย	zeiv
พ่าง	paangh
โฮ์	hoz
โดะ	ndoqc
เปยย	biei
หฒวน	zuonx
เดี๊ย’	ndiev’
ฑุ่ย	nzuih
หญ่อ	nyorc
แหง่ง	ngaengc
ผุย	puix
จุ่น	junc
ปู๊	buv
โฆ	nqo
เน้า	nauv
ฟุ	fuqv
โหละ	loqc
บู๊ง	mbungv
ชะ	qaqv
เหละ	leqc
ฑู่ง	nzungh
จาง	jaang
ฟาน	faan
เหฒวย	zueix
เดี๊ยบ	ndiepv
ทาน	taan
อ๋ง	ongx
ดุ้น	ndunh
เลี่ยม	liemh
ฟีง	fing
ฑิว	nziu
ลัด	latv
ขัม	kamx
ปุย	bui
โฮ่	hoh
เซย	sei
ต์ง	dongz
ด๊าด	ndaatv
ฟั้ง	fangv
เซ่ง	sengh
หลิ่ม	limc
กาม	gaam
ธุ	cuqv
ปวั้ง	buangh
ม์วน	muonz
หฒั่น	zanc
ไฆ้	nqaiv
ชม	qom
ชาว	qaau
หธา	caax
จุ้น	junh
จ๊าบ	jaapv
ตั๊ง	dangv
เหฑียง	nziangx
หลง	longx
หนัม	namx
ญ่วน	nyuonh
ออ	or
ปยม	biom
ไจ	Jai
ก๋อง	gorngx
เซี้ยว	siouv
ฌ่าง	njaangh
เซี้ยด	sietv
ญัง	nyang
ติ้ว	diuh
แฮ่ง	haengh
ซวัง	suang
ซอน	sorn
จัง	jang
ฮลัง	hlang
หฌ่ม	njomc
เปน	ben
เบี๊ยะ	mbieqv
ฟ้อ	forv
ก่อง	gorngc
ธ้าย	caaiv
หนาม	naamx
เหฮลย	hleix
จูง	jung
โคว	kou
บั๋ว	mbuox
ไซ​ปัดค้อย	SaibatcKoiv
โหฒว	zoux
ปูง’	bung’
เฝียว	fioux
เญี่ยน	nyienh
หฑุ่น	nzunc
ฒา	zaa
ต๊าม	daamv
เหมี่ย	miec
เยี้ยน	yienv
ฮวุย	hui
กั๋น	ganx
ด้อง	ndorngh
บวั้ง	mbuangh
เก้	geh
ฑัง	nzang
ฒ้าม	zaamv
หฑั่ง	nzaangc
ช้าว	qaauv
หธาม	caamx
เผย	peix
ตง	dong
กุ๊น	gunv
ไบ	mbai
เอย	ei
โต้ว	douh
ซิม	sim
บยุ่ย	mbiuic
เตี๋ย’	Diex’
โหธว	coux
เญี้ยด	nyietv
เทาะ	torqv
เสียน	sienx
แธง	caeng
เบี๋ยง	mbiangx
โหฆ	nqox
จ่ม	jomc
แหล่ง	laengc
บาง	mbaang
โฟ่ว	fouh
ด๊อด	ndortv
เบี๊ยน	mbienv
หลี่ง	lingc
ฮยาง	hiaang
ตั้ม	damh
แหม่ง	maengc
ดั๊บ	ndapv
อ๋อน	ornx
ฟ้าด	faatv
เทย	tei
เฒี่ยง	ziangh
ปี๊ง	bingv
เหฒย	zeix
ตั่ง	dangc
ตี่ง	dingc
แหวะ	waeqc
ต๋าว	daaux
พาน	paan
เพย	pei
เย​ลู​ซา​เลม	Yelusaalem
เย	Ye
ซู	su
โย	Yo
ฮัน	han
อี	I
ยิบ	yipv
ฮิบ	Hipv
ลู	Lu
เอ	E
เดน	nden
โค	ko
ลิน	lin
โท	to
โน	no
ยา	yaa
อับ	Apc
ลาม	laam
กา	Gaa
ลา	laa
เทีย	tie
คา	kaa
นา	naa
อัน	an
โม	mo
เล	le
อัม	am
เฟน	fen
สา	saax
อา	Aa
ลี	li
โอก	okc
เค	Ke
โอ	o
เม	me
ทิ	ti
ฮัม	ham
ทู	tu
สิม	Simx
โย้ก	Yokv
ซาน	saan
มี	Mi
เดียน	ndien
อิด	Itc
บาก	mbaakc
เช	Qe
บา	mbaa
เด	Nde
อัด	Atc
ลิม	lim
อุม	um
มิม	mim
ฟา	faa
บี	mbi
ดา	ndaa
สัก	sakc
เก	Ge
หะ	haa
เส	Se
โดม	ndom
ไท	tai
ดี	ndi
เบด	Mbetc
เซ้บ	Sepv
ยู	Yu
ดุน	ndun
ลัม	lam
ชู	Qu
ไน	nai
อิ	I
สะ	saa
เบน	mben
สิ	Si
โอน	on
วี	wi
บู	mbu
ลุน	lun
ดอน	ndorn
ฝีงอิ	fingxI
เซ	se
โลน	lon
ฟี	fi
ดิม	ndim
ฮู	hu
เบ	Mbe
เลน	len
ฮิด	Hitv
เป	Be
ลิด	litv
ซี	si
บุด	mbutc
ดับ	ndapc
เคน	ken
สี	si
เดด	ndetc
จอ	Jor
แดน	ndaen
สิบ	Sipc
โป	bo
ซิด	Sitv
ทิม	tim
มัด	Matv
ทาย	taai
กิ	Gi
อาด	aatc
เสด	setc
สุก	Sukc
โค้ด	kotv
บีบ	mbipc
วา	waa
นอน	norn
บิน	Mbin
โดน	ndon
บับ	mbapc
อัก	Akc
ซ้าบ	saapv
ลิ	li
เตีย	die
ทา	taa
โล้ด	lotv
มะ	Maa
นัด	natv
คี	ki
มิ	mi
โล	lo
เฟ	fe
หัด	hatc
ฮา	haa
โฮ้ก	Hokv
ที	ti
ละ	laa
กิน	Gin
กาน	gaan
ฮู้ด	hutv
โบ	mbo
เล้ก	lekv
แซม	Saem
สัน	sanx
เอด	Etc
เฮม	hem
คิ	Ki
หุ	hu
มู	mu
มิด	mitv
ปาต้อ	baaDorh
มิน	min
โมน	mon
หาด	haatc
หิ	hi
ยิด	Yitv
เฮ	he
อาบ	aapc
บาน	mbaan
ยิน	yin
โลม	lom
นี	ni
ฮัก	Hakv
กีด	gitc
ทัน	tan
เอก	Ekc
เน	Ne
ลุ	lu
เท	Te
บีก	Mbikc
เจียด	Jetc
มอน	Morn
เลม	lem
โดก	ndokc
โฮ	ho
เล้บ	lepv
ลู้ด	lutv
ฟัด	fatv
ชา	qaa
นิม	nim
โห	hox
บัด	mbatc
เลีย	lie
โบด	mbotc
หับ	hapc
มาน	maan
คิม	kim
เฮ้บ	Hepv
คัด	katv
เน้ด	netv
นับ	Napv
เฮ้ด	Hetv
โซ	So
ไม	mai
ฮ้าด	haatv
อุด	Utc
บุก	Mbukc
โย้ด	yotv
ทู้บ	tupv
นัน	nan
ดัก	ndakc
พู	Pu
ไฟ	fai
อิบ	Ipc
สัม	samx
โบน	mbon
โม้ด	motv
โท้ด	totv
เม้ด	metv
ฮาน	haan
อูด	utc
อะ	aa
ซุบ	Supv
ปิม	bim
หุบ	Hupc
อา	aa
เบีย	mbie
สิก	Sikc
ล้าก	laakv
ซัม	Sam
มุ	mu
เล้ด	letv
อุ	U
โส	So
ดัด	ndatc
ติด	ditc
กัด	gatc
ดู	ndu
ทูน	tun
นิ	ni
ปิ	bi
ทัด	Tatv
เซน	Sen
ลิบ	lipv
ลุบ	lupv
ไค	kai
ปา	baa
บิก	Mbikc
ไว	wai
ฮูม	hum
ไก	gai
อาน	Aan
ซี้ด	sitv
ฮิน	Hin
ฮัด	Hatv
สุ	su
วัด	Watv
หย่อ	yorc
เปีย	bie
ฟัน	fan
ปาด	Baatc
มิก	Mikv
ปาน	baan
เหด	hetc
ซัด	satv
เซีย	sie
ทุ	tu
นะ	naa
เว	we
กุก	gukc
คิด	Kitv
สับ	Sapc
ยูม	yum
บุ	mbu
ปอ	bor
ควิน	kuin
ปิด	Bitc
สิน	sinx
ลาว	laau
ดิ	ndi
ยุม	yum
ปัม	Bam
พอย	poi
เลา	Lau
คับ	Kapv
บิ	Mbi
