yesu	เยซู
yesu	เยซู
Ravg	หฑั่ง
tovb	ต้ง
Zx	ธอ
Tinb huvb	ทินฮู่ง
zeij	เหฒย
luvb	ลู่ง
Dau	เดา
Zauj	เหธา
maang	หม่าน
mwrtg	หมวด
Navq	ฮนั้ง
naaiq	น้าย
nx	นอ
zyavj	เหฒียง
Revg	เหฑ่ง
aq	อ๊ะ
Tauj	เถา
taZyetq	ตะเธี้ยด
Nxi	ฮนอย
zruj	โหฒว
ninb	นิ่น
Eei	เญย
kov	กง
zyrug	ฯฒฯ
tivb	ตี้ง
hitq	ฮิด
Kwrnj	ขวน
Zwrtq	ธ้วด
Zeij	เหธย
fuq	ฟุ
pun	ปุน
uaq	วั้ว
nxm	นอม
penj	เป๋น
Revg	ธีงเหฑ่ง
weig	เหว่ย
zug	หฒุ
yaag	หย่า
Wivj	หฮวีง
lrug	เจ๊าโหล่ว
se	เซ
zyruq	เฒี้ยว
zang	หฒั่น
maiq	ไม้
kcvb	แก้ง
maaib	ม่าย
haiq	หาย
Euvg	หญู่ง
miaq	เมี้ย
Dyavj	เดี๋ยง
Kuvj	ขูง
uam	ววม
yem	เยียม
saamj	สาม
taaib	ต้าย
Dxn	ดอน
kxmj	ก๋อม
cvj	แอ๋ง
zxq	เฒาะ
teij	เต๋ย
Buv	เนียบูง
nanq	นั้น
taub	เต้า
myenb	เมี่ยน
pyomq	ปย๊ม
mcvg	แหม่ง
Qiaj	เฉีย
piag	เปียะ
Bazxv	บะฒอง
tov	ตง
puv	ปูง
kaEuad	กะญั์ว
Diaq	เดี๊ย
maanb	ม่าน
Jiad	เจี์ย
kxn	กอน
Yaavj	หฮยาง
Jyenq	เจี๊ยน
faauj	ฝาว
yuvd	ยู์ง
tuq	ตุ๊
siaq	เซียะ
kxvq	ก๊อง
Buaj	บั๋ว
meib	เม่ย
meib	เม่ย
yetg	เหยียด
pyauq	เปย๊า
Mwavq	ฮมวั้ง
txig	ต่อย
xij	อ๋อย
Ravq	ฑั้ง
Jaaj	จ๋า
yia	เยีย
pwatg	ปวัด
kanb	กั้น
hxpg	หอบ
Hruq	เฮญี้ยว
tafaanb	ตะฟ่าน
wij	หวุย
Kuq	แซงคู้
txb	ต้อ
siag	เสี่ย
txij	ต๋อย
kruq	โก๊ว
Eeid	เญ์ย
nxg	เหนาะ
siaj	เสีย
trug	โต่ว
pwrnq	ป๊วน
zuvq	ฒู้ง
laKuq	หละคุ
Yiab	เฮยี่ย
zxib	ฒ่อย
pwav	ปวัง
waag	หว่า
txn	ตอน
Bua	บัว
Jweiq	ตอนเจว๊ย
faq	ฟุนฟะ
pwavq	ปวั๊ง
Tinb	ทิน
teig	เต่ย
trub	โต้ว
Daub	เดาเป้ย
Exv	ญอง
kanaaiq	กะน้าย
Kxiq	ค้อย
Byaud	เบย์า
kamb	กั้ม
Riaj	เหฑีย
Jiu	จิว
kunq	กุ๊น
haib	ไฮ่
tovd	ต์ง
Eang	หญั่น
hopq	ฮบ
ib	อี้
Euvg	หญู่งๆ
zinb	ฒิ่น
Daavg	ด่าง
mivb	มี่ง
sem	เซม
haam	ฮาม
zeib	เฒ้ยฟุน
yemj	เหยียม
liud	ลิ์ว
Gahaaq	ฆะฮ้า
pua	ปัว
Dug	ดุ
fib	ฟี่
fivj	ฝีง
Lo	โฮล
mevb	เม่ง
hog	โห่
zyruj	เหฒียว
fivj	ฝีงๆ
myenb	เมี่ยน
ziuj	หฒิว
Jauq	เจ๊า
lotq	โล้ด
Zyetq	เธี้ยด
zyepg	เหฒียบ
Mmd	ฮม์
Havj	หฮญัง
auq	เอ๊า
fun	ฟุน
lyemb	เลี่ยม
zxng	หฒ่อน
taub	เต้าๆ
puv	เต่ยปูง
mig	หมี่
kan	กัน
Jiaj	เจี๋ย
zivb	ฒี่ง
tiub	ติ้ว
tomb	ต้ม
Baov	บะอง
zwei	เฒวย
hing	หิ่น
naaiq	น้าย
ziab	เหฒี่ยต้อง
ziag	เหฒี่ย
huvb	ฮู่ง
Havb	หฮญังเจ๊ย
Juaq	จั๊ว
yia	เยีย
nrnb	เน่น
mwavj	หมวัง
zang	หฒั่นๆ
lamb	ลั่ม
Gemb	เฆ่ม
txvj	ต๋อง
zweid	เฒว์ย
liub	ด๊บลิ่ว
kaub	เก้า
yuaq	ยัวะ
zyavb	เฒี่ยง
seij	เสย
zavg	หฒั่ง
pcq	แป๊ะ
Eig	หญี่
Lav	ฮลัง
koj	โก๋
haig	ไห่
lovg	หล่ง
heug	เห่ว
Fiag	เหฌี่ย
tivb	จาตี้ง
Ripg	หฑิบ
zeiq	เฒ้ย
pwavb	ปวั้ง
Rung	หฑุ่น
Waav	ฮวาง
vxg	หง่อ
lomb	หล่มฮวาง
kwanb	กวั้น
paki	ปะกี
yuvb	ยู่ง
pweij	เปว๋ย
kaLen	กะเฮลน
myenb	ฟินเมี่ยน
pcv	แปง
fai	ไฟ
Zyavq	เธี้ยง
Paaiq	พ้าย
fyenj	เฝียน
lxd	ล์อ
kxj	ก๋อ
Faauj	หฌาว
kau	เกา
feij	เฝย
Gxi	ฆอย
fuJweiq	ฝุเจว๊ย
i	อี
nrub	โน่ว
peid	เป์ย
Puaq	พัวะ
Zivj	หธีง
fatq	ฟัด
mq paag	มป่า
Tiuj	ถิว
zipq	ฒิบ
Qam	ชัม
zom	ฒม
msiaq	มเซียะ
Ryaaug	หฑย่าว
haid	ไฮ์
Namq	ฮนั้ม
lovj	หลง
Duaq	ดั๊ว
swiq	ซุ้ย
miub	หมิ่วฝัง
kwavg	กวั่ง
saaj	สา
yeng	เหยี่ยน
hruj	ลุยโหว
Zxg	หธ่อ
tia	เตีย
lunj	หลุน
leib	เล่ย
pyauj	เปย๋า
sin	ซิน
taEeig	ตะเหญ่ย
Tevj	เถง
mavg	หมั่ง
waaig	หว่าย
taig	ไต่
Zaamj	หธาม
prub	โป้ว
avung	อะหงุ่น
tiuq	ติ๊ว
Jyen	เจียน
Fuaq	ฌั้ว
txvg	ต่อง
tiaj	เตี๋ย
kruj	โก๋ว
ting	ติ่น
pcvb	แปงเปย๊ย
wrnj	หววน
lob	โล่
laub	เล่า
Beij	เบ๋ย
sruq	โซ้ว
Daaib	ด้าย
Len	เฮลน
yavb	ยั่ง
vovb	ง่ง
Rweig	เหฑว่ย
Jung	จุ่น
luag	หลัวะ
tig	ติ
nxmb	น่อม
Byaub	เบย้า
maaid	ม์าย
Naavj	หฮนาง
taig	ไต่
Kruq	โค้ว
zaanq	ฒ้าน
Eaanb	ญ่าน
tapq	ตั๊บ
Buag	บัวะ
Rwib	ฑุ่ย
pru	โปว
ei	เอย
Dxm	ดอม
Ryruq	เฑี้ยว
Fav	ฌัง
fuvj	ฝูง
lxb	ล่อ
Rwrnj	หฑวน
zig	หฒิ
navg	หนั่ง
ko	โก
kaanq	ก๊าน
zung	หฒุ่น
zaaig	หฒ่าย
naaig	หน่าย
kaaj	ก๋า
tiug	ติ่ว
Bua	บัว
Eyend	เญี์ยน
peq	เป๊ะ
hiuq	ฮิ้ว
Rxib	ฑ่อย
kapq	กั๊บ
zunq	ฒุ้น
hivq	ฮี้ง
sig	สี่
aag	อ่า
Qaq	ชะ
taaub	ต้าว
muad	มั์ว
Rug	หฑุ
Daauq	ด๊าว
tog	โตะ
uag	หวัวะ
king	กิ่น
taaq	ต๊า
zaeij	หฒะเอ๋ย
Zaavb	ธ่าง
laavb	ล่าง
taij	ไต๋
sweib	เซว่ย
eij	เอ๋ย
Vaq	ฮงะ
lwavg	หลวั่ง
Jaan	จาน
tavj	ตั๋ง
laaij	หลาย
Zyruq	เธี้ยว
Zev	เธง
puad	ปั์ว
wavq	วินวั้ง
Jaav	จาง
kweig	เกว่ย
paaij	ป๋าย
syenb	เซี่ยน
saauq	ซ้าว
laaug	หล่าว
yaavb	ย่าง
vaatg	หงาด
xq	อ๊อ
Baapq	บ๊าบ
kaamq	ก๊าม
hcq	แฮะ
Eia	เญีย
Dob	โด้
Mei	เฮมย
Gwaab	ฆว่า
Roj	โหฑ
siq	ซิ
Ryaamq	ฑย้าม
yemg	เหยี่ยม
peiq	เป๊ย
pyruq	เปี๊ยว
Zamq	ธั้ม
Len	ค้อยเฮลน
kapg	กั๊บจ๋าย
taauj	ต๋าว
henq	เฮ้น
laanb	ล่าน
BuDovj	บุด๋ง
Daan	ดาน
pcvb	แป้ง
fim	ฟิม
syemq	เซี้ยม
pcg	แปะ
naav	นาง
pivj	ปี๋ง
Laaj	หฮลา
Eiag	เหญียะ
Bweid	เบว์ย
ziaq	เฒียะ
zuv	ฒูง
Lxpq	ฮล้อบ
vwaad	กู้งว์า
an	อัน
lomg	หล่ม
txg	ต่อ
mavg	หมั่ง
txv	ตอง
RaMyen	หฑะเฮมียน
vcvg	แหง่ง
hxvb	ฮ่อง
hog	จั๋งโห่
lob	หฑั่ม
latg	เล์ยหลัด
Ruv	ฑูง
Fruj	เหฌียว
Taaib	ท่าย
Bxq	เบ๊าะ
o	โอ
Byaaug	บย่าว
Jiaq	เจี๊ยะ
paaig	ป่าย
Fopg	หฌบ
trud	โต์ว
puaq	ปั๊ว
Qwi	ชุย
Gaauq	ฆ้าว
zwavj	หฒวัง
sinj	สิน
Bov	บง
Kav	คัง
lyepg	เหลียบ
sai	ไซ
sij	สี
kinq	กิ๊น
Zwrtq	ธ้วด
tuvq	ตู๋ง
zyenb	เฒี่ยน
leid	เล์ย
zag	หฒะ
nimg	หนิ่ม
xij	อ๋อย
fovg	ฝ่ง
hxg	ห่อ
Jyem	เจียม
swij	สุย
setq	เซ้ด
Buaq	บั๊ว
lamaab	ล่าม่า
pyei	เปยย
tav	ตัง
kalanq	กะลั้น
yrub	โย่ว
Daav	ดาง
laapg	หลาบ
liug	หลิ่ว
zxpg	หฒอบ
xn	ออน
huv	ฮูง
Jaaij	จ๋าย
lcvd	แล์ง
faav	ฟาง
kaEiag	กะเหญี่ย
pin	ปิน
hxmb	ฮ่อม
tasuq	ตะซุ
pyaa	ปยา
Dxg	เดาะ
Javq	จั๊ง
kxq	เก๊าะ
Pycv	แพยง
nctq	แน้ด
pyenb	เปี้ยน
kaDiaq	กะเดี๊ย
mcvj	แหมง
kcv	แกง
laatg	หลาด
naamb	น่าม
Bcg	แบะ
tovg	ต่ง
fai	ไฟ
Dia	เดีย
Topq	ทบ
Taapq	ท้าบ
weib	เว่ย
pyaaq	ปย๊า
Zxv	ธอง
wrnq	ว้วน
tivj	ตี๋ง
vau	เงา
Buaj	บั๋ว
zaaj	หฒา
tinb	ติ้น
ziag	เหฒียะ
tiab	เตี้ย
Jxv	จอง
kaatq	ก๊าด
Ziq	ธิ
lxg	เหลาะ
tiu	ติว
pyavb	เปี้ยง
zug	หฒุ
Kwaaiq	คว้าย
penq	หละเปย๊ยเป๊น
fiaq	เฟี้ย
huq	ฮู้
hatg	หัด
pyenj	เปี๋ยน
Datq	ดั๊ด
zuq	ฒุ
sivj	สีง
fub	ฟูสู
Japq	จั๊บ
mwrng	หม่วน
Jaaiq	จ๊าย
yenj	เหยียน
zib	ฒี่
scvb	แซงเยี้ยด
wig	หวุ่ย
maan	มาน
mGxvq	มฆ้อง
fiq	ฟิ
zwid	ฒุ์ย
Bwrnb	บ๊วนหม่วน
Zag	ธะโป่ว
Eeig	เล์ยเหญ่ย
Wiv	ฮวีง
Eutg	หญุด
peu	เปว
nitq	นิด
pivq	ปี๊ง
tapetq	ตะเป๊ด
kxg	เก๊าะเมี่ยน
huvb	ฮูงโล่ว
Yetq	เฮยี้ยด
teib	เต้ย
Baaij	บ๋าย
Levj	เหฮลง
faan	ฟาน
mJavg	มจั่ง
zcq	แฒะ
Raauj	หฑาว
Mwavj	หฮมวัง
muaq	มัวะ
keb	เก้
Byenq	เบี๊ยน
Myen	เฮมียน
Pai	ไพ
Zyen	เธียน
maag	หม่า
naaiq	น้าย
tivg	ตี่ง
zunb	ฒุ่น
Eeig	เหญ่ย
ziaj	เหฒีย
maiq	ไม้
levg	เหล่ง
Jeiq	เจ๊ย
keg	เก่
yem	เยียม
Teij	เถย
zuaq	ฒั้ว
Eiag	ฮนอยเหญียะ
lyrub	เลี่ยว
Bapyei	บะเปยย
syaam	ซยาม
Kub	คู่
sei	เซย
maa	มา
yrud	โย์ว
muag	หมั่ว
zeib	เฒ่ย
kuaq	กั๊วะ
sig	จาสี่
Juq	จุ๊
Zia	เธีย
komq	ก๊ม
liub	ลิ่ว
pyeiq	เปย๊ย
Ryemb	เหฑียมย่าง
Ratg	หฑัด
Bwi	บุย
Kutq	คู้ด
suv	ซูง
Byaag	ปย๊าบย่า
Taaij	องถาย
Jwavg	จวั่ง
livg	หลี่ง
Zoq	โธะ
huvj	หูง
Dopq	ด๊บ
Jaavb	จ้าง
zovb	ฒ่ง
kwei	เกวย
zavj	หฒัง
kwaij	ไกว๋
aNeiq	อะเฮน้ย
faatq	ฟ้าด
Win	ฮวิน
livb	ลี่ง
mziv	มฒีง
Tov	ทง
Yenj	เหฮยียน
yuag	หยัวะ
pcvg	ววนแป่ง
pwrng	ป่วน
tayetq	ตะเยี้ยด
hrud	โฮ์ว
hruq	โฮ้ว
Dxtq	ด๊อด
Goj	โหฆ
zakevb	หฒะเก้ง
lakwaib	หละไกว้
paag	ป่า
Jaa	จา
Jaauq	จ๊าว
win	วิน
kaatg	กาด
Diaq	ปั์วเดี๊ย
okg	โอก
faij	ไฝ
Javj	จั๋ง
lapyeiq	หละเปย๊ย
Erud	โญ์ว
Raub	เฑ่า
Eyemq	เญี้ยม
Juv	จูง
Faib	ไฌ่
mrud	โม์ว
maanb	ม์านหฮมวัง
muvq	มู้ง
favj	ฝัง
yruj	โหยว
Riaq	เฑี้ย
hang	หั่น
laavd	ล์าง
kxij	ก๋อย
fevj	เฝง
pruq	โป๊ว
Dutq	ดุ๊ด
zei	เฒย
cq	แอ๊ะ
palag	ปะหละ
Zapq	ธับ
maad	ม์า
Zia	ม์าเธีย
og	โอ่
hxvd	ฮ์อง
laib	ไล่
Doq	โด๊ะ
nauq	เน้า
yrud	ก๋อโย์ว
naab	น่า
kwen	เกวน
lwi	ลุย
Dxpg	ดอบ
laud	เล์า
puag	ปั่ว
Jauj	เจ๋า
txvb	ต้อง
zig	หฒี่
sruj	โสว
mrug	โหม่ว
syru	เซียว
Txvj	ถอง
Zunb	ธุนแกง
ton	ตน
Wi	ฮวุย
zuaq	ฒัวะ
Raanj	หฑาน
mnxmb	มน่อม
paamb	ป้าม
ken	เกน
Toq	โท้
Einb	ญิ่น
pxvb	ปองปั์ว
nun	นุน
Gaai	ฆาย
BaRiu	บะฑิว
yug	หยุ
kwrn	กวน
maiq	ไม้
ai	ไอ
Zaavq	ธ้าง
zuaq	ฒั้ว
waang	หว่าน
mwrnd	ม์วน
aiq	บงไอ๊
hivb	ฮี่ง
Rcv	แฑง
Duab	ดั้ว
puvb	ปู้ง
zivq	ววมฒี้ง
Zcvj	แหธง
zevg	เหฒ่ง
Daaub	ด้าว
Kauj	เขา
nipg	หนิบ
fivj	ด๊ามฝีง
nxmb	นอมๆ
Kauq	เค้า
hod	โฮ์
paauj	ป๋าว
Bxq	เบ๊าะ
tau	เตา
fuvg	ฝู่ง
sig	สี่
Raud	เฑ์า
kcq	แก๊ะ
zeid	เฒ์ย
maaig	หม่าย
zaab	ฒ่า
mivb	มี่ง
putq	ปุ๊ด
scvq	แซ้ง
Kwinj	ขวิน
tafeij	ตะเฝย
Eang	หญั่น
tavb	ตั้ง
Zeq	เธียนเธะ
Bwavd	บวั์ง
kanaaib	กะน้ายเธ้น
Ryaauj	หฑยาว
aanj	อ๋าน
pavg	ปั่ง
sru	โซว
faq	ฟะ
supg	สูบ
zyen	เฒียน
Baib	ไบ้
swei	เซวย
Zin	ธิน
kub	กู้
vwaaig	หงว่าย
Kitq	คี้ด
Dovg	ด่ง
Bcvg	แบ่ง
Bataub	บะเต้า
toj	โต๋
kikg	กีก
pxq	เป๊าะ
kunq	กุ๊น
Ziv	ธีง
Toq	โท้
Jaiq	ไจ๊
zinj	จวังหฒิน
pcv	จุนแปง
mweig	เหมว่ย
Zavj	หธัง
heij	เหย
Fyenb	เฌียนโย่ว
Rod	โฑ์
Patq	พัด
taanb	ต้าน
paab	ป้า
ping	ปิ่น
ninb	นิ่น
Euvg	หญู่ง
puvj	ปู๋ง
xq	เอ๊าะ
myenq	เมี้ยน
mxb	ม่อ
Rav	ฑัง
Zav	ธัง
piu	ปิว
Ropq	ฑบ
Fovg	หฌ่ง
tiv	ตีง
Jyenq	เจี๊ยน
simq	ซิ้ม
nopq	โน้บ
zinj	หฒิน
katg	กัด
zov	ฒง
Qyemj	เฉียม
Do	โด
zruq	โฒ้ว
Gaav	ฆาง
hei	เฮย
tafaam	ตะฟาม
taMmd	ตะฮม์
taluag	ตะหลัวะ
mtaaib	มต้าย
Jwavg	จวั่ง
Buvq	บู๊ง
hxig	ห่อย
maaib	ม่าย
winb	วิ่น
en	เอน
ninb	นิ่น
maaib	ม่าย
Jomg	จ่ม
mevb	ธงเม่ง
Raatq	ฑ้าด
Ken	เคน
pwig	ปุ่ย
Tx	ทอ
Dunb	ดุ้น
kxv	กอง
timq	ติ๊ม
Zuaq	ธัวะ
mweid	เมว์ย
homg	ห่ม
swavj	สวัง
syruq	เซี้ยว
aapq	อ๊าบ
myenb	กงเมี่ยน
Jwav	จวัง
zuag	หฒัวะ
wib	วุ่ย
faam	ฟาม
kemb	เก้ม
faab	ฟ่า
lyrud	เลี์ยว
Dyrub	เดี้ยว
hcvb	แฮ่ง
Byxq	บย๊อ
funj	ฝุน
ag	อะ
Txb	ท่อ
zuq	ฒองฒุ
Peij	เผย
fug	ฝู่
syenj	เสียน
uaq	วั้ว
yetq	เยี้ยด
pcvg	แป่ง
zxv	ฒอง
pcvb	แปงกวั้น
komb	ก้ม
hepg	เหบ
Qovj	ฉง
paamd	ป์าม
petq	เป๊ด
naang	หน่าน
Eaiq	ไญ้
Fung	หฌุ่น
taJuaq	ตะจั๊ว
scvb	แซงเหฒียบ
kwaatq	กว๊าด
taan	ตาน
Yetg	เหฮยียด
Rru	โฑว
zaavq	ฒ้าง
yem	เยียม
tunj	ตุ๋น
Zalevg	หธะเหล่ง
fiub	ฟิ้วต้าน
Gaapq	ฆ้าบ
Zaaub	ธ่าว
hog	โหะ
panb	ปั้น
zeig	เหฒ่ย
Liaq	เฮลียะ
pen	เปน
kevj	เก๋ง
tauj	เต๋า
kauj	เก๋า
laavg	ฌังหล่าง
Jruj	โจ๋ว
Pxq	พ้อ
Buvb	บู้ง
zwrtg	หฒวด
Rxv	ฑอง
nrud	โน์ว
zxg	หฒ่อ
Havb	หฮญังๆ
syepq	เซี้ยบๆ
Beng	เบ่น
pxvd	ป์อง
laaub	ล่าว
Kxi	คอย
Zcq	แธะ
myetg	เหมียด
zaaij	หฒาย
kxiq	ก๊อย
fyruj	เฝียว
Jxm	จอม
tevq	เต๊ง
BaNxi	บะฮนอย
lapq	ลับ
Genj	เหฆน
Wrtq	ฮว้วด
vopq	งบ
kaQiaj	กะเฉีย
fiu	ฟิว
Fxmb	ฌ่อม
Tiuq	ทิ้ว
yopq	โย้บ
feij	เฝย
faanb	ฟ่าน
Ryav	เฑียง
paamb	ป้าม
kovb	กงฒิ่น
Pyen	เพียน
zivj	หฒีง
lod	โล์
aNxi	อะฮนอย
Koq	โคะ
linb	ลิ่น
kxvq	ก๊อง
kwai	ไกว
aiq	ไอ๊
myenb	เมี่ยน
zog	โหฒะ
wrnb	ว่วน
zaav	ฒาง
tavq	ตั๊ง
mxg	หม่อ
navq	นั้ง
paaq	ป๊า
lxg	ออนเหลาะ
Baav	บาง
naug	เหน่า
Eitg	หญิด
Kuq	คู้
lcvb	แล่ง
kcvq	แก๊ง
om	อม
xg	เอาะ
kevb	เก้ง
zyavq	เฒี้ยง
mun	มุน
wetq	เว้ด
tiaq	เตี๊ย
Jaaq	จ๊า
tunb	ตุ้น
yunb	ยุ่น
syrug	เสี่ยว
Piaj	เผีย
zung	หฑยาวหฒุ่น
Doq	กอนโด๊ะ
Laav	ฮลาง
Daub	เดาฮวาง
Zunj	หธุน
Kwavj	ขวัง
eij	แซงเอ๋ย
Zovb	ธง
aaj	อ๋า
sekq	เซ้ก
Vovj	หฮงง
prug	โป่ว
mau	เมา
Pwij	ผุย
twib	ตุ้ย
sxv	ซอง
zauj	เหฒา
Bai	ไบ
Diuj	ดิ๋ว
Fimq	ฌิ้ม
Eiag	เหญี่ย
Tipq	ทิบ
kxvb	ก๊องแปะ
Jyetq	จั๊ด
zxi	ฒอย
laaib	ล่าย
lwig	หลุ่ย
lovj	หลง
Eau	เญา
Yenq	เฮยี้ยน
Niaq	เฮนี้ย
vatq	งัด
myenb	เมี่ยน
leid	เล์ย
muvd	มู์ง
zweij	เหฒวย
tiq	ติ๊
Kwrtq	ค้วด
Exq	เญาะ
Piq	พิ
zeg	เหฒะ
Bwrnj	บ๋วน
paq	ป๊ะ
Exj	หญอ
heb	เฮ่
Zamb	ธั่ม
zwib	ฒุ่ย
Junb	จุ้น
hrub	โฮ่ว
scv	แซง
syruj	เสียว
Ruvb	ฑู่ง
Gwaaq	ฆว้า
zatq	ฒัด
Jyepq	เจี๊ยบ
lyenb	ค้อเลี่ยน
vaang	หง่าน
Daatq	ด๊าด
Eeig	จ๊บเหญ่ย
yenb	เยี่ยน
syepq	เซี้ยบ
lwib	ลุ่ย
Qru	โชวๆ
Gwin	ฆวิน
Dovj	ด๋ง
kwcvq	แกว๊ง
mwrtq	ม้วด
Zai	ไธ
fim	กงฟิม
piuj	ปิ๋ว
Zau	เธา
nivq	นี้ง
Dwi	ดุย
Gwaab	เดี๋ยงฆว่า
Bweij	เบว๋ย
zyruq	เฒี้ยว
Luvb	ฮลู่ง
Lwrtq	ฮล้วด
zweib	เฒว่ย
haand	ฮ์าน
pyopq	ปย๊บ
Gaiq	ไฆ้
pctq	แป๊ด
luq	ลู้
Dyavb	เดี๋ยงก์า
Jyenq	ก์า
Fung	โซวหฌุ่น
limg	หลิ่ม
Fwrtq	ฌ้วด
mcq	แมะ
fxv	ฟอง
Zunq	ธุ้น
Deig	เด่ย
yrug	โหย่ว
Jaub	เจ้า
Zeuj	เหธว
lung	หลุ่น
laKwrtq	หละค้วด
Riad	เฑี์ย
Ziaq	เธี้ย
tazyepg	ตะเหฒียบ
Tiv	ทีง
Zivb	ธี่ง
Bxg	เบาะ
tonj	ต๋น
Zruj	โหธว
Rutq	ฑุด
uaq	วั้ว
zcv	แฒง
syem	เซียม
mauj	เหมา
zevj	ฒองเหฒง
Diq	ดิ๊
zuvb	ฒู่ง
kasia	กะเซีย
Eyemg	เหญี่ยม
Funb	ฌุ่น
Juq	จู๊
Daij	ได๋
kweij	เกว๋ย
Byuvg	บยู่ง
samj	สัม
Leij	เหฮลย
sia	เซีย
swrng	ส่วน
Pruj	โผว
BaNxi	บะฮนอย
aaq	อ๊า
Lxvj	หฮลอง
Tov	โพวทง
Zivq	ธี้ง
nxig	หน่อย
Duaq	ดั๊ว
mcvb	แม่ง
tweiq	เตว๊ย
kitq	กิ๊ด
Twij	ถุย
Rov	ฑง
tod	โต์
Janj	จั๋น
kuq	กู๊
zuvj	หฒูง
Byenj	เบี๋ยน
Rru	ค้อยโฑว
Jwavq	จวั๊ง
taaij	ต๋าย
lwrnj	หลวน
hxvg	ห่อง
lyrug	เหลี่ยว
tonq	ต๊น
Byxvd	บย์อง
peig	เป่ย
navb	นั่ง
Jiuq	จิ๊ว
saaij	สาย
kauq	เก๊า
Daam	ดาม
Byaavj	บย๋าง
Zru	โธว
siaq	เซี้ย
mauq	เม้า
Kwanq	ควั้น
Pali	พะลี
Palaaij	พะหลาย
kwaaj	กว๋า
Jrub	โจ้ว
zanj	หฒัน
kem	เกม
Byaavg	บย่าง
kxb	ก๋อ
hemj	เหม
laEauq	หละเญ้า
Druq	โด๊ว
lovj	หลงๆ
haab	ฮ่า
Ki	คี
zivb	เอนฒี่ง
zanq	ฒั้น
laavg	หล่าง
Qavj	ฉัง
Eung	หญุ่น
hevj	เหง
nxb	น่อ
zwid	ฒุ์ย
ninb	นิ่น
Nxi	โล์ฮนอย
Kcq	แคะ
taaib	ต้าย
pyxvb	ปย้อง
Riag	เหฑียะ
mrub	โม่ว
syavb	เซียงฑูง
punb	ปุ้น
levb	เล่ง
Jaig	ไจ่
im	อิม
toq	โต๊
Zamj	หธัม
Qxv	ชอง
fov	ฟง
mwrnb	ม่วน
maab	ม่าะ
setg	เสด
paatg	ปาด
Jxib	จ้อย
Gwaq	ฆวะ
Dipg	ดิบ
maiq	ไม้
saaiq	ซ้าย
Yaamj	หฮยาม
Byrub	เบี้ยวๆ
aab	อ้า
meij	เหมย
puq	ปู๊
lovb	ล่ง
Kruj	โขว
kaaq	ก๊า
zyruq	แฒะเฒี้ยว
Bruq	โบ๊ว
peuq	เป๊ว
Txvq	ท้อง
Fipq	ฌิบ
Nxib	ฮนอยๆ
zyemj	เหฒียม
Ravb	ฑั่ง
mFxmb	มฌ่อม
saab	ซ่าะ
peib	เป้ย
nia	เนีย
aaDam	อา​ดัม
haawaa	ฮา​วา
Kaain	คา​อิน
kanaaib	กะน้ายหฒวัง
aaBcn	อา​แบน
Txi	ทอย
Zaa	ธา
nyaa	นีอา
mxvj	หมอง
naq	นะ
Frub	โฌ่ว
Waaj	หฮวา
tov	เอ​เดน
notq	โน้ด
enokq	เอ​โน้ก
ilaatq	อิ​ล้าด
mehujyaaen	เม​หู​ยา​เอน
meTusaaen	เม​ทู​ซา​เอน
laamekq	ลา​เม้ก
aaDaa	อา​ดา
sinjlaa	สิน​ลา
syav	เซียง
tiq	ตี๊
zwavq	ฒวั้ง
enotq	เอ​โน้ด
Kenan	เค​นัน
maahaalaalen	มา​หะ​ลา​เลน
yaaletq	ยา​เล้ด
meTusejlaa	เม​ทู​เส​ลา
noyaa	โน​ยา
yaafetq	ยา​เฟ้ด
aa	อา
haapq	ฮ้าบ
Go	โฆ
haam	ฮาม
Kaanaaan	คา​นา​อัน
kome	โก​เม
maakokg	มา​โกก
maaDai	มา​ได
yaawaan	ยา​วาน
TuBan	ทู​บัน
mesekq	เม​เซ้ก
Tilaatq	ทิ​ล้าด
atgKenatq	อัด​เค​นัด
lifaatq	ลี​ฟ้าด
Tokaanmaa	โท​กาน​มา
eliseaa	เอ​ลี​เซ​อา
Taansitq	ทาน​ซิด
KitqTim	คิด​ทิม
loDaanim	โล​ดา​นิม
iyipq	อี​ยิบ
Putq	พู้ด
sejBaa	เส​บา
haawilaa	ฮา​วิ​ลา
sapgTaa	สับ​ทา
laaaamaa	ลา​อา​มา
sapgTeKaa	สับ​เท​คา
QeBaa	เช​บา
DeDaan	เด​ดาน
nimlotq	นิม​โล้ด
taamq	ต๊าม
lesenj	เล​เสน
ninaawe	นิ​นะ​เว
Kaalaa	คา​ลา
luDim	ลู​ดิม
aanaamim	อา​นา​มิม
lehaaBim	เล​หะ​บิม
napqTuhim	นับ​ทู​ฮิม
hiwai	ฮี​ไว
aanKaa	อาน​คา
sijni	สี​นี
elaam	เอ​ลาม
atgsu	อัด​ซู
aanfaasatq	อาน​ฟา​ซัด
luDe	ลู​เด
aalam	อา​ลัม
utg	อูด
hun	ฮูน
keTe	เก​เท
matq	มัด
Qelaa	เช​ลา
eBe	เอ​เบ
yokqTaan	โย้ก​ทาน
anmoDatg	อัน​โม​ดัด
Qelepq	เช​เล้บ
haasaanmaawetq	ฮา​ซาน​มา​เว้ด
yelaa	เย​ลา
haaDolam	ฮา​โด​ลัม
usaan	อุ​ซาน
Dikglaa	ดิก​ลา
oBaan	โอ​บาน
aaBimaaen	อา​บี​มา​เอน
ofi	โอ​ฟี
yoBapg	โย​บับ
fanb	ฟั่น
BaaBen	บา​เบน
pelekq	เป​เล้ก
leu	เล​อู
sejlukq	เส​ลุก
naaho	นา​โฮ
Telaa	เท​ลา
apglaam	อับ​ลาม
haalaan	ฮา​ลาน
saalaai	ซา​ลาย
minKaa	มิน​คา
itgKaa	อิด​คา
nekepg	เน​เกบ
faalo	ฟา​โล
Betgen	เบด​เอน
sojDom	โส​โดม
Beilaa	เบย​ลา
komolaa	โก​โม​ลา
Binsaa	บิน​ซา
atgmaa	อัด​มา
sinaapq	ซี​น้าบ
sejBoyim	เส​โบ​ยิม
semeBe	เซ​เม​เบ
Belaa	เบ​ลา
naaiq	น้าย
sojaa	โส​อา
zivb	ฒี่ง
enmitqfatq	เอน​มิด​ฟัด
KaaDetg	คา​เดด
haasaason	ฮา​ซา​โซน
Taamaa	ทา​มา
aamaalekq	อา​มา​เล้ก
aamolai	อา​โม​ไล
sitgDim	สิด​ดิม
Erub	โญ่ว
hoBaa	โฮ​บา
Daamatqkatg	ดา​มัด​กัด
KeDolaaome	เค​โด​ลา​โอ​เม
saawe	ซา​เว
cvj	แอ๋ง
aane	อา​เน
etgKo	เอด​โค
mamle	มัม​เล
paaib	ท้องป้าย
eliyese	เอ​ลี​เย​เซ
apglaaham	อับ​ลา​ฮัม
kopq	ก๊บ
Ewrnb	ญ่วน
hitqTai	ฮิด​ไท
pelitqsi	เป​ลิด​ซี
lefaaim	เล​ฟา​อิม
haakaa	ฮา​กา
isaamaaen	อิ​สะ​มา​เอน
saalaa	ซา​ลา
ni	นี
zaamg	หฒ่าม
KaDau	ขะเดา
loq	โล้
zyrug	เหฒี่ยว
fovq	ฟ้ง
Raatg	หฑาด
paan	ปาน
kelaaaa	เก​ลา​อา
aaBimelekq	อา​บี​เม​เล้ก
isakg	อี​สัก
hrug	โห่ว
Ritq	ฑิด
BeeQeBaa	เบ​เอ​เช​บา
lomb	ล่ม
Haa	ฮญา
Dog	โดะ
Kesetg	เค​เสด
haaso	ฮา​โซ
pinDaatg	ปิน​ดาด
yitqlaapq	ยิด​ล้าบ
BeTuen	เบ​ทู​เอน
leBeKaa	เล​เบ​คา
KiliyaatqaanBaa	คี​ลิ​ย้าด​อาน​บา
heBolon	เฮ​โบ​โลน
keg	เกะ
sojhaaj	โส​หา
efolon	เอ​โฟ​โลน
zaavb	ฒ่าง
Ko	โค
lo	โล
ov	อง
kuj	กู๋
laaBaan	ลา​บาน
Kavq	คั้ง
hopq	ฮบ
zxq	ฒ้อ
KeTulaa	เค​ทู​ลา
yokqsaan	โย้ก​ซาน
atgsulim	อัด​ซู​ลิม
leTusim	เล​ทู​ซิม
leummim	เล​อุม​มิม
mitqmaa	มิด​มา
Dumaa	ดู​มา
matqsaa	มัด​ซา
haaDatg	ฮา​ดัด
Temaa	เท​มา
yeTu	เย​ทู
naafitq	นา​ฟิด
KeDemaa	เค​เด​มา
patgDaanaalam	ปัด​ดาน​อา​ลัม
esaau	เอ​ซาว
yaaKopq	ยา​โค้บ
topg	ตบ
filisaatia	ฟี​ลิ​สะ​เตีย
Beeli	เบ​เอ​ลี
yuDitg	ยู​ดิด
elon	เอ​โลน
Baasejmatq	บา​เส​มัด
laai	ลาย
aJav	อะจัง
Lua	ฮลัว
taa	ตา
Romd	ฑ์ม
laasen	ลา​เซน
syavj	เสียง
naud	เน์า
pyetq	เปี๊ยด
laaBaan	ลา​บาน
Pyenj	เผียน
Binhaa	บิน​ฮา
leaa	เล​อา
lewi	เล​วี
napqTaali	นับ​ทา​ลี
sinjpaa	สิน​ปา
witq	วิด
saau	ซาว
DuDaaim	ดู​ดา​อิม
Jiab	เจี้ย
Dinaa	ดี​นา
taapq	ต๊าบ
tyemq	เตี๊ยม
Pyruj	เผียว
kwaaiq	กว๊าย
Pwi	พุย
Pyatq	พยัด
isaalaaen	อิ​สะ​ลา​เอน
yosepq	โย​เซ้บ
seji	เส​อี
haamo	ฮา​โม
seKem	เซ​เคม
simeon	สิ​เม​โอน
pwij	ปุ๋ย
Eeib	เญ่ย
efaalaaTaa	เอ​ฟา​ลา​ทา
Benyaamin	เบน​ยา​มิน
aase	อา​เซ
se	เซ
elifatq	เอ​ลี​ฟัด
leuen	เล​อู​เอน
Temaan	เท​มาน
omaa	โอ​มา
sejfo	เส​โฟ
naahatg	นา​หัด
zelaa	เฒ​ลา
aanaa	อา​นา
yeutg	เย​อูด
yaalaam	ยา​ลาม
Kolaa	โค​ลา
oholiBaamaa	โอ​โฮ​ลี​บา​มา
tovb	ต้ง
eDom	เอ​โดม
holi	โฮ​ลี
homam	โฮ​มัม
loTaan	โล​ทาน
Timnaa	ทิม​นา
soBaan	โซ​บาน
maanaahaatq	มา​นา​ฮ้าด
eBaan	เอ​บาน
Qefo	เช​โฟ
onam	โอ​นัม
Dison	ดี​โซน
hemDaan	เฮม​ดาน
etgBaan	เอด​บาน
itglaan	อิด​ลาน
Kelaan	เค​ลาน
ese	เอ​เซ
aaKaanj	อา​ขาน
Disaan	ดี​ซาน
aalan	อา​ลัน
siBeon	สิ​เบ​โอน
eDom	เอ​โดม
DinhaaBaa	ดิน​ฮา​บา
Bosaalaa	โบ​ซา​ลา
husaam	หุ​ซาม
BeDatg	เบ​ดัด
moapg	โม​อับ
miDyen	มี​เดียน
aawitq	อา​วี้ด
samjlaa	สัม​ลา
lehojBotg	เล​โห​โบด
saaun	ซา​อุน
akgBo	อัก​โบ
Baaanhaanan	บา​อัน​ฮา​นัน
paau	ปา​อู
matqletq	มัด​เล้ด
mesaahapg	เม​ซา​หับ
anwaa	อัน​วา
yeTetq	เย​เท้ด
elaa	เอ​ลา
pinon	ปี​โนน
Kenatq	เค​นัด
mipqsaa	มิบ​ซา
DoTaan	โด​ทาน
luBen	ลู​เบน
yuDaa	ยู​ดา
Quaa	ชู​อา
eaa	เอ​อา
onan	โอ​นัน
Kesipq	เค​ซี้บ
hipqlu	ฮิบ​ลู
Jei	เจย
naiaa	ไน​อา
Kxv	คอง
amavg	อะหมั่ง
txq	ต๊อ
Eauj	เหญา
lcb	แล่
siv	ซีง
fivq	ฟี้ง
haanokq	ฮา​โน้ก
panlu	ปัน​ลู
hetqlon	เฮ้ด​โลน
Kaanmi	คาน​มี
yemuen	เย​มู​เอน
yaamin	ยา​มีน
ohaatg	โอ​หาด
yaaKin	ยา​คีน
keson	เก​โซน
Kohaatq	โค​ฮ้าด
melaali	เม​ลา​ลี
itgsaajKaa	อิด​สา​คา
Tolaa	โท​ลา
puwaa	ปู​วา
iopg	อิ​โอบ
simlon	ซิม​โลน
sejBulun	เส​บู​ลุน
sejletq	เส​เล้ด
yaaleen	ยา​เล​เอน
hakqki	ฮัก​กี
suni	ซู​นี
etgBon	เอด​โบน
elei	เอ​เล​อี
aaloDi	อา​โล​ดี
aaleli	อา​เล​ลี
imnaa	อิม​นา
itgwaa	อิด​วา
itgwi	อิด​วี
Beliyaa	เบ​ลี​ยา
selaaaa	เซ​ลา​อา
heBe	เฮ​เบ
BeKe	เบ​เค
atgBen	อัด​เบน
kelaa	เก​ลา
naaaamaan	นา​อา​มาน
ehai	เอ​ไฮ
loatg	โล​อัด
mapqpim	มับ​ปิม
aatg	อาด
husim	หุ​ซิม
yaasien	ยา​ซี​เอน
kuni	กุ​นี
yese	เย​เซ
sinlem	ซิน​เลม
kosen	โก​เซน
Eim	ญิม
maanatqsej	มะ​นัด​เส
efaaim	เอ​ฟา​อิม
waan	วาน
Eaab	ญ่า
Zei	เธย
JxDcn	จอ​แดน
aaTaatq	อา​ท้าด
maaKi	มา​คี
Byend	เบี์ยน
aRyaaug	อะหฑย่าว
mose	โม​เซ
kxvq	สิบ​โป​ลา
aalon	อา​โลน
zyav	เฒียง
lweig	เหลว่ย
lipqni	ลิบ​นี
simei	ซิ​เม​อี
maali	มา​ลี
musi	มู​ซี
itghaa	อิด​ฮา
nefekq	เน​เฟ้ก
sikgli	สิก​ลี
utgsien	อุด​ซี​เอน
misaaen	มิ​ซา​เอน
ensaafaan	เอน​ซา​ฟาน
sitgli	สิด​ลี
naason	นา​โซน
eliQeBaa	เอ​ลี​เช​บา
naaDapg	นา​ดับ
iTaamaa	อิ​ทา​มา
atgsij	อัด​สี
enKaanaa	เอน​คา​นา
aaBiyaasaapg	อา​บี​ยา​สาบ
eleaasaa	เอ​เล​อา​ซา
puTien	ปู​ทิ​เอน
finehatg	ฟี​เน​หัด
yaamb	ย่าม
ziq	ฒิ
Zaij	ไหธ
Len	เปย๊าเฮลน
faanq	ฟ้าน
fyaau	ฟยาว
pyxmb	ปย้อม
Kavb	คั่ง
wrn	ววน
Raug	โต์วเหฑ่า
pxg	เปาะ
twib	ตุ้ย
Baali	บา​ลี
pau	เปา
mapq	มับ
zyruq	เฒี้ยว
Daamq	ด๊าม
zrug	โหฒ่ว
husopg	หุ​โสบ
laamaasetg	ลา​มา​เสด
sukgKotq	สุก​โค้ด
Zib	ธี่
aaBipg	อา​บีบ
zyetg	เหฒียด
milyem	มิ​เลียม
xb	เอ้าะ
mxq	เมาะ
lefiDim	เล​ฟี​ดิม
Ewij	หญุย
huaa	ฮู​อา
yosuwaa	โย​ซู​วา
zutg	หฒุด
yeTo	เย​โท
Jaavq	จ๊าง
Balivg	บะหลี่ง
sinaai	ซี​นาย
Bovb	บง
Genj	บงเหฆน
hanb	ฮั่น
luvd	ลู์ง
pwib	ปุ้ย
leig	เหล่ย
wcvg	แหว่ง
aaBihu	อา​บี​ฮู
Kwiv	ควีง
KeluBim	เค​ลู​บิม
wcvb	แว่ง
lunb	ลุ่น
nekq	เน้ก
Kru	โคว
wrng	หว่วน
efotq	เอ​โฟ้ด
Paanj	ผาน
Bind	บิ์น
Jyemb	เจียมป้าย
Divb	ดี้ง
txv	ดามตอง
hruj	โหว
Ganj	หฆัน
piag	ฌั้วเปียะ
Ywav	ฮยวัง
kiv	กีง
faamb	ฟามปวน
Peuj	เผว
uli	อุ​ลี
Besaalen	เบ​ซา​เลน
Yun	ฮยุน
Bwrnq	บ๊วน
sxtq	ซ้อด
setq	เซียวเซ้ด
yeButg	เย​บุด
cvq	แอ๊ง
aahisaamakq	อา​หิ​สะ​มัก
oholiapg	โอ​โฮ​ลี​อับ
kuvb	กู้ง
kavg	กั่ง
Laavb	ฮลางบั๊ว
Kwiv	ญัด
Kavj	ขัง
Jaavb	แธะจ้าง
Zaan	ธาน
kxg	เกาะ
Kwei	เควย
Jwij	จุ๋ย
Qruq	โช้ว
Zcv	แธง
naatq	น้าด
zin	ฒิน
ulim	อุ​ลิม
Tummim	ทุม​มิม
puaq	ปั๊วะ
Byaab	บย้า
naaud	น์าว
Taanb	ท่าน
omj	อ๋ม
syetq	เซี้ยด
kxvg	ก่อง
puab	ปั์วฒ้าง
mcv	แมง
lyavq	เลี้ยง
kwaaib	กว้าย
laaud	ล์าว
molekq	โม​เล้ก
Duv	ดูง
syrub	เซี่ยว
Ryepq	เฑี้ยบ
Laau	ฮลาว
tiub	ติ้วๆ
Eanq	ญั้น
selomitq	เซ​โล​มิด
Dipgli	ดิบ​ลี
fivj	ป๊วนฝีง
Bav	บัง
seDee	เซ​เด​เอ
elisu	เอ​ลี​ซู
sujlisatqDai	สู​ลิ​ซัด​ได
selumien	เซ​ลู​มิ​เอน
amminaaDapg	อัม​มี​นา​ดับ
zuaa	ฒู​อา
neTanen	เน​ทัน​เอน
helon	เฮ​โลน
eliapg	เอ​ลี​อับ
ammihutq	อัม​มี​ฮู้ด
elisaamaa	เอ​ลี​ซา​มา
peDaasu	เป​ดา​ซู
kaamaalien	กา​มา​ลิ​เอน
kiDeoni	กิ​เด​โอ​นี
aaBiDan	อา​บี​ดัน
ammiQatqDai	อัม​มี​ชัด​ได
aahiyese	อา​หิ​เย​เซ
oKaan	โอ​คาน
paakien	ปา​กี​เอน
Deuen	เด​อู​เอน
eliyaasaapg	เอ​ลี​ยา​สาบ
enan	เอ​นัน
aahilaa	อา​หิ​ลา
amlaam	อัม​ลาม
elisaafaan	เอ​ลี​ซา​ฟาน
Bxv	บอง
naasij	นา​สี
meib	บัว’
TaaBelaa	ทา​เบ​ลา
maanaa	มา​นา
mweij	เหมวย
zepq	เฒ้บ
Kipglotqhatgtaaaawaa	ขิบ​โล้ด​หัด​ตา​อา​วา
haaselotq	ฮา​เซ​โล้ด
sakgke	สัก​เก
sammuwaa	ซัม​มุ​วา
saafatq	ซา​ฟัด
yefunne	เย​ฟุน​เน
Kaalepq	คา​เล้บ
ikaan	อิ​กาน
hoseyaa	โฮ​เซ​ยา
laafu	ลา​ฟู
panTi	ปัน​ที
sojDi	โส​ดี
katgDyen	กัด​เดียน
susij	สุ​สี
katgDi	กัด​ดี
kemanli	เก​มัน​ลี
ammien	อัม​มี​เอน
miKaaen	มี​คา​เอน
sejTu	เส​ทู
wopqsij	โว้บ​สี
naaBi	นา​บี
keuen	เก​อู​เอน
yaaug	หย่าว
heg	เห่
Ria	เฑีย
zitg	หฒิด
homaa	โฮ​มา
tekg	ต๋อยเตก
DaaTaan	ดา​ทาน
aaBilam	อา​บี​ลัม
syavb	เซียงสี่
yemb	เยี่ยม
lob	โล่ะ
avung	เซียงอะหงุ่น
Eweib	เญว่ย
zxvb	ฒ่อง
meliBaa	เม​ลี​บา
KaaDetg	คา​เดด
hoaa	โฮ​อา
aalaatq	อา​ล้าด
aaTaalim	อา​ทา​ลิม
tog	นางโตะ
zeletq	เฒ​เล้ด
matqTaanaa	มัด​ทา​นา
naahaalien	นา​หะ​ลี​เอน
Baamotq	บา​โม้ด
sihonj	สิ​โหน
hetqBon	เฮ้ด​โบน
Kemotq	เค​โม้ด
Biag	เบี่ย
Laij	ไหฮล
sipgpo	สิบ​โป
Baalaakq	บา​ล้าก
Baalaaam	บา​ลา​อัม
laaig	หล่าย
Kiliyaatqhusotq	คี​ลิ​ย้าด​หุ​โซ้ด
Baaan	บา​อัน
zevj	เหฒง
Beo	เบ​โอ
Kenai	เค​ไน
sitqTim	ซิด​ทิม
peo	เป​โอ
simjli	สิม​ลี
saajlu	สา​ลู
KotqBi	โค้ด​บี
sujaa	สู​อา
otgni	โอด​นี
aalotq	อา​โล้ด
yaasupq	ยา​ซู้บ
atglien	อัด​ลี​เอน
semiDaa	เซ​มิ​ดา
hefe	เฮ​เฟ
hefe	เฮ​เฟ
sejlofehatg	เส​โล​เฟ​หัด
maahaalaa	มา​ฮา​ลา
hokqlaa	โฮ้ก​ลา
Tilaasaa	ที​ละ​ซา
sefufaam	เซ​ฟู​ฟาม
hufaam	หุ​ฟาม
suham	ซู​ฮัม
aase	อา​เซ
kileaatg	กิ​เล​อาด
maaKile	มา​คี​เล
aaBaalim	อา​บา​ลิม
ewi	เอ​วี
leKem	เล​เคม
leBaa	เล​บา
Tiag	เถี่ย
Juvd	จู์ง
tev	เตง
txnb	ตอนหละเก๊า
eTaam	เอ​ทาม
pihaahilotq	ปี​หะ​หิ​โล้ด
Baaansefon	บา​อัน​เซ​โฟน
mikqDon	มิก​โดน
DofaaKaa	โด​ฟะ​คา
aalutq	อา​ลู้ด
litqmaa	ลิด​มา
limmonpeletq	ลิม​โมน​เป​เล้ด
lipqnaa	ลิบ​นา
litqsaaj	ลิด​สา
KehelaaTaa	เค​เฮ​ลา​ทา
sefe	เซ​เฟ
haalaaDaa	ฮา​ลา​ดา
makqhelotq	มัก​เฮ​โล้ด
Taahatg	ทา​หัด
mitqKaa	มิด​คา
hatqmonaa	ฮัด​โม​นา
mosejlotq	โม​เส​โล้ด
BeneyaaaaKan	เบ​เน​ยา​อะ​คัน
hohakqkitgkaatg	โฮ​ฮัก​กีด​กาด
yotqBaaTaa	โย้ด​บา​ทา
apglonaa	อับ​โล​นา
esionkeBe	เอ​ซี​โอน​เก​เบ
sanjmonaa	สัน​โม​นา
punon	ปู​โนน
oBotg	โอ​โบด
iyeaaBaalim	อี​เย​อา​บา​ลิม
DiBonkaatg	ดี​โบน​กาด
anmonDipglaaTaaim	อัน​โมน​ดิบ​ลา​ทา​อิม
neBo	เน​โบ
atgmon	อัด​โมน
meDitelenyen	เม​ดิ​เต​เล​เนียน
haamatq	ฮา​มัด
sejDatg	เส​ดัด
semuen	เซ​มู​เอน
Qitqlon	ชิด​โลน
eliDaatg	เอ​ลี​ดาด
yokqli	โย้ก​ลี
BukgKi	บุก​คี
hannien	ฮัน​นี​เอน
sipqTaan	ซิบ​ทาน
Kemuen	เค​มู​เอน
paanaakq	ปา​น้าก
atgsaan	อัด​ซาน
panTien	ปัน​ที​เอน
selomi	เซ​โล​มี
aahihutq	อา​หิ​ฮู้ด
peDaahen	เป​ดา​เฮน
eDeni	เอ​เดน​อี
atgTaalotq	อัด​ทา​โล้ด
Baasaan	บา​ซาน
holepq	โฮ​เล้บ
zinb	ฒิ่น
emim	เอ​มิม
aanaakq	อา​น้าก
KaaDetgBaania	คา​เดด​บา​เนีย
yaahaatq	ยา​ฮ้าด
aankopg	อาน​โกบ
sxn	ซอน
hemon	เฮ​โมน
saiDxn	ไซ​ดอน
sijlixn	สี​ลี​ออน
sejni	เส​นี
mru	โมว
penq	เป๊น
aalaaBaa	อา​ลา​บา
pitgkaa	ปิด​กา
Juaq	จั๊วะ
Jyenb	เจี้ยน
Gcq	แฆะ
mag	หมะ
faav	เดี๋ยงฟาง
kutgkoDaa	กุด​โก​ดา
Jamq	จั๊ม
Zaaiq	ธ้าย
mlomb	มล่ม
miu	มิว
lov	ลง
weig	เหว่ย
Meiq	เฮม้ย
puad	ขูงปั์ว
pei	เปย
Zim	ธิม
Jyemj	เจี๋ยม
fin	ฟิน
ammon	อัม​โมน
vaib	ไง่
ling	หลิ่น
tru	โตว
pcvj	แป๋ง
auq	เอ๊า
Tutq	ทุด
kelisim	เก​ลิ​ซิม
Tovj	ถง
aamen	อา​เมน
puag	ปัวะ
Gaatq	ฆ้าด
yav	ยัง
laahapg	ลา​หับ
kinkaan	กิน​กาน
lau	โต์วเลา
yeliKo	เย​ลี​โค
QeBaalim	เช​บา​ลิม
sapgDi	สับ​ดี
aaKaan	อา​คาน
Dapq	ดั๊บ
kiBeon	กิ​เบ​โอน
Kefilaa	เค​ฟี​ลา
Beelotq	เบ​เอ​โล้ด
Kiliyaatqyeaalim	คี​ลิ​ย้าด​เย​อา​ลิม
yelusaalem	เย​ลู​ซา​เลม
aaDoniseDekg	อา​โด​นี​เซ​เดก
hoham	โฮ​ฮัม
yaanmutq	ยาน​มู้ด
pilaam	ปี​ลาม
laaKitq	ลา​คี้ด
yaafia	ยา​เฟีย
ekglon	เอก​โลน
DeBi	เด​บี
Betgholon	เบด​โฮ​โลน
aaseKaa	อา​เซ​คา
makqKeDaa	มัก​เค​ดา
aiyaalon	ไอ​ยา​โลน
kese	เก​เซ
holaam	โฮ​ลาม
yaaBin	ยา​บิน
maaDon	มา​โดน
akgsaapq	อัก​ซ้าบ
melom	เม​โลม
uamb	ววม
mitqlefotqmaaim	มิด​เล​โฟ้ด​มา​อิม
mitqpaa	มิด​ปา
Tauq	เท้า
nitq	นิด
keDe	เก​เด
aaDunlam	อา​ดุน​ลัม
Tapqpuwaa	ทับ​ปู​วา
aafekq	อา​เฟ้ก
laasaalon	ลา​ซา​โลน
simlonmelon	ซิม​โลน​เม​โลน
Taaaanaakq	ทา​อา​น้าก
mekitgDo	เม​กิด​โด
KeDetg	เค​เดด
Kaanmen	คาน​เมน
yokqneam	โย้ก​เน​อัม
naafotqDoaa	นา​โฟ้ด​โด​อา
Doaa	โด​อา
kaaliliEei	กา​ลิ​ลีเญย
koyim	โก​ยิม
kesu	เก​ซู
maaaaKaa	มา​อา​คา
saajleKaa	สา​เล​คา
KeDemotq	เค​เด​โม้ด
mefaaaatg	เม​ฟา​อาด
Betgpeo	เบด​เป​โอ
Betgyesimotq	เบด​เย​ซิ​โม้ด
Baaaalaa	บา​อา​ลา
yelaalim	เย​ลา​ลิม
Kesaalon	เค​สะ​โลน
Betgsemetq	เบด​เซ​เม้ด
Timnaahaa	ทิม​นา​ฮา
Kiliyaatqsejfe	คี​ลิ​ย้าด​เส​เฟ
akgsaaj	อัก​สา
otgnien	โอด​นี​เอน
taand	ต์าน
Kinaa	คี​นา
Dimonaa	ดี​โม​นา
aaDaaDaa	อา​ดา​ดา
itgnaan	อิด​นาน
sipgaa	สิบ​อา
Telem	เท​เลม
Beaalotq	เบ​อา​โล้ด
haasohaaDatgTaa	ฮา​โซ​ฮา​ดัด​ทา
Keliotghetqlon	เค​ลิ​โอด​เฮ้ด​โลน
aamam	อา​มัม
semaa	เซ​มา
molaaDaa	โม​ลา​ดา
haasaankatgDaa	ฮา​ซาน​กัด​ดา
hetqmon	เฮ้ด​โมน
Betgpeletq	เบด​เป​เล้ด
haasaansuaan	ฮา​ซาน​ซู​อาน
BisioTiyaa	บิ​ซิ​โอ​ทิ​ยา
iyim	อิ​ยิม
esem	เอ​เซม
enTolatq	เอน​โท​ลัด
Kesinj	เค​สิน
honmaa	โฮน​มา
sikglaakq	สิก​ล้าก
matqmannaa	มัด​มัน​นา
sanjsanjnaa	สัน​สัน​นา
saajnoaa	สา​โน​อา
enkannim	เอน​กัน​นิม
enaam	เอ​นาม
sojKo	โส​โค
sejnan	เส​นัน
haaDaaqaa	ฮา​ดา​ชา
mikqDankaatg	มิก​ดัน​กาด
Dilean	ดิ​เล​อัน
yotqTeen	โย้ด​เท​เอน
BotgKaatq	โบด​ค้าด
KapqBon	คับ​โบน
laamam	ลา​มัม
Kitqlitq	คิด​ลิด
eTe	เอ​เท
aaQan	อา​ชัน
ipgTaa	อิบ​ทา
atgnaa	อัด​นา
nesipq	เน​ซี้บ
Daannaa	ดาน​นา
Kiliyaatqsanjnaa	คี​ลิ​ย้าด​สัน​นา
aanaapq	อา​น้าบ
etgTemoaa	เอด​เท​โม​อา
aanim	อา​นิม
aalapg	อา​หลับ
esaan	เอ​ซาน
yaanim	ยา​นิม
BetgTapqpuwaa	เบด​ทับ​ปู​วา
aafeKaa	อา​เฟ​คา
maaon	มา​โอน
yutqTaa	ยุด​ทา
yitqleen	ยิด​เล​เอน
yokqDeam	โย้ก​เด​อัม
hanhun	ฮัน​ฮูน
Betgsujaa	เบด​สู​อา
keDo	เก​โด
yaanoaa	ยา​โน​อา
aaTaalotq	อา​ทา​โล้ด
naaaalaa	นา​อา​ลา
silo	ซี​โล
Betghokqlaa	เบด​โฮ้ก​ลา
emekqKesitq	เอ​เม้ก​เค​ซี้ด
BetgaalaaBaa	เบด​อา​ลา​บา
sejmaalaaim	เส​มา​ลา​อิม
apgwim	อับ​วิม
paalaa	ปา​ลา
ofaalaa	โอ​ฟา​ลา
laamaa	ลา​มา
mosaa	โม​ซา
inpeen	อิน​เป​เอน
Taalaalaa	ทา​ละ​ลา
QeBaa	เช​บา
Baalaa	บา​ลา
BetgmaanKaaBotg	เบด​มาน​คา​โบด
haasaansujsaaj	ฮา​ซาน​สู​สา
haafaalaaim	ฮา​ฟา​ลา​อิม
siyon	ซี​โยน
aanaahaalaatq	อา​นา​หะ​ล้าด
lapqBitg	ลับ​บีด
Kision	คี​ซิ​โอน
eBetg	เอ​เบด
lemetq	เล​เม้ด
enhatgDaa	เอน​หัด​ดา
Betgpatgsetq	เบด​ปัด​เซ้ด
zeaa	เฒ​อา
hammatq	ฮัม​มัด
lakqKatq	ลัก​คัด
Kinneletq	คิน​เน​เล้ด
aaDaamaa	อา​ดา​มา
enhaaso	เอน​ฮา​โซ
sojlaa	โส​ลา
etgTaaon	เอด​ทา​โอน
insemetq	อิน​เซ​เม้ด
saaanBin	ซา​อัน​บิน
itglaa	อิด​ลา
eKolon	เอ​โค​โลน
enTeKe	เอน​เท​เค
kipgBeTon	กิบ​เบ​โทน
Baaaalatq	บา​อา​ลัด
yehutq	เย​ฮู้ด
BeneBelaakq	เบ​เน​เบ​ล้าก
katglimmon	กัด​ลิม​โมน
Besekq	เบ​เซ้ก
aaDoniBesekq	อา​โด​นี​เบ​เซ้ก
sesai	เซ​ไซ
aahimaan	อา​หิ​มาน
Tanmai	ทัน​ไม
akgKo	อัก​โค
akglaapq	อัก​ล้าบ
akgsipq	อัก​ซี้บ
henBaa	เฮน​บา
lehopg	เล​โหบ
ehutq	เอ​ฮู้ด
Byeng	เบี่ยน
fxq	ฟ้อ
aanaatq	อา​น้าด
samkaa	ซัม​กา
lapqpiDotg	ลับ​ปิ​โดด
DeBolaa	เด​โบ​ลา
aaBinoam	อา​บี​โน​อัม
TaaBo	ทา​โบ
sisejlaa	สิ​เส​ลา
timg	ติ่ม
Eomg	หญ่ม
Zovj	หธง
kiDeon	กิ​เด​โอน
yoaatg	โย​อาด
uamb	ววมเฮลน
Byetg	เบียด
aaBiyese	อา​บี​เย​เซ
zeBaa	เฒ​บา
sanjmunnaa	สัน​มุน​นา
penuen	เป​นู​เอน
heletq	เฮ​เล้ด
yelupqBaaan	เย​ลุบ​บา​อัน
BaaanBelitq	บา​อัน​เบ​ลี้ด
Betgminlo	เบด​มิน​โล
kaam	กาม
yoTaam	โย​ทาม
Bee	เบ​เอ
sejBun	เส​บุน
kaaan	กา​อัน
Kiv	คีง
Rauq	เฑ้า
haad	ฮ์า
TeBetg	เท​เบด
saami	ซา​มี
Jaai	จา​อี
haauwotqJaai	ฮาว​โว้ด​จา​อี
Kaamon	คา​โมน
yepqTaa	เย้บ​ทา
aaloe	อา​โล​เอ
minnitq	มิน​นิด
aaBenKelaamim	อา​เบน​เค​ลา​มิม
saajfon	สา​โฟน
Betglehem	เบด​เล​เฮม
ipgsaan	อิบ​ซาน
pilaaTon	ปิ​ลา​โทน
hinlen	ฮิน​เลน
apgDon	อับ​โดน
maanoaa	มา​โน​อา
scmsanj	แซม​สัน
lehi	เล​ฮี
kwcvj	แกว๋ง
laamaatqlehi	ลา​ม้าด​เล​ฮี
kaasaa	กา​ซา
sojlekq	โส​เล้ก
Delilaa	เด​ลิ​ลา
Gamq	ฆั้ม
miKaa	มี​คา
maahaaneDaan	มา​หะ​เน​ดาน
laaitg	ลา​อิด
Betglehopg	เบด​เล​โหบ
kiBeaa	กิ​เบ​อา
uaq	วั้ว
BaaanTaamaa	บา​อัน​ทา​มา
yaaBetgkileaatg	ยา​เบด​กิ​เล​อาด
leBonaa	เล​โบ​นา
naaomi	นา​โอ​มี
elimelekq	เอ​ลี​เม​เล้ก
ofaa	โอ​ฟา
luTe	ลู​เท
maalon	มา​โลน
Kilion	คิ​ลิ​โอน
Jaa	เซียงจา
Eaam	ญาม
Juab	จั้ว
Niaq	เฮนี้ยๆ
maalaa	มา​ลา
Boaatg	โบ​อาด
ovj	อ๋ง
Zamq	ธั้มๆ
Ryen	เฑียน
Tovq	ท้ง
laam	ลาม
sanjmon	สัน​โมน
oBetg	โอ​เบด
Jyetgsi	เจียด​ซี
Daawitq	ดา​วิด
Eei	ป๊วนฒี่ง
eli	เอ​ลี
peninnaa	เป​นิน​นา
hannaa	ฮัน​นา
yuvd	แซงยู์ง
Jeij	ฮวั้วเจ๋ย
eiq	เอ๊ย
kanaanb	กะน่าน
lafapg	หละฟับดุย
saamuen	ซา​มู​เอน
atgDotg	อัด​โดด
txvj	โล์ต๋อง
aaBinaaDapg	อา​บี​นา​ดับ
Damq	ดั๊ม
BetgKaa	เบด​คา
saulo	เซา​โล
zrub	โฒ่ว
Jyenq’	เจี๊ยน’
senjsaa	เสน​ซา
Dwi	กะน้ายดุย
fwij	ฝุย
yaaBetg	ยา​เบด
naahaatg	นา​หาด
mikqmaatq	มิก​ม้าด
suan	ซู​อัน
yonaaTaan	โย​นา​ทาน
mikon	มิ​โกน
aahiyaa	อา​หิ​ยา
apgne	อับ​เน
ne	เน
aaBien	อา​บี​เอน
Telaaim	เท​ลา​อิม
suwaa	ซู​วา
aakakg	อา​กัก
sinb	ซินเพย
sammaa	ซัม​มา
Myenb	เฮมียนฝัง
koliatg	โก​ลิ​อัด
naamj	หนาม
saaaalaaim	ซา​อา​ลา​อิม
siag	เซียะโฮล
heug	เม​ล้าบ
miKaan	มี​คาน
naayotq	นา​โย้ด
aahimelekq	อา​หิ​เม​เล้ก
aaKitq	อา​คิด
Doekg	โด​เอก
aahiTupq	อา​หิ​ทู้บ
aaBiyaaTaa	อา​บี​ยา​ทา
Keilaa	เค​อี​ลา
selaahammaaleKotq	เซ​ลา​ฮัม​มา​เล​โค้ด
enkeDi	เอน​เก​ดี
naaBaan	นา​บาน
aaBikaayin	อา​บี​กา​ยิน
aahinoam	อา​หิ​โน​อัม
sejluyaa	เส​ลุ​ยา
yoaapg	โย​อาบ
aaBiQai	อา​บี​ไช
maaokg	มา​โอก
sunem	ซู​เนม
kinBoaa	กิน​โบ​อา
poj	โป๋
enDo	เอน​โด
tyen	เตียน
Besoj	เบ​โส
KeleTi	เค​เล​ที
yiaq	เยียะ
laamotq	ลา​โม้ด
yaatqTi	ย้าด​ที
sipgmotq	สิบ​โม้ด
laaKaan	ลา​คาน
yelaameen	เย​ลา​เม​เอน
BolaaQaan	โบ​ลา​ชาน
aaTaakq	อา​ท้าก
manKisuwaa	มัน​คี​ซู​วา
xpq	อ๊อบ
Betgsaan	เบด​ซาน
mwrnj	หมวน
Jyemb	เจี้ยม
yaasaa	ยา​ซา
itgBosetq	อิด​โบ​เซ้ด
maahaanaaim	มา​หะ​นา​อิม
Faavb	ฌ่าง
laEaapq	หละญ้าบ
henKatghatqsulim	เฮน​ขัด​ฮัด​ซู​ลิม
aasaajhen	อา​สา​เฮน
Bitqlon	บิ๊ด​โลน
amnon	อัม​โนน
aaDoniyaa	อา​โด​นี​ยา
hakqkitg	ฮัก​กีด
sefaaTiyaa	เซ​ฟา​ทิ​ยา
aaBiTan	อา​บี​ทัน
itgleam	อิด​เล​อัม
ekglaa	เอก​ลา
kitgTaaim	กิด​ทา​อิม
limmon	ลิม​โมน
leKaapq	เล​ค้าบ
Baaaanaa	บา​อา​นา
minlo	มิน​โล
soBapg	โซ​บับ
naaTan	นา​ทัน
saalomxn	ซา​โล​มอน
ipghaa	อิบ​ฮา
elisuwaa	เอ​ลี​ซู​วา
eliyaaDaa	เอ​ลี​ยา​ดา
elifeletq	เอ​ลี​เฟ​เล้ด
keBaa	เก​บา
utgsaa	อุด​ซา
peletqutgsaa	เป​เล้ด​อุด​ซา
wivg	หวี่ง
oBetgeDom	โอ​เบด​เอ​โดม
laamj	หลาม
Jung	ตอนจุ่น
sijDaa	สี​ดา
Eauq	เญ้า
sojBaa	โส​บา
haaDatgese	ฮา​ดัด​เอ​เซ
yufetitg	ยู​เฟ​ติด
silia	ซี​เลีย
BeTaa	เบ​ทา
BeloTai	เบ​โล​ไท
yehoyaaDaa	เย​โฮ​ยา​ดา
Benaiyaa	เบ​ไน​ยา
Peletq	เพ​เล้ด
siBaa	ซิ​บา
loDeBaa	โล​เด​บา
mefiBosetq	เม​ฟี​โบ​เซ้ด
haanun	ฮา​นูน
eliam	เอ​ลี​อัม
BatgQeBaa	บัด​เช​บา
uliaa	อุ​ลี​อา
yelupqBesetq	เย​ลุบ​เบ​เซ้ด
lapqBaa	ลับ​บา
apgsaalom	อับ​ซา​โลม
yonaaDapg	โย​นา​ดับ
Baaanhaaso	บา​อัน​ฮา​โซ
TeKoaa	เท​โค​อา
itgTai	อิด​ไท
saajDokg	สา​โดก
aahimaaatg	อา​หิ​มา​อัด
aahiTofen	อา​หิ​โท​เฟน
husai	หุ​ไซ
soBi	โซ​บี
lokelim	โล​เก​ลิม
Baasinlai	บา​ซิน​ไล
Kimhaam	คิม​ฮาม
aamaasaaj	อา​มา​สา
Bikgli	บีก​ลี
ilaa	อิ​ละ
aiaa	ไอ​อา
litqpaa	ลิด​ปา
aanmoni	อาน​โม​นี
mehojlaa	เม​โห​ลา
aatglien	อาด​ลี​เอน
simehaa	ซี​เม​ฮา
Reng	เหฑ่น
Gcvg	แหฆ่ง
taub	เต้า
aahojhai	อา​โห​ไฮ
DoDo	โด​โด
haalaa	ฮา​ลา
aake	อา​เก
enhaanan	เอน​ฮา​นัน
haalotq	ฮา​โล้ด
eliKaa	เอ​ลี​คา
heletqTe	เฮ​เล้ด​เท
ikgKetg	อิก​เขด
aanaaTotq	อา​นา​โท้ด
husaa	หุ​ซา
meBunnai	เม​บุน​ไน
neTofaa	เน​โท​ฟา
maahaalai	มา​หะ​ไล
liBai	ลี​ไบ
kaaatg	กา​อัด
hitqDai	ฮิด​ได
aaBiyanBon	อา​บี​ยัน​โบน
Baahulim	บา​ฮู​ลิม
atgmaawetq	อัด​มา​เว้ด
saamaa	ซา​มา
Qaalaa	ชา​ลา
aahiyam	อา​หิ​ยัม
aahatgBai	อา​หัด​ไบ
kilon	กิ​โลน
hetqlo	เฮ้ด​โล
aalaapq	อา​ล้าบ
paalai	ปา​ไล
Baani	บา​นี
sejlekq	เส​เล้ก
naahaalai	นา​หะ​ไล
itglai	อิด​ไล
kaalepq	กา​เล้บ
uliyaa	อุ​ลี​ยา
yaase	ยา​เซ
taaTimhotgQi	ตา​ทิม​โหด​ชี
Danyaaan	ดัน​ยา​อัน
aalaaunaa	อา​ลาว​นา
ninb	นิ่น
weig	เหว่ย
aaBiQaakq	อา​บี​ช้าก
aasaaliyaa	อา​ซา​ลิ​ยา
BenDeKe	เบน​เด​เค
maaKaatq	มา​ค้าด
saaanBim	ซา​อัน​บิม
elonBetghaanan	เอ​โลน​เบด​ฮา​นัน
Benhesetg	เบน​เฮ​เสด
aalupqBotg	อา​ลุบ​โบด
sojKo	โส​โค
BenaaBinaaDapg	เบน​อา​บี​นา​ดับ
Taafatq	ทา​ฟัด
aahilutq	อา​หิ​ลู้ด
saajleTaan	สา​เล​ทาน
aaBenmeholaa	อา​เบน​เม​โฮ​ลา
yokqmeam	โย้ก​เม​อัม
itgDo	อิด​โด
aahinaaDapg	อา​หิ​นา​ดับ
Paaluaa	พา​ลู​อา
yehosaafatq	เย​โฮ​ซา​ฟัด
Jai	ไจ
hilaam	ฮี​ลาม
leBaanxn	เล​บา​นอน
aaDonilam	อา​โด​นี​ลัม
se	ซิบ
lxvj	หลอง
Tei	เทย
penq	เดี๋ยงเป๊น
halrub	หะโล่ว
taau	ตาว
lxvb	ล่อง
Ripq	ฑิบ
ywrnb	ย่วน
Bun	บุน
Tailaq	ไท​ละ
lovd	ล์ง
sevb	เซ่ง
Rxmg	หฑ่อม
Rxmg	เยี้ยน
sion	สิ​โอน
eTaanim	เอ​ทา​นิม
sig	สี่
nuvj	หนูง
leBohaamatq	เล​โบ​ฮา​มัด
kaalili	กา​ลิ​ลี
KaaBun	คา​บุน
iyipq	อี​ยิบ
Taapenetq	ทา​เป​เน้ด
kenuBatg	เก​นู​บัด
yeloBoam	เย​โล​โบ​อัม
lehojBoam	เล​โห​โบ​อัม
zyruq	โล์เฒี้ยว
aaBiyaa	อา​บี​ยา
Daavg	จาด่าง
naaaamaa	นา​อา​มา
sisakq	ซิ​ซัก
neBatg	เน​บัด
aaBiyam	อา​บี​ยัม
aaBiQaalom	อา​บี​ชา​โลม
aasaaj	อา​สา
BaaaaQaa	บา​อา​ชา
Eei	ทับ​ลิม​โมน
Eei	เฮ​ซี​โอน
BenhaaDatg	เบน​ฮา​ดัด
omli	โอม​ลี
kinatq	กี​นัด
Tipqni	ทิบ​นี
saamaalia	สะ​มา​เลีย
aahapg	อา​หับ
aaselaa	อา​เซ​ลา
KelitqTaa	เค​ลี้ด​ทา
Dog	โด๊ะ
eliyaa	เอ​ลี​ยา
oBaaDi	โอ​บา​ดี
yeseBen	เย​เซ​เบน
Kison	คี​โซน
nimsi	นิม​ซี
yehu	เย​ฮู
elisaa	เอ​ลี​ซา
haasaaen	ฮา​ซา​เอน
naaBotg	นา​โบด
maiq	ไม้
laamotqkileaatg	ลา​โม้ด​กิ​เล​อาด
imlaa	อิม​ลา
miKaayaa	มี​คา​ยา
aahatgyaa	อา​หัด​ยา
sinhi	ซิน​หิ
aasuBaa	อา​ซุ​บา
BaaanseBupg	บา​อัน​เซ​บูบ
yolam	โย​ลัม
yeholam	เย​โฮ​ลัม
saib	ไซเตี๋ย
oq	โอ๊
kehaasi	เก​หะ​ซี
tc	แต
tong	ต่น
Ziuq	ธิ้ว
teib	เต่ย
yolam	โย​ลัม
fai	ไฟ
sib	ซี่
aahapg	อา​หับ
Byaapq	บย๊าบ
BetgeKetg	เบด​เอ​เขด
yehonaaDapg	เย​โฮ​นา​ดับ
aannon	อาน​โนน
yehoaahaatg	เย​โฮ​อา​หาด
aaTaaliyaa	อา​ทา​ลิ​ยา
Kaali	คา​ลี
lwrnb	ล่วน
suje	สู​เอ
Baij	ไบ๋
siBiyaa	สิ​บี​ยา
tavb	ฌับ
Fiuq	ฌิ้ว
yehoaatg	เย​โฮ​อาด
aamaasiyaa	อา​มา​ซิ​ยา
Daau	ดาว
elatq	เอ​ลัด
sejKaaliyaa	เส​คา​ลิ​ยา
sanlum	ซัน​ลูม
utgsiyaa	อุด​ซี​ยา
kaaDi	กา​ดี
menaahem	เม​นา​เฮม
atgsilia	อัด​ซี​เลีย
pulaa	ปู​ลา
peKaahiyaa	เป​คา​หิ​ยา
lemaaliyaa	เล​มา​ลิ​ยา
peKaa	เป​คา
Tikqlatqpilesej	ทิก​ลัด​ปิ​เล​เส
iyon	อิ​โยน
aaBenBetgmaaaaKaa	อา​เบน​เบด​มา​อะ​คา
aahatg	อา​หัด
lesin	เล​ซิน
Kiaa	คี​อา
haalaaaa	ฮา​ลา​อา
haaBo	ฮา​โบ
kosaan	โก​ซาน
miDia	มี​เดีย
BaaBilon	บา​บี​โลน
sukgKotqBenotq	สุก​โค้ด​เบ​โน้ด
KuTaa	คู​ทา
nekan	เน​กัน
aasimaa	อา​ซิ​มา
apgwaa	อับ​วา
nipqhatg	นิบ​หัด
TaanTakq	ทาน​ทัก
sejfaanwaaim	เส​ฟาน​วา​อิม
atglammelekq	อัด​ลัม​เม​เล้ก
aanammelekq	อา​นัม​เม​เล้ก
heseKiyaa	เฮ​เซ​คี​ยา
scnmaanesej	แซน​มา​เน​เส
sennaaKelipq	เซน​นา​เค​ลิบ
isaayaa	อิ​สะ​ยา
aanpatg	อาน​ปัด
henaa	เฮ​นา
ipgwaa	อิบ​วา
opq	อ๊บ
BaalaaDan	บา​ลา​ดัน
meloDakgBaalaaDan	เม​โล​ดัก​บา​ลา​ดัน
hepqsiBaa	เฮ้บ​ซี​บา
Givj	หฆีง
aamon	อา​โมน
yosiyaa	โย​สิ​ยา
yeDiDaa	เย​ดี​ดา
aaDaayaa	อา​ดา​ยา
mesunlaam	เม​ซุน​ลาม
aasaalaiyaa	อา​ซา​ไล​ยา
saafaan	ซา​ฟาน
hinKiyaa	ฮิน​คี​ยา
aahiKam	อา​หิ​คัม
aasaajyaa	อา​สา​ยา
hunDaa	ฮุน​ดา
haanhatq	ฮาน​ฮัด
Tikqwaa	ที้ก​วา
Kitglon	ขิด​โลน
sin	ป๊วนซิน
Tofetq	โท​เฟ้ด
Benhinnom	เบน​ฮิน​โนม
faaloneKo	ฟา​โล​เน​โค
haamuTaan	ฮา​มุ​ทาน
yelemi	เย​เล​มี
lipqlaa	ลิบ​ลา
yehoyaaKim	เย​โฮ​ยา​คิม
sejBiDaa	เส​บิ​ดา
lumaa	ลู​มา
peDaayaa	เป​ดา​ยา
yehoyaaKin	เย​โฮ​ยา​คีน
nehutgTaa	เน​หุด​ทา
ennaaTan	เอน​นา​ทัน
sejDeKiyaa	เส​เด​คี​ยา
ewinmeloDakg	เอ​วิน​เม​โล​ดัก
aanwatq	อาน​วัด
sejme	เส​เม
apglaam	อับ​ลาม
matqsaaj	มัด​สา
zefi	เฒ​ฟี
kaaTaam	กา​ทาม
mitqsaa	มิด​ซา
anwaan	อัน​วาน
sefi	เซ​ฟี
hamlaan	ฮัม​ลาน
Binhaan	บิน​ฮาน
saajwaan	สา​วาน
yaaaaKaan	ยา​อา​คาน
matqleKaa	มัด​เล​คา
meheTaaBen	เม​เฮ​ทา​เบน
makqDien	มัก​ดี​เอน
ilaam	อิ​ลาม
peletq	เป​เล้ด
haamun	ฮา​มูน
eTaan	เอ​ทาน
hemaan	เฮ​มาน
KaanKo	คาน​โค
DaanDaa	ดาน​ดา
latqDai	ลัด​ได
osem	โอ​เซม
yeTe	เย​เท
yeliotg	เย​ลี​โอด
aanDon	อาน​โดน
sejkupg	เส​กุบ
KaalepqefaalaaTaa	คา​เล้บ​เอ​ฟา​ลา​ทา
atghu	อัด​ฮู
aaTaalaa	อา​ทา​ลา
sammai	ซัม​ไม
yaaDaa	ยา​ดา
aaBiQu	อา​บี​ชู
aaBihaain	อา​บี​ฮา​อิน
akgBaan	อัก​บาน
molitq	โม​ลิด
seleletq	เซ​เล​เล้ด
apgpaaim	อับ​ปา​อิม
itgi	อิด​อี
sesan	เซ​ซัน
akglai	อัก​ไล
yaalaahaa	ยา​ละ​ฮา
atgTai	อัด​ไท
saajBaatg	สา​บาด
efaan	เอ​ฟาน
eleaasaaj	เอ​เล​อา​สา
sisaamai	สิ​สะ​ไม
yeKaamiyaa	เย​คา​มิ​ยา
laaham	ลา​ฮัม
yolaaKeam	โย​ละ​เค​อัม
yaaDai	ยา​ได
kesaan	เก​ซาน
peletg	เป​เหลด
efaa	เอ​ฟา
saaapg	ซา​อับ
makqBenaa	มัก​เบ​นา
Qewaa	เช​วา
sanjmaa	สัน​มา
haaletq	ฮา​เล้ด
BetgkaaDe	เบด​กา​เด
puTai	ปุ​ไท
sumatq	ซู​มัด
mitqlaa	มิด​ลา
simeaa	ซิ​เม​อา
enpeletq	เอน​เป​เล้ด
nokaa	โน​กา
manKilaam	มัน​คี​ลาม
senaatqsaa	เซ​น้าด​ซา
hosaamaa	โฮ​ซา​มา
neDaaBiyaa	เน​ดา​บี​ยา
sejlupqBaaBen	เส​ลุบ​บา​เบน
haananyaa	ฮา​นัน​ยา
haasuBaa	ฮา​ซู​บา
ohen	โอ​เฮน
BeleKiyaa	เบ​เล​คิ​ยา
haasaajDiyaa	ฮา​สา​ดิ​ยา
yusapqhesetg	ยู​ซับ​เฮ​เสด
pelaaTiyaa	เป​ลา​ที​ยา
yesaayaa	เย​ซา​ยา
lefaiyaa	เล​ไฟ​ยา
aannan	อาน​นัน
seKaaniyaa	เซ​คา​นิ​ยา
semaiaa	เซ​ไม​อา
hatqTatq	ฮัด​ทัด
Baaliyaa	บา​ลี​ยา
neaaliyaa	เน​อา​ลี​ยา
elionai	เอ​ลี​โอ​ไน
atgliKam	อัด​ลี​คัม
hoDaawiyaa	โฮ​ดา​วิ​ยา
eliyaasipq	เอ​ลี​ยา​ซี้บ
pelaiyaa	เป​ไล​ยา
akgKupg	อัก​ขูบ
yohaanan	โย​ฮา​นัน
Delaiyaa	เด​ไล​ยา
aanaani	อา​นา​นี
leaayaa	เล​อา​ยา
yaahaatg	ยา​หาด
aahumai	อา​หุ​ไม
laahaatq	ลา​ฮ้าด
etaam	เอ​ตาม
itgmaa	อิด​มา
itgBaatg	อิด​บาด
hatqselenPoni	ฮัด​เซ​เลน​โพ​นี
helaa	เฮ​ลา
Zeeletq	เธ​เอ​เล้ด
etgnaan	เอด​นาน
suhaa	ซู​ฮา
mehi	เม​หิ
etgTon	เอด​โทน
Betglaafaa	เบด​ลา​ฟา
paasejaa	ปา​เส​อา
Tehinjnaa	เท​หิน​นา
leKaa	เล​คา
sejlaiaa	เส​ไล​อา
haaTaatq	ฮา​ท้าด
meonoTai	เม​โอ​โน​ไท
ilu	อิ​ลู
naaam	นา​อัม
yehaanlelen	เย​ฮาน​เล​เลน
sifaa	สิ​ฟา
Tiliyaa	ทิ​ลี​ยา
aasaajlen	อา​สา​เลน
etglaa	เอด​ลา
meletq	เม​เล้ด
efe	เอ​เฟ
Kenan	เค​นัน
maahaalaalen	มา​หะ​ลา​เลน
enokq	เอ​โน้ก
meTusejlaa	เม​ทู​เส​ลา
noyaa	โน​ยา
nimlotq	นิม​โล้ด
aalam	อา​ลัม
Qelaa	เช​ลา
isakg	อี​สัก
loTaan	โล​ทาน
Dison	ดี​โซน
haaDatg	ฮา​ดัด
meheTaaBen	เม​เฮ​ทา​เบน
yuDaa	ยู​ดา
amminaaDapg	อัม​มี​นา​ดับ
naason	นา​โซน
sanjmon	สัน​โมน
oBetg	โอ​เบด
sejluyaa	เส​ลุ​ยา
yeliotg	เย​ลี​โอด
uli	อุ​ลี
Jaai	จา​อี
atghu	อัด​ฮู
aaTaalaa	อา​ทา​ลา
aaBihaain	อา​บี​ฮา​อิน
itgi	อิด​อี
sesan	เซ​ซัน
yeTe	เย​เท
naaTan	นา​ทัน
efaan	เอ​ฟาน
yehu	เย​ฮู
heletqTe	เฮ​เล้ด​เท
sisaamai	สิ​สะ​ไม
yeKaamiyaa	เย​คา​มิ​ยา
laaham	ลา​ฮัม
maaon	มา​โอน
Daawitq	ดา​วิด
lehojBoam	เล​โห​โบ​อัม
aaBiyaa	อา​บี​ยา
aasaaj	อา​สา
aamaasiyaa	อา​มา​ซิ​ยา
aasaaliyaa	อา​ซา​ลิ​ยา
aahatg	อา​หัด
heseKiyaa	เฮ​เซ​คี​ยา
ammon	อัม​โมน
yehoyaaKin	เย​โฮ​ยา​คีน
sejlupqBaaBen	เส​ลุบ​บา​เบน
yesaayaa	เย​ซา​ยา
lefaiyaa	เล​ไฟ​ยา
aannan	อาน​นัน
oBaaDi	โอ​บา​ดี
seKaaniyaa	เซ​คา​นิ​ยา
semaiaa	เซ​ไม​อา
yaahaatg	ยา​หาด
mehi	เม​หิ
Tehinjnaa	เท​หิน​นา
yaalon	ยา​โลน
itgBaa	อิด​บา
BiTiyaa	บิ​ทิ​ยา
yeletq	เย​เล้ด
yeKuTien	เย​คู​ที​เอน
siqmon	ซิ​โมน
linnaa	ลิน​นา
Benhaanan	เบน​ฮา​นัน
Tilon	ทิ​โลน
sojhetg	โส​เหด
Bensohetq	เบน​โซ​เฮ้ด
maalesaa	มา​เล​ซา
laaaaDaa	ลา​อา​ดา
BetgatgBeaa	เบด​อัด​เบ​อา
neTaaim	เน​ทา​อิม
keDelaa	เก​เด​ลา
nemuen	เน​มู​เอน
yaalipq	ยา​ลี้บ
sanlum	ซัน​ลูม
mipqsamj	มิบ​สัม
mipqsamj	มิบ​สัม
hammuen	ฮัม​มู​เอน
hammuen	ฮัม​มู​เอน
sakgke	สัก​เก
Tolatq	โท​ลัด
haasaansujsimj	ฮา​ซาน​สู​สิม
BetgBili	เบด​บี​ลี
aayin	อา​ยิน
ToKen	โท​เคน
mesoBapg	เม​โซ​บับ
yamlekq	ยัม​เล้ก
yosaa	โย​ซา
yoen	โย​เอน
yosiBiyaa	โย​ซิ​บี​ยา
yosiBiyaa	โย​ซิ​บี​ยา
aasien	อา​สิ​เอน
aasien	อา​สิ​เอน
yaaaaKoBaa	ยา​อา​โค​บา
yesohaayaa	เย​โซ​ฮา​ยา
aaDien	อา​ดี​เอน
yesimien	เย​สิ​มี​เอน
zizaa	ฒี​ฒา
zizaa	ฒี​ฒา
sifi	ซิ​ฟี
sifi	ซิ​ฟี
anlon	อัน​โลน
anlon	อัน​โลน
yeDaayaa	เย​ดา​ยา
yeDaayaa	เย​ดา​ยา
simli	ซิม​ลี
simli	ซิม​ลี
miKaa	มี​คา
leaayaa	เล​อา​ยา
Beelaa	เบ​เอ​ลา
Beelaa	เบ​เอ​ลา
saafaam	ซา​ฟาม
yaanai	ยา​ไน
huli	หุ​ลี
huli	หุ​ลี
yaaloaa	ยา​โล​อา
yaaloaa	ยา​โล​อา
kileaatg	กิ​เล​อาด
miKaaen	มี​คา​เอน
yesisai	เย​ซิ​ไซ
yesisai	เย​ซิ​ไซ
yaaDo	ยา​โด
yaaDo	ยา​โด
Butg	บุด
apgDien	อับ​ดี​เอน
aahi	อา​หิ
noDapg	โน​ดับ
elien	เอ​ลี​เอน
yaaDien	ยา​ดี​เอน
finehatg	ฟี​เน​หัด
aaBiQuwaa	อา​บี​ชู​วา
BukgKi	บุก​คี
utgsi	อุด​ซี
sejlaahiyaa	เส​ลา​หิ​ยา
sejlaahiyaa	เส​ลา​หิ​ยา
melaayotq	เม​ลา​โย้ด
aamaaliyaa	อา​มา​ลิ​ยา
aamaaliyaa	อา​มา​ลิ​ยา
saajDokg	สา​โดก
hinKiyaa	ฮิน​คี​ยา
sejlaiaa	เส​ไล​อา
yehosaaDakg	เย​โฮ​ซา​ดัก
neBuKatqnetqsaa	เน​บู​คัด​เน้ด​ซา
simjmaa	สิม​มา
yoaa	โย​อา
yoaa	โย​อา
itgDo	อิด​โด
zelaa	เฒ​ลา
yeaaTelai	เย​อา​เท​ไล
enKaanaa	เอน​คา​นา
eBiyaasaapg	เอ​บี​ยา​สาบ
eBiyaasaapg	เอ​บี​ยา​สาบ
Taahatg	ทา​หัด
ulien	อุ​ลี​เอน
ulien	อุ​ลี​เอน
utgsiyaa	อุด​ซี​ยา
aahimotq	อา​หิ​โม้ด
sojfai	โส​ไฟ
sojfai	โส​ไฟ
eliapg	เอ​ลี​อับ
yeloham	เย​โล​ฮัม
yeloham	เย​โล​ฮัม
simeaa	ซิ​เม​อา
hakqkiyaa	ฮัก​กี​ยา
hakqkiyaa	ฮัก​กี​ยา
elien	เอ​ลี​เอน
Toaa	โท​อา
maahaatq	มา​ฮ้าด
maahaatq	มา​ฮ้าด
aamaasaij	อา​มา​ไส
yoen	โย​เอน
sejfanyaa	เส​ฟัน​ยา
atgsij	อัด​สี
itghaa	อิด​ฮา
Kohaatq	โค​ฮ้าด
lewi	เล​วี
aasaapg	อา​สาบ
aasaapg	อา​สาบ
BeleKiyaa	เบ​เล​คิ​ยา
Baaaasejyaa	บา​อา​เส​ยา
Baaaasejyaa	บา​อา​เส​ยา
manKiyaa	มัน​คิ​ยา
etgni	เอด​นี
etgni	เอด​นี
eTaan	เอ​ทาน
simjmaa	สิม​มา
keson	เก​โซน
Kisi	คี​ซี
Kisi	คี​ซี
apgDi	อับ​ดี
apgDi	อับ​ดี
manlukq	มัน​ลุก
haasaapiyaa	ฮา​ซา​ปิ​ยา
haasaapiyaa	ฮา​ซา​ปิ​ยา
amsi	อัม​ซี
amsi	อัม​ซี
Baani	บา​นี
Qeme	เช​เม
maali	มา​ลี
musi	มู​ซี
melaali	เม​ลา​ลี
utgsi	อุด​ซี
melaayotq	เม​ลา​โย้ด
hilen	ฮี​เลน
DaaBelatq	ดา​เบ​ลัด
maasaan	มา​ซาน
Puaa	พู​อา
yeDiyaaen	เย​ดี​ยา​เอน
yelimotq	เย​ลี​โม้ด
ili	อิ​ลี
sejmilaa	เส​มิ​ลา
yelemotq	เย​เล​โม้ด
aalemetq	อา​เล​เม้ด
Binhaan	บิน​ฮาน
Kenaaaanaa	เค​นา​อะ​นา
sejTaan	เส​ทาน
aahiQaahaa	อา​หิ​ชา​ฮา
hupgpim	หุบ​ปิม
supqpim	ซุบ​ปิม
sejlofehatg	เส​โล​เฟ​หัด
pelctq	เป​แล้ด
Qeletq	เช​เล้ด
pelctq	เป​แล้ด
ulaam	อุ​ลาม
laaKem	ลา​เคม
hammoleKetq	ฮัม​โม​เล​เค้ด
itghotq	อิด​โฮ้ด
aahiyan	อา​หิ​ยัน
likqhi	ลิก​ฮี
aaniyam	อา​นี​ยัม
Qeelaa	เช​เอ​ลา
utgsenQeelaa	อุด​เซน​เช​เอ​ลา
lefaa	เล​ฟา
lefaa	เล​ฟา
lesepq	เล​เซ้บ
lesepq	เล​เซ้บ
Telaa	เท​ลา
Taahan	ทา​ฮัน
laaDaan	ลา​ดาน
laaDaan	ลา​ดาน
ammihutq	อัม​มี​ฮู้ด
Binsaaitg	บิน​ซา​อิด
manKien	มัน​คี​เอน
yaafeletq	ยา​เฟ​เล้ด
some	โซ​เม
hoTaam	โฮ​ทาม
paasakg	ปา​สัก
Bimhaan	บิม​ฮาน
atgwaatq	อัด​ว้าด
lokaa	โล​กา
yehupqBaa	เย​ฮุบ​บา
helem	เฮ​เลม
sojfaa	โส​ฟา
Qeeletq	เช​เอ​เล้ด
aaman	อา​มัน
suaa	สุ​อา
haannefe	ฮาน​เน​เฟ
Beli	เบ​ลี
Bese	เบ​เซ
hotq	โฮ้ด
sinsaa	ซิน​ซา
pitgpaa	ปิด​ปา
aalaa	อา​ลา
unlaa	อุน​ลา
lisiaj	ลี​เสีย
nohaa	โน​ฮา
laafaa	ลา​ฟา
atgDaa	อัด​ดา
aaBihutq	อา​บี​ฮู้ด
aahojaa	อา​โห​อา
sefufaan	เซ​ฟู​ฟาน
hulaam	หุ​ลาม
kelaa	เก​ลา
saahaalaaim	ซา​หะ​ลา​อิม
Baaaalaaaa	บา​อา​ลา​อา
hoDetg	โฮ​เดด
siBia	สิ​เบีย
mesaa	เม​ซา
manKaam	มัน​คาม
yeutge	เย​อุด​เอ
saajKia	สา​เคีย
minmaa	มิน​มา
aaBiTupq	อา​บี​ทู้บ
enpaaan	เอน​ปา​อัน
aahiyo	อา​หิ​โย
saasakq	ซา​ซัก
sejBaaDiyaa	เส​บา​ดิ​ยา
eDe	เอ​เด
itgpaa	อิด​ปา
yohaa	โย​ฮา
hitqKi	ฮิด​คี
itgmelai	อิด​เม​ไล
isaaliyaa	อิ​สะ​ลิ​ยา
yaaKim	ยา​คิม
eliyenai	เอ​ลี​เย​ไน
sinjleTai	สิน​เล​ไท
Belaiaa	เบ​ไล​อา
simlaatq	ซิม​ล้าด
itgpaan	อิด​ปาน
haanan	ฮา​นัน
anToTiyaa	อัน​โท​ที​ยา
ipgDaiyaa	อิบ​ได​ยา
samselai	ซัม​เซ​ไล
sehaaliyaa	เซ​หะ​ลี​ยา
yaaaalesiyaa	ยา​อา​เล​ซี​ยา
yeien	เย​อี​เอน
sejKe	เส​เค
saulo	เซา​โล
etgBaaan	เอด​บา​อัน
melipqBaaan	เม​ลิบ​บา​อัน
melipqBaaan	เม​ลิบ​บา​อัน
piTon	ปิ​โทน
melekq	เม​เล้ก
Taalia	ทา​เลีย
yehoatgDaa	เย​โฮ​อัด​ดา
yehoatgDaa	เย​โฮ​อัด​ดา
simjli	สิม​ลี
Bineaa	บิ​เน​อา
Bineaa	บิ​เน​อา
laafaa	ลา​ฟา
eleaasaaj	เอ​เล​อา​สา
aasen	อา​เซน
BoKelu	โบ​เค​ลู
seaaliyaa	เซ​อา​ลิ​ยา
isaalaaen	อิ​สะ​ลา​เอน
yeuen	เย​อู​เอน
sanjlu	สัน​ลู
hoDaawiyaa	โฮ​ดา​วิ​ยา
hatgsejnuaa	หัด​เส​นู​อา
ipgneyaa	อิบ​เน​ยา
ipgneyaa	อิบ​เน​ยา
elaa	เอ​ลา
mikqli	มิก​ลี
mikqli	มิก​ลี
mesunlaam	เม​ซุน​ลาม
sefaaTiyaa	เซ​ฟา​ทิ​ยา
leuen	เล​อู​เอน
ipgniyaa	อิบ​นี​ยา
yehoyaalipq	เย​โฮ​ยา​ลิบ
aaDaayaa	อา​ดา​ยา
paatghe	ปาด​เฮ
paatghe	ปาด​เฮ
manKiyaa	มัน​คิ​ยา
maaaasaij	มะ​อา​ไส
maaaasaij	มะ​อา​ไส
aaDien	อา​ดี​เอน
yaaselaa	ยา​เซ​ลา
yaaselaa	ยา​เซ​ลา
mesinlemitq	เม​ซิน​เล​มิด
mesinlemitq	เม​ซิน​เล​มิด
imme	อิม​เม
BakgBakgKaa	บัก​บัก​คา
heletqsej	เฮ​เล้ด​เส
kaalaan	กา​ลาน
matqTaaniyaa	มัด​ทา​นิ​ยา
sikgli	สิก​ลี
kaalaan	กา​ลาน
yeDuTun	เย​ดู​ทูน
yeDuTun	เย​ดู​ทูน
yeien	เย​อี​เอน
mikqlotq	มิก​โล้ด
yaalaa	ยา​ลา
yaalaa	ยา​ลา
yeButg	เย​บุด
patgDammim	ปัด​ดัม​มิม
Deig	เด่ย
sammotq	ซัม​โม้ด
pelon	เป​โลน
sipgBeKai	สิบ​เบ​ไค
ilai	อิ​ไล
iTai	อิ​ไท
hulai	หุ​ไล
aanBaa	อาน​บา
saaanBon	ซา​อัน​โบน
eliyaaBaa	เอ​ลี​ยา​บา
kimso	กิม​โซ
haasem	ฮา​เซม
saaki	ซา​กี
saajKaa	สา​คา
uaa	อู​อา
elifan	เอ​ลี​ฟัน
meKelaa	เม​เค​ลา
etgBai	เอด​ไบ
naaaalai	นา​อา​ไล
haaki	ฮา​กี
mipqhaa	มิบ​ฮา
itglai	อิด​ไล
sisaaaa	ซิ​ซา​อา
aaDinaa	อา​ดี​นา
mitqne	มิด​เน
yosaafatq	โย​ซา​ฟัด
Tisai	ทิ​ไซ
maahaawai	มา​หะ​ไว
ennaaam	เอน​นา​อัม
yeliBai	เย​ลี​ไบ
yosaawiyaa	โย​ซา​วิ​ยา
mesoBai	เม​โซ​ไบ
yaaaasien	ยา​อา​ซี​เอน
semaaaa	เซ​มา​อา
yesien	เย​ซี​เอน
Peletg	เพ​เหลด
BelaaKaa	เบ​ลา​คา
elusai	เอ​ลู​ไซ
Beanyaa	เบ​อัน​ยา
semaaliyaa	เซ​มา​ลิ​ยา
haalupq	ฮา​ลู้บ
itgsiyaa	อิด​ซี​ยา
aasaalen	อา​ซา​เลน
yoese	โย​เอ​เซ
yaasoBeam	ยา​โซ​เบ​อัม
yoelaa	โย​เอ​ลา
mitqmannaa	มิด​มัน​นา
ensaaBaatg	เอน​ซา​บาด
makqBannai	มัก​บัน​ไน
KiDon	คิ​โดน
Kaaq	ค้า
suv	ควัด
puad	อุด​ซา
pyauq	โอ​เบด​เอ​โดม
BeenyaaDaa	เบ​เอน​ยา​ดา
Kenaaniyaa	เค​นา​นี​ยา
Rwrnj	หฑวน
aaBiQai	อา​บี​ไช
silia	ซี​เลีย
saataan	ซา​ตาน
namj	หนัม
Jyen	เจียน
selomotq	เซ​โล​โม้ด
haasien	ฮา​ซี​เอน
kesom	เก​โซม
haalim	ฮา​ลิม
sejolim	เส​โอ​ลิม
miyaamin	มิ​ยา​มิน
hakqKotg	ฮัก​โขด
yesuaa	เย​ซู​อา
hupgpaa	หุบ​ปา
yeseBeapg	เย​เซ​เบ​อับ
Binkaa	บิน​กา
hesi	เฮ​ซี
hapgpitgsetq	หับ​ปิด​เซ้ด
peTaahiyaa	เป​ทา​หิ​ยา
yeheseKen	เย​เฮ​เซ​เคน
kaamun	กา​มุน
maaaasiyaa	มา​อา​ซิ​ยา
yaaaasiyaa	ยา​อา​ซี​ยา
Beno	เบ​โน
keDaaliyaa	เก​ดา​ลิ​ยา
yesaayaa	เส​ลี
yeDuTun	มัด​ที​ทิ​ยา
BukgKiyaa	บุก​คี​ยา
seBuen	เซ​บู​เอน
haanaani	ฮา​นา​นี
eliyaaTaa	เอ​ลี​ยา​ทา
kitgDaanTi	กิด​ดาน​ที
lomamTiese	โล​มัม​ที​เอ​เซ
yotqBeKaasaa	โย้ด​เบ​คา​ซา
manloTi	มัน​โล​ที
hoTi	โฮ​ที
maahaasiotg	มา​หะ​ซิ​โอด
yehohaanan	เย​โฮ​ฮา​นัน
elihonai	เอ​ลี​โฮ​ไน
peunleTai	เป​อุน​เล​ไท
hosaaj	โฮ​สา
sanleKetq	ซัน​เล​เค้ด
kwanb	กวั้น
ye	เย​ฮี​เอ​ลี
yoen	เส​ทาม
yeliyaa	เย​ลี​ยา
txij	ต๋อย
Havj	หฮญัง
sapgDien	สับ​ดี​เอน
isaalaa	อิ​สะ​ลา
samhutg	ซัม​หุด
henDai	เฮน​ได
elihu	เอ​ลี​ฮู
itgmaiaa	อิด​ไม​อา
Kelupq	เค​ลู้บ
esaali	เอ​สะ​ลี
sefaam	เซ​ฟาม
avung	อะหงุ่น
oBin	โอ​บิน
melonotq	เม​โล​โน้ด
aanKi	อาน​คี
saalomxn	ซา​โล​มอน
aq	อ๊ะ
luvd	ลู์ง
Tailaq	ไท​ละ
yapqfaa	ยับ​ฟา
KeluBim	เค​ลู​บิม
yetg	เหยียด
yav	ยัง
yav	ยัง
KeluBim	เค​ลู​บิม
puv	ปูง
toj	โต๋
Tiv	ทีง
lovd	ล์ง
punb	ปุ้น
saalomxn	ซา​โล​มอน
Paavb	พ่าง
Paavb	พ่าง
Paavb	พ่าง
isaalaaen	อิ​สะ​ลา​เอน
haamatqsojBaa	ฮา​มัด​โส​บา
Betgholon	เบด​โฮ​โลน
saalomxn	ซา​โล​มอน
seKem	เซ​เคม
yeloBoam	เย​โล​โบ​อัม
lehojBoam	เล​โห​โบ​อัม
aaDolaaim	อา​โด​ลา​อิม
maahaalatq	มา​หะ​ลัด
maahaalatq	มา​หะ​ลัด
maahaalatq	มา​หะ​ลัด
saajham	สา​ฮัม
maaaaKaa	มา​อา​คา
atqTai	อั๊ด​ไท
yelusaalem	เย​ลู​ซา​เลม
yuDaa	ยู​ดา
sejfaaTaa	เส​ฟา​ทา
oDetg	โอ​เดด
pwavq	ปวั๊ง
tia	เตีย
BaaaaQaa	บา​อา​ชา
yehosaafatq	เย​โฮ​ซา​ฟัด
neTaaniyaa	เน​ทา​นิ​ยา
semilaamotq	เซ​มิ​ลา​โม้ด
yehonaaTan	เย​โฮ​นา​ทัน
ToBiyaa	โท​บี​ยา
TopqaaDoniyaa	โท้บ​อา​โด​นิ​ยา
yehosaaBaatg	เย​โฮ​ซา​บาด
aahapg	อา​หับ
laamotqkileaatg	ลา​โม้ด​กิ​เล​อาด
pcg	แปะ
’	’
meuni	เม​อู​นี
txvj	เซียงต๋อง
yaahaasien	ยา​ฮา​ซี​เอน
se	ยา​ฮา​ซี​เอน
se	เส​คา​ลิ​ยา
se	เบ​ไน​ยา
tuvq	ตู๋ง
aahatgyaa	อา​หัด​ยา
yeholam	เย​โฮ​ลัม
yehien	เย​ฮี​เอน
aasaaliyaahu	อา​ซา​ลี​ยา​ฮู
yeholam	เย​โฮ​ลัม
eTiopia	เอ​ที​โอ​เปีย
yeholam	เย​โฮ​ลัม
aahapg	อา​หับ
yolam	โย​ลัม
yolam	โย​ลัม
yehu	เย​ฮู
kruq	โก๊ว
yehoyaaDaa	เย​โฮ​ยา​ดา
huvb	ฮู่ง
simeatg	ซิ​เม​อัด
simlitq	ซิม​ลิด
laavb	ล่าง
yehoaatg	เย​โฮ​อาด
yehoaatg	เย​โฮ​อาด
aamaasiyaa	อา​มา​ซิ​ยา
laaKitq	ลา​คี้ด
yeKoliyaa	เย​โค​ลี​ยา
yapqne	ยับ​เน
zivb	ฒี่ง
filisaatia	ฟี​ลิ​สะ​เตีย
kuaaBaaan	กู​อา​บา​อัน
utgsiyaa	อุด​ซี​ยา
aamxtq	อา​ม้อด
ofen	โอ​เฟน
Tovq	ท้ง
yoTaam	โย​ทาม
maaaasejaa	มา​อา​เส​อา
mesinlemotq	เม​ซิน​เล​โม้ด
yehitqKiyaa	เย​ฮิด​คี​ยา
hatglai	หัด​ไล
paauj	ป๋าว
Ratg	หฑัด
tiaj	เตี๋ย
Konaaniyaa	โค​นา​นิ​ยา
Kole	โค​เล
kanaaiq	กะน้าย
sennaaKelipq	เซน​นา​เค​ลิบ
Diaq	ปั์วเดี๊ย
heseKiyaa	เฮ​เซ​คี​ยา
Zamq	ธั้ม
Mmd	ฮม์
maanatqsej	มะ​นัด​เส
aamon	อา​โมน
Win	ฮวิน
zxg	หฒ่อ
txvj	ต๋อง
txvj	ต๋อง
haasaaBiyaa	ฮา​ซา​บี​ยา
yosaaBaatg	โย​ซา​บาด
yuvb	ยู่ง
neKo	เน​โค
KaanKemitq	คาน​เค​มิด
yoaahaatg	โย​อา​หาด
yelemi	เย​เล​มี
pesia	เป​เซีย
sailatq	ไซ​ลัด
makqBitg	มัก​บีด
lotg	โหลด
haaDitg	ฮา​ดิด
ono	โอ​โน
sejnaaaa	เส​นา​อา
aanTaasesitq	อาน​ทา​เซ​ซี้ด
Bitglaam	บิด​ลาม
mitqleDaatg	มิด​เล​ดาด
TaaBeen	ทา​เบ​เอน
aanTaasesitq	อาน​ทา​เซ​ซี้ด
aanTaasesitq	อาน​ทา​เซ​ซี้ด
Daaliatg	ดา​ลิ​อัด
ekgBaaTaanaa	เอก​บา​ทา​นา
hakqkai	ฮัก​ไก
yiuTai	ยิว​ไท
aahiTupq	อา​หิ​ทู้บ
maalaayotq	มา​ลา​โย้ด
aaBiQuwaa	อา​บี​ชู​วา
eleaasaa	เอ​เล​อา​ซา
esaalaa	เอ​สะ​ลา
kxvg	ก่อง
aahaawaa	อา​หะ​วา
tomb	ลุย
hev	เฮง
esaalaa	เอ​สะ​ลา
esaalaa	เอ​สะ​ลา
yaasaiaa	ยา​ไซ​อา
sapqBeTai	ซับ​เบ​ไท
Kelaayaa	เค​ลา​ยา
KeliTaa	เค​ลิ​ทา
BeDaiyaa	เบ​ได​ยา
Keluhi	เค​ลุ​ฮี
waaniyaa	วา​นิ​ยา
melemotq	เม​เล​โม้ด
matqTenai	มัด​เท​ไน
yaaaasu	ยา​อา​สุ
selemiyaa	เซ​เล​มิ​ยา
makqnaaDeBai	มัก​นา​เด​ไบ
saasai	ซา​ไซ
saalai	ซา​ไล
selemiyaa	เซ​เล​มิ​ยา
haaKaaliyaa	ฮา​คา​ลิ​ยา
nehaami	เน​หะ​มี
Kitqlepq	คิด​เล้บ
susaaj	สุ​สา
Namq	ฮนั้ม
nisaanj	นิ​สาน
sanjBaanlatq	สัน​บาน​ลัด
ToBiaa	โท​บี​อา
kesem	เก​เซม
imli	อิม​ลี
mesesaaBen	เม​เซ​ซา​เบน
yoyaaDaa	โย​ยา​ดา
BesojDaiaa	เบ​โส​ได​อา
yesaanaa	เย​ซา​นา
sxn	ซอน
haalumapq	ฮา​ลุ​มับ
haasapqneyaa	ฮา​ซับ​เน​ยา
paahatgmoapg	ปา​หัด​โม​อับ
hatgsupq	หัด​ซู้บ
hanlohetg	ฮัน​โล​เหด
lehum	เล​ฮูม
sapgBai	สับ​ไบ
Baalukq	บา​ลุก
hatgsupq	หัด​ซู้บ
aanaaniyaa	อา​นา​นี​ยา
henaaDatg	เฮ​นา​ดัด
Binnwi	บิน​นุย
usai	อุ​ไซ
paalaan	ปา​ลาน
paalotq	ปา​โล้ด
saajlaapq	สา​ล้าบ
laanb	ล่าน
ToBiaa	โท​บี​อา
noatgyaa	โน​อัด​ยา
yrug	โหย่ว
laaaamiaa	ลา​อา​มี​อา
naahaamaani	นา​หะ​มา​นี
moDeKai	โม​เด​ไค
Binsaan	บิน​ซาน
mitqpeletq	มิด​เป​เล้ด
Bikgwai	บิก​ไว
nehum	เน​ฮูม
Betgatgmaawetq	เบด​อัด​มา​เว้ด
Jxib	จ้อย
Katgmien	ขัด​มี​เอน
QeBaaniyaa	เช​บา​นี​ยา
Bunni	บุน​นี
selepiyaa	เซ​เล​ปี​ยา
Kenaani	เค​นา​นี
Katgmien	ขัด​มี​เอน
selepiyaa	เซ​เล​ปี​ยา
hoDiyaa	โฮ​ดี​ยา
QeBaaniyaa	เช​บา​นี​ยา
ken	เกน
Kxiq	ค้อย
Daanien	ดา​นี​เอน
kinneTon	กิน​เน​โทน
Binkai	บิน​ไก
Beninu	เบ​นิ​นู
patglotq	ปัด​โล้ด
satgTu	สัด​ทู
atgkaatg	อัด​กาด
BeBai	เบ​ไบ
aaDin	อา​ดีน
aaTe	อา​เท
haasum	ฮา​ซูม
Besai	เบ​ไซ
haalipq	ฮา​ลิบ
neBai	เน​ไบ
makqBiaatg	มัก​บี​อาด
yaatqDuwaa	ย้าด​ดู​วา
aanaayaa	อา​นา​ยา
pinhaaj	ปิน​หา
soBekg	โซ​เบก
haasapqnaa	ฮา​ซับ​นา
aahiaa	อา​หิ​อา
aanan	อา​นัน
kapgBai	กับ​ไบ
sanjlai	สัน​ไล
yoyaalipq	โย​ยา​ลิบ
atgliKam	อัด​ลี​คัม
sapgDi	สับ​ดี
BakgBuKiyaa	บัก​บู​คิ​ยา
apgDaa	อับ​ดา
sijhag	สี​หะ
kitgpaa	กิด​ปา
BetgPeletg	เบด​เพ​เหลด
enlimmon	เอน​ลิม​โมน
sejBoim	เส​โบ​อิม
neBanlatq	เน​บัน​ลัด
seanTien	เซ​อัน​ทิ​เอน
kinneTxi	กิน​เน​ทอย
maaaaDiyaa	มา​อา​ดี​ยา
yoyaaKim	โย​ยา​คิม
yoyaaKim	โย​ยา​คิม
eliyaasipq	เอ​ลี​ยา​ซี้บ
yoyaaDaa	โย​ยา​ดา
yonaaTaan	โย​นา​ทาน
yoyaaKim	โย​ยา​คิม
melaayaa	เม​ลา​ยา
manluKi	มัน​ลู​คี
henKaai	เฮน​คาย
minyaamin	มิน​ยา​มิน
moatgyaa	โม​อัด​ยา
pinTai	ปิน​ไท
Kaanlai	คาน​ไล
aamokq	อา​โม้ก
Tanmon	ทัน​โมน
Betgkinkaan	เบด​กิน​กาน
hosaayaa	โฮ​ซา​ยา
matqTaaniyaa	มัด​ทา​นิ​ยา
miKaayaa	มี​คา​ยา
eliyaaKim	เอ​ลี​ยา​คิม
minyaamin	มิน​ยา​มิน
yitqsaalaayaa	ยิด​สะ​ลา​ยา
atgDotg	อัด​โดด
aahaasuelatq	อา​หะ​สุ​เอ​ลัด
inDia	อิน​เดีย
aahaasuelatq	อา​หะ​สุ​เอ​ลัด
susaaj	สุ​สา
yinb	ยิ่น
watqQaaTi	วัด​ชา​ที
aahaasuelatq	อา​หะ​สุ​เอ​ลัด
yinb	ยิ่น
watqQaaTi	วัด​ชา​ที
Kaansenaa	คาน​เซ​นา
QeTaa	เช​ทา
atgmaaTaa	อัด​มา​ทา
maansejnaa	มาน​เส​นา
memuKaan	เม​มู​คาน
pesia	เป​เซีย
haag	ห่า
memuKaan	เม​มู​คาน
watqQaaTi	วัด​ชา​ที
yeKoniyaa	เย​โค​นี​ยา
moDeKai	โม​เด​ไค
eseTe	เอ​เซ​เท
hekai	เฮ​ไก
eseTe	เอ​เซ​เท
eseTe	เอ​เซ​เท
TeBetq	เท​เบ๊ด
eseTe	เอ​เซ​เท
eseTe	เอ​เซ​เท
eseTe	เอ​เซ​เท
eseTe	เอ​เซ​เท
eseTe	เอ​เซ​เท
moDeKai	โม​เด​ไค
BikgTaan	บิก​ทาน
Teletq	เท​เล้ด
eseTe	เอ​เซ​เท
eseTe	เอ​เซ​เท
Diuj	ดิ๋ว
haamaan	ฮา​มาน
haamaan	ฮา​มาน
puaa	ปู​อา
lamd	ลั์ม
haamaan	ฮา​มาน
haaTaakq	ฮา​ท้าก
haaTaakq	ฮา​ท้าก
haaTaakq	ฮา​ท้าก
pua	ปัว
Zinb	ธิ่น
BikgTaanaa	บิก​ทา​นา
paanQanDaaTaa	ปาน​ชัน​ดา​ทา
Daanfon	ดาน​โฟน
atgpaaTaa	อัด​ปา​ทา
polaaTaa	โป​ลา​ทา
aaDanyaa	อา​ดัน​ยา
aaliDaaTaa	อา​ลี​ดา​ทา
paanmatqTaa	ปาน​มัด​ทา
aalisaij	อา​ลี​ไส
aaliDai	อา​ลี​ได
waisaaTaa	ไว​ซา​ทา
pulim	ปู​ลิม
pulim	ปู​ลิม
KenDia	เคน​เดีย
siag	เสี่ย
mapq	มับ
zyruj	เหฒียว
lewiaaTaan	เล​วี​อา​ทาน
henb	เฮ่น
syenb	เซี่ยน
Pxj	ผอ
Waaj	หฮวา
Gapg	หฆับ
Lyenj	เหฮลียน
mitg	หมิด
yia’	เยีย’
Rwid	ฑุ์ย
yia’	เยีย’
Laaj	หฮลา
mwrnd	ม์วน
kob	โก้
Quwaa	ชู​วา
BinDatg	บิน​ดัด
lwavb	ลวั่ง
lrug	โหล่ว
syepq	เซี้ยบ
zimb	ฒิ่ม
naaaame	นา​อา​เม
Truj	โถว
suv	ซูง
suj	สู
haavb	ฮ่าง
pyob	โปย้
pyob	โปย้
syeng	เสี่ยน
wrtq	ว้วด
kwcq	แกว๊ะ
Rung	หฑุ่น
Zyen	เธียน
hxig	ห่อย
fapq	ฟับ
liaq	เลี้ย
Fxm	ฌอม
naanb	น่าน
mag	หมะ
Biaq	เบี๊ยะ
wavg	หวั่ง
kwenj	เกว๋น
Lxq	ฮล้อ
Eaab	ญ่า
Beu	เบว
Beu	เบว
Gxq	เฆาะ
yia	เยีย
koj	โก๋
elihu	เอ​ลี​ฮู
zweib	เฒว่ย
waag’	หว่า’
soq	โซะ
yemb	เยี่ยม
aauj	อ๋าว
Dang	ดั่น
Matq	ฮมัด
Lopq	ฮลบ
paamd	ป์าม
syrug	เสี่ยว
yend	เยี์ยน
tog	โต่
hxpg’	หอบ’
Balivg	บะหลี่ง
kwinb	กวิ้น
kwinb	กวิ้น
kivj	กี๋ง
mwavb	มวั่ง
lamd	ลั์ม
naaiq’	น้าย’
Komq	ค้ม
Daug	เด่า
Zaaiq	ธ้าย
Eaaiq	ญ้าย
Behemotq	เบ​เฮ​โม้ด
tiuj	ติ๋ว
Zutq	ธุด
selaa	เซ​ลา
selaa	เซ​ลา
txb	ตอเหฒี่ย
Zyenb	เธี่ยน
tob	โต้
zxij	หฒอย
waag	หว่า
lrub	โล่ว
zaauj	หฒาว
Taanj	ถาน
zuaq	ฒัวะ
Ewrnb	ญ่วน
liud	ลิ์ว
zua	ฒัว
Wavj	หฮวัง
pcvj	แป๋ง
kruj	โก๋ว
zyavb	เฒี่ยง
myenb	ฒุ์ยเมี่ยน
Zxvb	ธ่อง
naang	หน่าน
wrtq	ว้วด
leBaanxn	เล​บา​นอน
Diub	ดิ้ว
silion	ซี​ลี​โอน
yemj	เหยียม
finj	ฝิน
xq	เอ๊าะ
tonj	ตั๋งต๋น
haaq	ฮ้า
haaq	ฮ้า
haaq	ฮ้า
haaq	ฮ้า
misaa	มิ​ซา
myend	เมี์ยน
patq	ปั๊ด
tunj	ตุ๋น
Qavq	ชั้ง
Jiaj	เจี๋ย
laig	ไหล่
Eyemd	เญี์ยม
Dang	ดั่น
nyruq	เนี้ยว
Ryruj	เหฑียว
haig	ไห่
sinj	สิน
Eiaj	เหญีย
Lopq	ฮลบ
Jutq	จุ๊ด
Zauj	เหธา
Ewrtq	ญ้วด
Byaaud	บย์าว
maad	ม์า
Beuj	เบ๋ว
pxg	เปาะ
cvq	แอ๊ง
Ria	เฑีย
keBaan	เก​บาน
pwrnj	ป๋วน
olepq	โอ​เล้บ
sejepg	เส​เอบ
saanjmunnaa	สาน​มุน​นา
Bahinj	บะหิน
Tib	ที่
aamen	อา​เมน
Beij	เบ๋ย
paaiq	ป๊าย
Nam	ฮนัม
laavg	ววมหล่าง
Bang	บั่น
Diaq	เดี๊ย
ming	หมิ่น
pyopg	ปยบ
Eiab	เญี่ย
Eyenj	เหญียน
zyenb	เฒี่ยน
Gaatq	ฆ้าด
laib	ไล่
menKiseDekg	เมน​คี​เซ​เดก
JxDcn	จอ​แดน
Daaletq	ดา​เล้ด
he	เฮ
waau	วาว
laametq	ลา​เม้ด
Pe	เพ
Kopq	คบ
letq	เล้ด
taVatq	ตะฮงัด
taVatq	ตะฮงัด
Biud	บิ์ว
kaatq	ก๊าด
yaaKopq	ยา​โค้บ
efaaTaa	เอ​ฟา​ทา
yaaaa	ยา​อา
Rxv	ฑอง
Qiaj	ซีงเฉีย
Zyepq	เธี้ยบ
pwrng	ฟุป่วน
Bov	บง
mun	มุน
Wrtq	ฮว้วด
yaapq	ย้าบ
heiq	เฮ้ย
Faauj	ก๊องหฌาว
yrub	โย่ว
wakq	วัก
Qopq	ชบ
Eapg	หญับ
nuq	นุ
Eaavg	หญ่าง
laan	ลาน
lyaa	ลยา
lxd	ล์อ
Dyepq	เดี๊ยบ
Fruj	เหฌียว
lom	ลม
zotq	ฒด
tiq	ตี๊
Jomg	จ่ม
fitq	ฟิด
fitq	ฟิด
Taaib	ท่าย
Eaanb	ญ่าน
lxg	เหลาะ
Vovj	หฮงง
Vovj	หฮงง
naapg	หนาบ
Kxi	คอย
Byenq	เบี๊ยน
tavq	ตั๊ง
Kxq	เคาะ
taKomq	ตะค้ม
taJwib	ตะจุ้ย
yaaKe	ยา​เค
aaku	อา​กู
iTien	อิ​ที​เอน
iTien	อิ​ที​เอน
uKaan	อู​คาน
lemuen	เล​มู​เอน
mwavj	หมวัง
syav	เซียง
Eei	เญย
Eau	เญา
saauj	สาว
lcvd	แล์ง
xq	เอ๊าะ
naav	นาง
Daav	ดาง
saalon	ซา​โลน
Janb	จั๋น
mwavd	มวั์ง
hxg	เหาะ
hxg	เหาะ
Jiug	จิ่ว
Jiug	จิ่ว
pweig	เปว่ย
Wrn	ฮววน
Baiq	ไบ๊
fei	เฟย
anman	อัน​มัน
Eweid	เญว์ย
sulem	ซู​เลม
sulem	ซู​เลม
Gxi	ฆอย
Bcvj	หละเปย๊ยแบ๋ง
txvb	สี่ต้อง
Zyruq	ปี๋งเธี้ยว
Rov	ฑง
Waav	เปย๊าฮวาง
kaam	กาม
mxvd	ม์อง
tomb	ววมต้ม
zwrnj	หฒวน
neij	เหนย
lemaaliyaa	เล​มา​ลิ​ยา
Daamatqkatg	ดา​มัด​กัด
muvd	ฟิ้ว
mweid	ฟิ้ว
maahesaalaanhatgBatg’	มา​เฮ​ซา​ลาน​หัด​บัด’
maa’	มา’
nxmb	ตาวน่อม
efaaim	เอ​ฟา​อิม
Kaanno	คาน​โน
vaaid	แป่งง์าย
Donj	เดี๋ยงด๋น
aiyaatq	ไอ​ย้าด
matqmenaa	มัด​เม​นา
keBim	เก​บิม
BaaBilon	บา​บี​โลน
moapg	โม​อับ
aan	อาน
moapg	โม​อับ
ekglaaim	เอก​ลา​อิม
Beeelim	เบ​เอ​เอ​ลิม
Kinhaalesetq	คีน​หะ​เล​เซ้ด
txq	ต๊อ
naiaa	ไน​อา
Batg	บัด
iyipq	อี​ยิบ
atgsilia	อัด​ซี​เลีย
Ywavb	ฮยวังเฮยี้ยน
myenb	หม่าย
txij	ต๋อย
sepqnaa	เซ้บ​นา
Naavj	ไลหฮนาง
lewiaaTaan	เล​วี​อา​ทาน
aalien	อา​ลี​เอน
aalien	อา​ลี​เอน
zipq	ฒิบ
Bxvj	บ๋อง
sru	โซว
lavopq	หละงบ
naanj	หนาน
Jiaq	หฑยาวเจี๊ยะ
sion	สิ​โอน
alanb	อะลั่น
Kub	คู่
Rwei	เฑวย
Fung	หฌุ่น
kuaq	กั๊วะ
isaayaa	อิ​สะ​ยา
Tei	เทย
Duv	ดูง
saipatg	ไซ​ปัด
lomg	หล่ม
huaj	หัว
Gwin	ฆวิน
pcg	แปะๆ
lo	โล
kug	กุ
Eim	ญิม
leib	เล่ย
Zauj	ฟาน​เกน​เซน
tiq	ตี๊
Jxib	เปี๊ยวจ้อย
pyruq	เปี๊ยว
Eanb	ญั่นๆ
Riab	เฑียววม
lovg	สะบู
zyenb’	เฒี่ยน’
saau	ซาว
lyrud	เลี์ยว
Pitq	พิด
aq’	อ๊ะ’
kcv	โล์แกง
Zwi	ธุย
Yenj	เหฮยียน
lyemb	เลี่ยม
yufetitg	ยู​เฟ​ติด
Damaaub	ดะม่าว
zunj	หฒุน
nin	นิน
nia	เนีย
Baaan	บา​อัน
halrub	เนียหะโล่ว
puab	กับ
zauj	ปั์วเหฒา
kapg	กับ
aq	อ๊ะโล่ะ
manKiaa	มัน​คี​อา
yosiyaa	โย​สิ​ยา
sijDaa	สี​ดา
pyopq	ปย๊บ
kwaatq	กว๊าด
kanaaiq’	กะน้าย’
atgKelon	อัด​เค​โลน
zwavj	หฒวัง
uliaa	อุ​ลี​อา
elaasaa	เอ​ลา​ซา
kemaaliyaa	เก​มา​ลิ​ยา
Kolaayaa	โค​ลา​ยา
nehelaam	เน​เฮ​ลาม
sejfanyaa	เส​ฟัน​ยา
nehelaam	เน​เฮ​ลาม
zutg	หฒุด
puvb	ปู๋งหฒัวะ
Faauj	หฌาว
koaa	โก​อา
sejDeKiyaa	เส​เด​คี​ยา
KenDia	เคน​เดีย
ikgDaaliyaa	อิก​ดา​ลิ​ยา
Qovj	ฉง
neliyaa	เน​ลิ​ยา
Baalukq	บา​ลุก
kxg	เก๊าะเมี่ยน
Baalukq	บา​ลุก
Baalukq	บา​ลุก
matg	หมัด
Baalukq	บา​ลุก
Koniyaa	โค​นิ​ยา
yehuKan	เย​ฮู​คัน
Benyaamin	เบน​ยา​มิน
iliyaa	อิ​ลี​ยา
matqTaan	มัด​ทาน
eBetgmelekq	เอ​เบด​เม​เล้ก
eBetgmelekq	เอ​เบด​เม​เล้ก
eBetgmelekq	เอ​เบด​เม​เล้ก
yelemi	เย​เล​มี
nekansaalese	เน​กัน​ซา​เล​เซ
samjkaaneBo	สัม​กา​เน​โบ
saanjsejKim	สาน​เส​คิม
nekansaalese	เน​กัน​ซา​เล​เซ
puaq	ปั๊ว
Kaaleaa	คา​เล​อา
Tanhumetq	ทัน​หุ​เม้ด
efaai	เอ​ฟาย
yesanyaa	เย​ซัน​ยา
Kaaleaa	คา​เล​อา
keDaaliyaa	เก​ดา​ลิ​ยา
ping	ปิ่น
Taapaanhetg	ทา​ปาน​เหด
Taapaanhetg	ทา​ปาน​เหด
panaib	ปะไน่
Ryavg	เหฑี่ยง
memfitq	เมม​ฟิด
aapitg	อา​ปิด
Lyruq	เฮลี้ยว
Zauj	อัด​เค​โลน
KiliyaaTaaim	คี​ลิ​ยา​ทา​อิม
matqmen	มัด​เมน
luhitg	ลู​หิด
holonaaim	โฮ​โล​นา​อิม
Kemotq	เค​โม้ด
DiBon	ดี​โบน
BetgDipglaaTaaim	เบด​ดิบ​ลา​ทา​อิม
KiliyaaTaaim	คี​ลิ​ยา​ทา​อิม
Betgkaamun	เบด​กา​มุน
Betgmeon	เบด​เม​โอน
Favj	หฌัง
sipgmaa	สิบ​มา
yaase	ยา​เซ
eleaale	เอ​เล​อา​เล
holonaaim	โฮ​โล​นา​อิม
ekglatqselisiyaa	เอก​ลัด​เซ​ลี​ซี​ยา
nimlim	นิม​ลิม
eDom	เอ​โดม
eDom	เอ​โดม
elaam	เอ​ลาม
Dwi	ดุย
Jyemb	เจียมฒ้าน
Din	ดิน
fxvb	ฟองธัง
Jopg	ด่ง
fuvj	ฝูง
BaaBilon	บา​บี​โลน
Ben	เบน
maasejyaa	มา​เส​ยา
zemb	เฒ่ม
Byrub	เบี้ยว
Levj	เหฮลง
Fovd	ฌ์ง
neBuKatqnetqsaa	เน​บู​คัด​เน้ด​ซา
Havj	หฮญัง
zung	หฒุ่น
Eweib	เญว่ย
ziaj	เหฒีย
meud	เม์ว
lafapq	หละฟับ
Fapg	หฌับ
Fapg	หฌับ
mGxvq	มฆ้อง
pwrnb	ป๊วนกั๊วะ
ziq	ฒิ
hopq	ฮบ
scvb	แซงฮม์
yem	เยียม
puad	ปั์ว
yenb	เยี่ยน
KeBaa	เค​บา
KeBaa	เค​บา
yaaaasanyaa	ยา​อา​ซัน​ยา
Zcv	แธง
wetq	เว้ด
lwib	ลุยจั๊วะ
tivg	ตี่ง
pywib	ปยุ้ย
tiaq	เตี๊ย
huvb	ฮู่ง
Kuq	คู้
Baamaa	บา​มา
Run	ฑุน
Paiq	ไพ้
Paiq	ไพ้
Tapq	ทับ
Tauq	เท้า
Ryruj	เหฑียว
Baij	ไบ๋
oholaa	โอ​โฮ​ลา
oholiBaa	โอ​โฮ​ลี​บา
oholaa	โอ​โฮ​ลา
oholiBaa	โอ​โฮ​ลี​บา
oholaa	โอ​โฮ​ลา
oholiBaa	โอ​โฮ​ลี​บา
yruj	โหยว
oholaa	โอ​โฮ​ลา
oholiBaa	โอ​โฮ​ลี​บา
oholi	โอ​โฮ​ลี
oholiBaa	โอ​โฮ​ลี​บา
esejKen	เอ​เส​เคน
BetgTokaanmaa	เบด​โท​กาน​มา
kaanBun	กาน​บุน
Gaan	ฆาน
huaj	หัว
huaj	หัว
paaig	ป่าย
eTiopia	เอ​ที​โอ​เปีย
pelusyem	เป​ลู​เซียม
pelusyem	เป​ลู​เซียม
on	โอน
PiBesetg	พี​เบ​เสด
scvb	แซงเธี้ยด
Palen	พะเลน
tweiq	เดี๋ยงเตว๊ย
Zauj	เอ​เดน
vwaaig	หงว่าย
Dovg	ด่ง
Fog	โหฌะ
Bevj	เบ๋ง
miab	เมี้ยเธี้ยง
naq	นะ
yavb	ยั่ง
palikq	ปะลี้ก
palxkq	ปะล้อก
Buvq	บู๊ง
kokg	โกก
aab	โกก
kokg	โกก
kokg	โกก
txvj	ฒ่าง
tovb	ธ้าง
tovb	ลู้
laatg	หลาด
timg	ติ่ม
laatg	หลาด
Dxg	เดาะ
laatg	หลาด
puv	ปูง
Qovj	ฉง
Dyrub	เดี้ยว
Ravb	ฑั่ง
zei	เฒย
Ravb	ฑั่ง
sivj	สีง
Batg	บัด
home	โฮ​เม
home	โฮ​เม
home	โฮ​เม
seKenj	เซ​เขน
seKenj	เซ​เขน
seKenj	เซ​เขน
seKenj	เซ​เขน
seKenj	เซ​เขน
minaa	มี​นา
seKenj	เซ​เขน
home	โฮ​เม
home	โฮ​เม
yetg	เหยียด
home	โฮ​เม
hxg	ห่อ
Tovq	ท้ง
zyrub	เฒี่ยว
atgpenatq	อัด​เป​นัด
hannanyaa	ฮัน​นัน​ยา
Daanien	ดา​นี​เอน
lai	ไล
Beij	เบ๋ย
Beij	เบ๋ย
Daanien	ดา​นี​เอน
BenTesatqsaa	เบน​เท​ซัด​ซา
panaib	ปะไน่
Daanien	ดา​นี​เอน
satqlakq	ซัด​ลัก
mesaakq	เม​ซ้าก
aaBetgneko	อา​เบด​เน​โก
zunb	ฒุ่น
aaBetgneko	อา​เบด​เน​โก
aaBetgneko	อา​เบด​เน​โก
aaBetgneko	อา​เบด​เน​โก
Hruq	เฮญี้ยว
Bensatqsaa	เบน​ซัด​ซา
Bensatqsaa	เบน​ซัด​ซา
taij	ไต๋
lyrub	เลี่ยว
Bensatqsaa	เบน​ซัด​ซา
mene	เม​เน
mene	เม​เน
TeKen	เท​เคน
paasin	ปา​ซิน
paasin	ปา​ซิน
Daaliatg	ดา​ลิ​อัด
Daatq	ด๊าด
taub	เต้า
tafeij	ตะเฝย
ulai	อู​ไล
ulai	อู​ไล
kaaBelyen	กา​เบ​เลียน
movb	ม่ง
Taikitg	ไท​กิด
Tiuj	ถิว
yeleBoam	เย​เล​โบ​อัม
hoseyaa	โฮ​เซ​ยา
Dipglaaim	ดิบ​ลา​อิม
kome	โก​เม
loluhaamaa	โล​ลุ​หะ​มา
loammi	โล​อัม​มี
ammi	อัม​มี
luhaamaa	ลู​ฮา​มา
lomb	หล่ม
aaKo	อา​โค
Betgaawen	เบด​อา​เวน
sanman	ซัน​มัน
BetgaanBen	เบด​อาน​เบน
pyetq	เปี๊ยด
Byaub	เบย้า
limb	ลิ่ม
aamotq	อา​โม้ด
aamotq	อา​โม้ด
aawen	อา​เวน
BetgeDen	เบด​เอ​เดน
kaasaa	กา​ซา
Keliotg	เค​ลิ​โอด
Ziq	ธี้
liq	ลี้
kinkaan	กิน​กาน
Kaannaaim	คาน​นา​อิม
mwavq	มวั้ง
finisia	ฟี​นี​เซีย
saajlefatq	สา​เล​ฟัด
sejfaalaatq	เส​ฟา​ล้าด
aamitqTai	อา​มิด​ไท
yonaa	โย​นา
yonaa	โย​นา
piub	ปิ้ว
ninaawe	นิ​นะ​เว
saafi	ซา​ฟี
saanan	ซา​นัน
Betgesen	เบด​เอ​เซน
maalotq	มา​โล้ด
vxvd	ง์อง
Ganj	หฆัน
Dunb	ดุ้น
pyeib	เปย๊ยเฒ้ย
enKotg	เอน​โขด
naahum	นา​ฮูม
syenb	เซี่ยน
liBia	ลิ​เบีย
Exj	หญอ
haaBaakukg	ฮา​บา​กุก
Pwrtq	พ้วด
sikionotq	ซิ​กิ​โอ​โน้ด
Kusi	คู​ซี
zyavq	เฒี้ยง
minKom	มิน​โคม
tiub	ติ๊วโหฌะ
hxvg	จายห่อง
Baav	เปย๊าบาง
Favb	ฌังหล่าง
hakqkai	ฮัก​ไก
isaalaaen	อิ​สะลา​เอน
yosuwaa	โย​ซู​วา
Gaaij	หฆาย
yosaaDatg	โย​ซา​ดัด
lxpg	หลอบ
fivj	ฝีง
naanj	หนาน
seij	เสย
Zaib	ไธต๋อย
log	ตุ๊
peletq	เป​เล้ด
hetqlon	เฮ้ด​โลน
laam	ลาม
Boaatg	โบ​อาด
Jyetgsi	เจียด​ซี
seanTien	เซ​อัน​ทิ​เอน
aaBiyutq	อา​บี​ยุด
aaBiyutq	อา​บี​ยุด
eliyaaKim	เอ​ลี​ยา​คิม
aasx	อา​ซอ
aasx	อา​ซอ
aaKim	อา​คิม
aaKim	อา​คิม
eliutg	เอ​ลี​อูด
eliutg	เอ​ลี​อูด
matqTaan	มัด​ทาน
yosepq	โย​เซ้บ
maaliyaa	มา​ลี​ยา
maaliyaa	มา​ลี​ยา
yesu	เย​ซู
yesu	เย​ซู
kitug	กี​ตู่
maaliyaa	มา​ลี​ยา
yesu	เย​ซู
imaanuen	อี​มา​นู​เอน
eij	เอ๋ย
helotq	เฮ​โล้ด
henb	เฮ่น
yuDia	ยู​เดีย
naasaaletq	นา​ซา​เล้ด
naasaaletq	นา​ซา​เล้ด
yohan	โย​ฮัน
yohan	โย​ฮัน
yohan	โย​ฮัน
yohan	โย​ฮัน
yohan	โย​ฮัน
Ropg	หฑบ
txnb	ตอน
sejBeDi	เส​เบ​ดี
yaakxpg	ยา​กอบ
TotqBuli	โท้ด​บุ​ลี
Gopq	ฆบ
paaib	ป้าย
Euag	หญัวะ
Euag	หญัวะ
kilo	กี​โล
kilo	กี​โล
Paan	พาน
paig	ไป่
pru	โปว
mrud	โม์ว
Laau	ฮลาว
vcvq	แง้ง
vcvq	แง้ง
lomd	ล์ม
lomd	ล์ม
tuvd	ตู์ง
tuvd	ตู์ง
tuvd	ตู์ง
tuvd	ตู์ง
Kamj	ขัม
mtaub	มเต้า
filipq	ฟี​ลิบ
BaaTolomiu	บา​โท​โล​มิว
Tomatq	โท​มัด
matqTaai	มัด​ทาย
anfeatg	อัน​เฟ​อัด
TatqDeatg	ทัด​เด​อัด
simon	ซี​โมน
yuDaatg	ยู​ดาด
isaaKaaliotg	อิ​สะ​คา​ลิ​โอด
Eeig	เหญ่ย
Zyrub	เธี่ยว
tung	ตุ่น
Zyrub	เธี่ยว
tung	ตุ่น
tog	โตะ
mnxmb	มน่อม
hev	เฮง
faalisij	ฟา​ลิ​สี
faalisij	ฟา​ลิ​สี
myenq	เมี้ยน
BeenseBun	เบ​เอน​เซ​บูน
saataan	ซา​ตาน
Rotq	ฑด
lcvg	แหล่ง
lcvg	แหล่ง
heloDyetg	เฮ​โล​เดียด
yesu	เย​ซู
txn	เบย์าตอน
saaDusij	สะ​ดู​สี
saaDusij	สะ​ดู​สี
pite	ปี​เต
pite	ปี​เต
saib	ไซ
fuJweiq	ฝุเจว๊ย
Juaq	จั๊ว
Juaq	จั๊ว
saa	ซา
BeTaani	เบ​ทา​นี
sisaa	ซี​ซา
sisaa	ซี​ซา
sisaa	ซี​ซา
saaDusij	สะ​ดู​สี
tanaij	ตะไหน
lauq	เล้า
saan	ซาน
lauq	เล้า
Zig	หธี่
zyruq’	เฒี้ยว’
taub’	เต้า’
kitug	กี​ตู่
mcg	แหมะ
haad	ฮ์า
Kaayaafaatq	คา​ยา​ฟ้าด
zxvb	ฒอง
cj	แอ๋
Druq	โด๊ว
pite	ปี​เต
lomaa	โล​มา
pilaatq	ปี​ล้าด
yuDaatg	ยู​ดาด
Dau	เดา
pilaatq	ปี​ล้าด
pilaatq	ปี​ล้าด
pilaatq	ปี​ล้าด
zwib	ฒุ์ย
BaalapqBatg	บา​ลับ​บัด
pilaatq	ปี​ล้าด
BaalapqBatg	บา​ลับ​บัด
pilaatq	ปี​ล้าด
pilaatq	ปี​ล้าด
BaalapqBatg	บา​ลับ​บัด
pilaatq	ปี​ล้าด
BaalapqBatg	บา​ลับ​บัด
pilaatq	ปี​ล้าด
pilaatq	ปี​ล้าด
pilaatq	ปี​ล้าด
pilaatq	ปี​ล้าด
kwatg	กวัด
sailin	ไซ​ลีน
simon	ซี​โมน
eli	เอ​ลี
laamaasaaBakgTaani	ลา​มา​ซา​บัก​ทา​นี
makqDaalaa	มัก​ดา​ลา
pilaatq	ปี​ล้าด
pilaatq	ปี​ล้าด
makqDaalaa	มัก​ดา​ลา
pilaatq	ปี​ล้าด
anDaalu	อัน​ดา​ลู
Kaapenaaum	คา​เป​นา​อุม
iDumeaa	อิ​ดู​เม​อา
yesu	เย​ซู
yesu	เย​ซู
Boaaneye	โบ​อา​เน​เย
yesu	เย​ซู
kwaiq	ไกว๊
haad	ฮ์า
miub	มิ่ว
Gomd	ฆ์ม
laavd	ล์าง
helotq	เฮ​โล้ด
Bomd	บ์ม
Yenj	เหฮยียน
BetgsaiDaa	เบด​ไซ​ดา
mose	โม​เซ
BaaTimeatg	บา​ทิ​เม​อัด
hosaanaa	โฮ​ซา​นา
lomaa	โล​มา
kiv	กีง
naaDaa	นา​ดา
Povj	ผง
aalekqsaanDe	อา​เล้ก​ซาน​เด
lufatq	ลู​ฟัด
eloi	เอ​โล​อี
eloi	เอ​โล​อี
yosetg	โย​เสด
saalome	สะ​โล​เม
Twi	ทุย
sejKaaliyaa	เส​คา
sejKaaliyaa	เส​คา​ลิ​ยา
uq	อู๊
elisaaBetg	เอ​ลี​ซา​เบด
elisaaBetg	เอ​ลี​ซา​เบด
annaa	อัน​นา
faanuen	ฟา​นู​เอน
annaa	อัน​นา
TiBeliatg	ทิ​เบ​ลิ​อัด
pxnTiatg	ปอน​ทิ​อัด
iTulia	อิ​ทู​เลีย
taaKonititg	ตา​โค​นิ​ติด
lisaanyetq	ลี​ซา​เนี้ยด
aaBilen	อา​บี​เลน
heli	เฮ​ลี
heli	เฮ​ลี
matqTatq	มัด​ทัด
matqTatq	มัด​ทัด
menKi	เมน​คี
menKi	เมน​คี
yannaai	ยัน​นาย
yannaai	ยัน​นาย
matqTaaTiatg	มัด​ทา​ที​อัด
matqTaaTiatg	มัด​ทา​ที​อัด
naahum	นา​ฮูม
etgli	เอด​ลี
etgli	เอด​ลี
nakqkaai	นัก​กาย
nakqkaai	นัก​กาย
maaaatg	มา​อาด
maaaatg	มา​อาด
matqTaaTiatg	มัด​ทา​ที​อัด
matqTaaTiatg	มัด​ทา​ที​อัด
sejmein	เส​เม​อิน
sejmein	เส​เม​อิน
yosekg	โย​เสก
yosekg	โย​เสก
yoDaa	โย​ดา
yoDaa	โย​ดา
yoaanan	โย​อา​นัน
yoaanan	โย​อา​นัน
lesaa	เล​ซา
lesaa	เล​ซา
neli	เน​ลี
neli	เน​ลี
menKi	เมน​คี
menKi	เมน​คี
atgDi	อัด​ดี
atgDi	อัด​ดี
Kosamj	โค​สัม
Kosamj	โค​สัม
enmaaDam	เอน​มา​ดัม
enmaaDam	เอน​มา​ดัม
eaa	เอ​อา
eliyese	เอ​ลี​เย​เซ
yolim	โย​ลิม
yolim	โย​ลิม
matqTatq	มัด​ทัด
matqTatq	มัด​ทัด
simeon	สิ​เม​โอน
yonaam	โย​นาม
yonaam	โย​นาม
meleaa	เม​เล​อา
meleaa	เม​เล​อา
mennaa	เมน​นา
mennaa	เมน​นา
matqtaaTaa	มัด​ตะ​ทา
matqtaaTaa	มัด​ตะ​ทา
atgmin	อัด​มิน
atgmin	อัด​มิน
aanni	อาน​นี
aanni	อาน​นี
apglaaham	อับ​ลา​ฮัม
naaho	นา​โฮ
sejlukq	เส​ลุก
leu	เล​อู
pelekq	เป​เล้ก
eBe	เอ​เบ
Kainaan	ไค​นาน
Kainaan	ไค​นาน
aanfaasatq	อาน​ฟา​ซัด
laamekq	ลา​เม้ก
yaaletq	ยา​เล้ด
maahaalaaleen	มา​หะ​ลา​เล​เอน
maahaalaaleen	มา​หะ​ลา​เล​เอน
enotq	เอ​โน้ด
aaDam	อา​ดัม
nib	นี่
Gwekg	เหฆวก
simon	ซี​โมน
pite	ปี​เต
zavg	หฒั่ง
taub	เต้า
nivj	หนีง
kelaasaa	เก​ลา​ซา
yailatq	ไย​ลัด
pite	ปี​เต
Zyru	เธียว
saamaalia	สะ​มา​เลีย
Tcpq	แท้บ
pyaub	เปย๊าเฒี้ยว
maaTaa	มา​ทา
Daavb	ด้าง
samj	สัม
kaalili	กา​ลิ​ลี
sijloam	สี​โล​อัม
ywav	ยวัง
puvj	ปู๋ง
Bwrnq	บ๊วน
piag	เปียะ
Naav	ฮนาง
waang	หว่าน
hivb	ฮี่ง
pwrnj	ป๋วน
hrug	โห่ว
’	ธุ
taan	แฒะตาน
laasaalatq	ลา​ซา​ลัด
kovb	กง
zob	โฒ่
sakgKyetq	สัก​เคี้ยด
’	’
sig	สิ
maali	มา​ลี
Eomj	หญม
lau	เลา
tig	ตี่
helotq	เฮ​โล้ด
Kib	คี่
Kaatq	ค้าด
Kenopatg	เคน​โอ​ปัด
Danb	ดั้น
laavb	ล์าง
anDaalu	อัน​ดา​ลู
Kefaatq	เค​ฟ้าด
Kefaatq	เค​ฟ้าด
filipq	ฟี​ลิบ
naaTaanaaen	นา​ทา​นา​เอน
naaTaanaaen	นา​ทา​นา​เอน
kopq	ก๊บ
niKoDematq	นี​โค​เด​มัด
livb	ลี่ง
niKoDematq	นี​โค​เด​มัด
aainon	อาย​โนน
saajlim	สา​ลิม
siKaa	สิ​คา
yiuTai	ยิว​ไท
Kaanaa	คา​นา
Kaapenaaum	คา​เป​นา​อุม
Jiug	จิ่ว
laai	ลาย
vib	งี่
vuvj	หงูง
suvj	สูง
sapq	ซับ
Bx	บอ
suvj	สูง
sapq	ซับ
yem	กา
kaalili	ลิ​ลี
faalisij	ฟา​ลิ​สี
yesu	เย​ซู
laasaalatq	ลา​ซา​ลัด
laasaalatq	ลา​ซา​ลัด
maaTaa	มา​ทา
maaTaa	มา​ทา
laasaalatq	ลา​ซา​ลัด
Kaayaafaatq	คา​ยา​ฟ้าด
sig’	สี่’
mRiaj	มเหฑีย
Paaiq	พ้าย
yuDaatg	ยู​ดาด
syenj	เสียน
laanb	ล่าน
laub’	เล่า’
hiuq	ฮิ้ว
tia	เตีย
Bam	บัม
manKatq	มัน​คัด
annaatq	อัน​น้าด
paaib	ป้าย
paaib	ป้าย
laatin	ลา​ติน
Teofilatq	เท​โอ​ฟี​ลัด
aaKenDaamaa	อา​เคน​ดา​มา
PenTeKxtq	เพน​เท​ค้อด
eq	เอ๊
aanaania	อา​นา​เนีย
sapgfilaa	สับ​ฟี​ลา
aanaania	อา​นา​เนีย
Tim	ทิม
saaTefen	สะ​เท​เฟน
saaTefen	สะ​เท​เฟน
poKolatq	โป​โค​ลัด
niKaano	นิ​คา​โน
Timon	ทิ​โมน
paanmenatq	ปาน​เม​นัด
anTiokg	อัน​ที​โอก
niKolau	นี​โค​เลา
tapg	ตับ
tapg	ตับ
Zeiq	เธ้ย
Fib	ฌี่
Fuvj	หฌูง
Futg	หฌุด
Qaq’	ชะ’
saulo	เซา​โล
aineatg	ไอ​เน​อัด
aineatg	ไอ​เน​อัด
litqDaa	ลิด​ดา
litqDaa	ลิด​ดา
yapqfaa	ยับ​ฟา
litqDaa	ลิด​ดา
samb	ซั่ม
Koneliatg	โค​เน​ลิ​อัด
Koneliatg	โค​เน​ลิ​อัด
sisaaliyaa	ซี​ซา​ลี​ยา
BaanaaBatg	บา​นา​บัด
BaanaaBatg	บา​นา​บัด
Taasatq	ทา​ซัด
aakaaBatg	อา​กา​บัด
KaalaauDiatg	คา​ลาว​ดิ​อัด
ziub	ฒิ่ว
maaKo	มา​โค
loDaa	โล​ดา
maaKo	มา​โค
elimaatq	เอ​ลี​ม้าด
xmj	อ๋อม
Lua	ฮลัว
paulo	เปา​โล
paulo	เปา​โล
iKoniyum	อี​โค​นี​ยูม
sutq	ซุด
hemetq	เฮ​เม้ด
iKoniyum	อี​โค​นี​ยูม
pekaa	เป​กา
atgTaaliyaa	อัด​ทา​ลิ​ยา
silaa	ซี​ลา
maasiDonia	มา​ซี​โด​เนีย
paulo	เปา​โล
silaa	ซี​ลา
amfiBuli	อัม​ฟี​บุ​ลี
aapxlonia	อา​ปอ​โล​เนีย
Tesaalonikaa	เท​สะ​โล​นิ​กา
yaasonj	ยา​โสน
faanq	ฟ้าน
yaasonj	ยา​โสน
aaTen	อา​เทน
TimoTai	ทิ​โม​ไท
aaleopaakatg	อา​เล​โอ​ปา​กัด
aaTen	อา​เทน
fyru	เฟียว
KolinTo	โค​ลิน​โท
TiTiatgyusaaTatq	ทิ​ทิ​อัด​ยุ​สะ​ทัด
Kaalitqpatg	คะ​ลิด​ปัด
KolinTo	โค​ลิน​โท
kanlio	กัน​ลิ​โอ
aaKaayaa	อา​คา​ยา
kanlio	กัน​ลิ​โอ
kanlio	กัน​ลิ​โอ
efeso	เอ​เฟ​โซ
pitgsinjlaa	ปิด​สิน​ลา
aaKwinlaa	อา​ควิน​ลา
efeso	เอ​เฟ​โซ
aapxlo	อา​ปอ​โล
pitgsinjlaa	ปิด​สิน​ลา
aaKwinlaa	อา​ควิน​ลา
sejwaa	เส​วา
aanTemitq	อาน​เท​มิด
esia	เอ​เซีย
aalekqsaanDe	อา​เล้ก​ซาน​เด
Demetqliatg	เด​เม้ด​ลิ​อัด
Beloaa	เบ​โล​อา
pilatq	ปี​ลัด
sojpaaTe	โส​ปา​เท
aalitqTaaKatq	อา​ลิด​ทา​คัด
sejKunDatg	เส​คุน​ดัด
kaaiatg	กาย​อัด
TiKikatg	ที​คิ​กัด
tofimatq	โต​ฟี​มัด
toatg	โต​อัด
yuTikatg	ยู​ทิ​กัด
yuTikatg	ยู​ทิ​กัด
atgsotg	อัด​โสด
atgsotg	อัด​โสด
miTileni	มิ​ทิ​เล​นี
silisia	ซี​ลี​เซีย
paulo	เปา​โล
felikq	เฟ​ลิก
felikq	เฟ​ลิก
KaalaauDiatg	คา​ลาว​ดิ​อัด
lisyetq	ลี​เซี้ยด
zig	หฒี่
TeTulatq	เท​ทู​ลัด
pxsiatg	ปอ​สิ​อัด
fesaaTatq	เฟ​สะ​ทัด
fesaaTatq	เฟ​สะ​ทัด
fesaaTatq	เฟ​สะ​ทัด
fesaaTatq	เฟ​สะ​ทัด
aaGiPaa	อา​ฆี​พา
Benitq	เบ​นิด
aaGiPaa	อา​ฆี​พา
fesaaTatq	เฟ​สะ​ทัด
aaGiPaa	อา​ฆี​พา
iq	อี๊
Zovb	ธ่ง
zamb	ฒั่ม
zamb	ฒั่ม
pupgliatg	ปุบ​ลิ​อัด
fiaj	เฝีย
sailaaKiu	ไซ​ลา​คิว
leyium	เล​ยี​อูม
puTioli	ปู​ที​โอ​ลี
msiaq	มเซียะ
yiuTai	ยิว​ไท
apglaaham	อับ​ลา​ฮัม
winb	วิน
wavq	วั้ง
kitug	กี​ตู่
aa	อา
Raig	ไหฑ่
en	เอน
taab	ต้า
saapen	สะ​เปน
saapen	สะ​เปน
saapen	สะ​เปน
aapenletq	อา​เปน​เล้ด
aalitqToBulatq	อา​ลิด​โท​บู​ลัด
tifenaa	ตี​เฟ​นา
tifosaaj	ตี​โฟ​สา
pesitg	เป​สิด
lufatq	ลู​ฟัด
filolokatg	ฟี​โล​โล​กัด
yulia	ยู​เลีย
neleatg	เน​เล​อัด
olimpatg	โอ​ลิม​ปัด
lusiatg	ลู​สิ​อัด
sojsipaaTe	โส​สิ​ปา​เท
TeTiatg	เท​ทิ​อัด
ob	โอ้
saaTefaanatq	สะ​เท​ฟา​นัด
aapxlo	อา​ปอ​โล
zaang	หฒ่าน
zaang	หฒ่าน
zyenb	เฒี่ยน
yaag	หย่า
zyenb	เฒี่ยน
zyruq	เฒี้ยว
Zamq	ธั้ม
nrub	โน่ว
Nomq	ฮน้ม
Ryaau	ฑยาว
kwaan	กวาน
maasiDonia	มา​ซี​โด​เนีย
fxTunaaTatq	ฟอ​ทู​นา​ทัด
aaKaaiKatq	อา​คาย​คัด
teij	เต๋ย
kitug	กี​ตู่
Belian	เบ​ลี​อัน
takxib	ตะก้อย
Titatg	ทิ​ตัด
Titatg	ทิ​ตัด
Titatg	ทิ​ตัด
paHavj	ปะหฮญัง
zog	โหฒะ
Tevj	เถง
Zev	เธง
fuq	ฟุ
aaBaa	อา​บา
Kauj	เขา
Lav	ฮลัง
Namq	ฮนั้ม
yuoDia	ยู​โอ​เดีย
sinjTiKe	สิน​ทิ​เค
Kenmen	เคน​เมน
epaafoDiTatq	เอ​ปา​โฟ​ดิ​ทัด
epaafaa	เอ​ปา​ฟา
epaafaa	เอ​ปา​ฟา
txnb	ตอน
lauDisia	เลา​ดี​เซีย
sin	ซิน
Eatq	ญัด
Dyemq	เดี๊ยม
Tinb	ทิน
zruj	โหฒว
yusaaTatq	ยุ​สะ​ทัด
taaij	ต๋าย
mFxmb	มฌ่อม
naanb	น่าน
Bua	บัว
himeneatg	ฮี​เม​เน​อัด
BuDovj	บุด๋ง
Rivd	ฑี์ง
pxvb	ปอง
lxj	หลอ
fyem	เฟียม
Gcvg	แหฆ่ง
Rcv	แฑง
inq	อิ๊น
Eeiq	เญ้ย
fiJelatq	ฟี​เจ​ลัด
hemokenetq	เฮ​โม​เก​เน้ด
saaij	สาย
fileTatq	ฟี​เล​ทัด
yannetq	ยัน​เน้ด
yamBe	ยัม​เบ
Demaatq	เด​ม้าด
Kelesen	เค​เล​เซน
kaalaaTia	กา​ลา​เทีย
DaanmaaTia	ดาน​มา​เทีย
lukaa	ลู​กา
pxv	ปอง
onesifolatq	โอ​เน​สิ​โฟ​ลัด
elatqTatq	เอ​ลัด​ทัด
mileTatq	มิ​เล​ทัด
swrng	ส่วน
sejnaatq	เส​น้าด
filemon	ฟี​เล​โมน
onesimatq	โอ​เน​สิ​มัด
onesimatq	โอ​เน​สิ​มัด
onesimatq	โอ​เน​สิ​มัด
onesimatq	โอ​เน​สิ​มัด
txvj	ต๋อง
saalem	ซา​เลม
menKiseDekg	เมน​คี​เซ​เดก
saalem	ซา​เลม
saalem	ซา​เลม
menKiseDekg	เมน​คี​เซ​เดก
Ryaamq	ฑย้าม
aaBcn	อา​แบน
mose	โม​เซ
Rung	หฑุ่น
Eei	เญย
Byetg	เบียด
kanb	กั้น
tyenb	เตี้ยน
laamb	ล่าม
kruj	โก๋ว
Baalaaam	บา​ลา​อัม
Ywav	ฮยวัง
Kaain	คา​อิน
yiuDaa	ยิว​ดา
Kolaa	โค​ลา
mauq	เม้า
namj	หนัม
kruq	โก๊ว
Bapyei	บะเปยย
Pyuq	พยู้
haib	ไฮ่
paab	ป้า
Ruv	ฑูง
aalaamaaketgDon	อา​ละ​มา​เกด​โดน
Peuj	เผว
aaleluyaa	อา​เล​ลู​ยา
Bopq	บ๊บ
anfaa	อัน​ฟา
omekaa	โอ​เม​กา
ເຢ	เย
ຊູ	ซู
aadam	อา​ดัม
kaain	คา​อิน
aabcn	อา​แบน
tov	เอ​เดน
aadaa	อา​ดา
maahaalaalen	มา​หะ​ลา​เลน
metusejlaa	เม​ทู​เส​ลา
kaanaaan	คา​นา​อัน
kome	โก​เม
maadai	มา​ได
tuban	ทู​บัน
atgkenatq	อัด​เค​นัด
tokaanmaa	โท​กาน​มา
eliseaa	เอ​ลี​เซ​อา
kitqtim	คิด​ทิม
lodaanim	โล​ดา​นิม
iyipq	อี​ยิบ
sejbaa	เส​บา
haawilaa	ฮา​วิ​ลา
sapgtaa	สับ​ทา
laaaamaa	ลา​อา​มา
sapgtekaa	สับ​เท​คา
qebaa	เช​บา
dedaan	เด​ดาน
ninaawe	นิ​นะ​เว
ludim	ลู​ดิม
aanaamim	อา​นา​มิม
lehaabim	เล​หะ​บิม
napqtuhim	นับ​ทู​ฮิม
atgsu	อัด​ซู
aanfaasatq	อาน​ฟา​ซัด
lude	ลู​เด
kete	เก​เท
ebe	เอ​เบ
yokqtaan	โย้ก​ทาน
anmodatg	อัน​โม​ดัด
haasaanmaawetq	ฮา​ซาน​มา​เว้ด
haadolam	ฮา​โด​ลัม
dikglaa	ดิก​ลา
aabimaaen	อา​บี​มา​เอน
yobapg	โย​บับ
baaben	บา​เบน
leu	เล​อู
naaho	นา​โฮ
apglaam	อับ​ลาม
betgen	เบด​เอน
sojdom	โส​โดม
komolaa	โก​โม​ลา
atgmaa	อัด​มา
sejboyim	เส​โบ​ยิม
sojaa	โส​อา
aamaalekq	อา​มา​เล้ก
aamolai	อา​โม​ไล
sitgdim	สิด​ดิม
daamatqkatg	ดา​มัด​กัด
kedolaaome	เค​โด​ลา​โอ​เม
aane	อา​เน
etgko	เอด​โค
eliyese	เอ​ลี​เย​เซ
apglaaham	อับ​ลา​ฮัม
hitqtai	ฮิด​ไท
pelitqsi	เป​ลิด​ซี
lefaaim	เล​ฟา​อิม
isaamaaen	อิ​สะ​มา​เอน
kelaaaa	เก​ลา​อา
aabimelekq	อา​บี​เม​เล้ก
isakg	อี​สัก
beeqebaa	เบ​เอ​เช​บา
betuen	เบ​ทู​เอน
lebekaa	เล​เบ​คา
hebolon	เฮ​โบ​โลน
sojhaaj	โส​หา
efolon	เอ​โฟ​โลน
laabaan	ลา​บาน
ketulaa	เค​ทู​ลา
yokqsaan	โย้ก​ซาน
mitqmaa	มิด​มา
haadatg	ฮา​ดัด
kedemaa	เค​เด​มา
filisaatia	ฟี​ลิ​สะ​เตีย
beeli	เบ​เอ​ลี
baasejmatq	บา​เส​มัด
laabaan	ลา​บาน
binhaa	บิน​ฮา
leaa	เล​อา
napqtaali	นับ​ทา​ลี
sinjpaa	สิน​ปา
dudaaim	ดู​ดา​อิม
isaalaaen	อิ​สะ​ลา​เอน
seji	เส​อี
simeon	สิ​เม​โอน
efaalaataa	เอ​ฟา​ลา​ทา
benyaamin	เบน​ยา​มิน
aase	อา​เซ
elifatq	เอ​ลี​ฟัด
leuen	เล​อู​เอน
naahatg	นา​หัด
yeutg	เย​อูด
oholibaamaa	โอ​โฮ​ลี​บา​มา
edom	เอ​โดม
sobaan	โซ​บาน
maanaahaatq	มา​นา​ฮ้าด
ebaan	เอ​บาน
etgbaan	เอด​บาน
itglaan	อิด​ลาน
ese	เอ​เซ
sibeon	สิ​เบ​โอน
edom	เอ​โดม
dinhaabaa	ดิน​ฮา​บา
bosaalaa	โบ​ซา​ลา
bedatg	เบ​ดัด
moapg	โม​อับ
midyen	มี​เดียน
samjlaa	สัม​ลา
lehojbotg	เล​โห​โบด
saaun	ซา​อุน
akgbo	อัก​โบ
mipqsaa	มิบ​ซา
luben	ลู​เบน
yudaa	ยู​ดา
quaa	ชู​อา
eaa	เอ​อา
hipqlu	ฮิบ​ลู
naiaa	ไน​อา
hetqlon	เฮ้ด​โลน
yemuen	เย​มู​เอน
ohaatg	โอ​หาด
kohaatq	โค​ฮ้าด
melaali	เม​ลา​ลี
itgsaajkaa	อิด​สา​คา
sejbulun	เส​บู​ลุน
yaaleen	ยา​เล​เอน
hakqki	ฮัก​กี
etgbon	เอด​โบน
elei	เอ​เล​อี
aaleli	อา​เล​ลี
itgwaa	อิด​วา
itgwi	อิด​วี
beliyaa	เบ​ลี​ยา
selaaaa	เซ​ลา​อา
hebe	เฮ​เบ
atgben	อัด​เบน
naaaamaan	นา​อา​มาน
yaasien	ยา​ซี​เอน
maanatqsej	มะ​นัด​เส
efaaim	เอ​ฟา​อิม
jxdcn	จอ​แดน
lipqni	ลิบ​นี
simei	ซิ​เม​อี
itghaa	อิด​ฮา
sikgli	สิก​ลี
utgsien	อุด​ซี​เอน
misaaen	มิ​ซา​เอน
ensaafaan	เอน​ซา​ฟาน
naadapg	นา​ดับ
itaamaa	อิ​ทา​มา
atgsij	อัด​สี
enkaanaa	เอน​คา​นา
eleaasaa	เอ​เล​อา​ซา
finehatg	ฟี​เน​หัด
sukgkotq	สุก​โค้ด
aabipg	อา​บีบ
lefidim	เล​ฟี​ดิม
huaa	ฮู​อา
yosuwaa	โย​ซู​วา
aabihu	อา​บี​ฮู
kelubim	เค​ลู​บิม
besaalen	เบ​ซา​เลน
yebutg	เย​บุด
oholiapg	โอ​โฮ​ลี​อับ
selomitq	เซ​โล​มิด
sujlisatqdai	สู​ลิ​ซัด​ได
selumien	เซ​ลู​มิ​เอน
amminaadapg	อัม​มี​นา​ดับ
zuaa	ฒู​อา
netanen	เน​ทัน​เอน
eliapg	เอ​ลี​อับ
ammihutq	อัม​มี​ฮู้ด
elisaamaa	เอ​ลี​ซา​มา
pedaasu	เป​ดา​ซู
kaamaalien	กา​มา​ลิ​เอน
kideoni	กิ​เด​โอ​นี
aabidan	อา​บี​ดัน
aahiyese	อา​หิ​เย​เซ
paakien	ปา​กี​เอน
deuen	เด​อู​เอน
eliyaasaapg	เอ​ลี​ยา​สาบ
aahilaa	อา​หิ​ลา
elisaafaan	เอ​ลี​ซา​ฟาน
maanaa	มา​นา
sakgke	สัก​เก
sammuwaa	ซัม​มุ​วา
yefunne	เย​ฟุน​เน
ikaan	อิ​กาน
hoseyaa	โฮ​เซ​ยา
mikaaen	มี​คา​เอน
aabilam	อา​บี​ลัม
melibaa	เม​ลี​บา
kaadetg	คา​เดด
hoaa	โฮ​อา
sihonj	สิ​โหน
hetqbon	เฮ้ด​โบน
sipgpo	สิบ​โป
baalaaam	บา​ลา​อัม
baaan	บา​อัน
beo	เบ​โอ
peo	เป​โอ
simjli	สิม​ลี
kotqbi	โค้ด​บี
sujaa	สู​อา
otgni	โอด​นี
atglien	อัด​ลี​เอน
semidaa	เซ​มิ​ดา
sejlofehatg	เส​โล​เฟ​หัด
maahaalaa	มา​ฮา​ลา
hokqlaa	โฮ้ก​ลา
tilaasaa	ที​ละ​ซา
suham	ซู​ฮัม
kileaatg	กิ​เล​อาด
maakile	มา​คี​เล
aabaalim	อา​บา​ลิม
lebaa	เล​บา
mikqdon	มิก​โดน
lipqnaa	ลิบ​นา
taahatg	ทา​หัด
yotqbaataa	โย้ด​บา​ทา
obotg	โอ​โบด
nebo	เน​โบ
atgmon	อัด​โมน
meditelenyen	เม​ดิ​เต​เล​เนียน
sejdatg	เส​ดัด
bukgki	บุก​คี
hannien	ฮัน​นี​เอน
kemuen	เค​มู​เอน
pantien	ปัน​ที​เอน
aahihutq	อา​หิ​ฮู้ด
edeni	เอ​เดน​อี
atgtaalotq	อัด​ทา​โล้ด
yaahaatq	ยา​ฮ้าด
aankopg	อาน​โกบ
saidxn	ไซ​ดอน
aalaabaa	อา​ลา​บา
pitgkaa	ปิด​กา
kelisim	เก​ลิ​ซิม
laahapg	ลา​หับ
kinkaan	กิน​กาน
yeliko	เย​ลี​โค
sapgdi	สับ​ดี
kibeon	กิ​เบ​โอน
beelotq	เบ​เอ​โล้ด
yelusaalem	เย​ลู​ซา​เลม
ekglon	เอก​โลน
debi	เด​บี
aasekaa	อา​เซ​คา
makqkedaa	มัก​เค​ดา
aiyaalon	ไอ​ยา​โลน
yaabin	ยา​บิน
maadon	มา​โดน
akgsaapq	อัก​ซ้าบ
mitqpaa	มิด​ปา
aadunlam	อา​ดุน​ลัม
tapqpuwaa	ทับ​ปู​วา
mekitgdo	เม​กิด​โด
kedetg	เค​เดด
yokqneam	โย้ก​เน​อัม
maaaakaa	มา​อา​คา
saajlekaa	สา​เล​คา
kedemotq	เค​เด​โม้ด
mefaaaatg	เม​ฟา​อาด
baaaalaa	บา​อา​ลา
timnaahaa	ทิม​นา​ฮา
akgsaaj	อัก​สา
otgnien	โอด​นี​เอน
sipgaa	สิบ​อา
beaalotq	เบ​อา​โล้ด
molaadaa	โม​ลา​ดา
entolatq	เอน​โท​ลัด
sikglaakq	สิก​ล้าก
matqmannaa	มัด​มัน​นา
botgkaatq	โบด​ค้าด
ete	เอ​เท
atgnaa	อัด​นา
etgtemoaa	เอด​เท​โม​อา
maaon	มา​โอน
yitqleen	ยิด​เล​เอน
kedo	เก​โด
aataalotq	อา​ทา​โล้ด
naaaalaa	นา​อา​ลา
apgwim	อับ​วิม
ofaalaa	โอ​ฟา​ลา
kision	คี​ซิ​โอน
ebetg	เอ​เบด
kinneletq	คิน​เน​เล้ด
etgtaaon	เอด​ทา​โอน
ekolon	เอ​โค​โลน
enteke	เอน​เท​เค
kipgbeton	กิบ​เบ​โทน
baaaalatq	บา​อา​ลัด
aahimaan	อา​หิ​มาน
akgsipq	อัก​ซี้บ
lehopg	เล​โหบ
ehutq	เอ​ฮู้ด
debolaa	เด​โบ​ลา
aabinoam	อา​บี​โน​อัม
taabo	ทา​โบ
sisejlaa	สิ​เส​ลา
kideon	กิ​เด​โอน
yoaatg	โย​อาด
aabiyese	อา​บี​เย​เซ
zebaa	เฒ​บา
sanjmunnaa	สัน​มุน​นา
penuen	เป​นู​เอน
bee	เบ​เอ
sejbun	เส​บุน
kaaan	กา​อัน
tebetg	เท​เบด
jaai	จา​อี
yepqtaa	เย้บ​ทา
aaloe	อา​โล​เอ
betglehem	เบด​เล​เฮม
pilaaton	ปิ​ลา​โทน
apgdon	อับ​โดน
maanoaa	มา​โน​อา
scmsanj	แซม​สัน
delilaa	เด​ลิ​ลา
laaitg	ลา​อิด
kibeaa	กิ​เบ​อา
naaomi	นา​โอ​มี
elimelekq	เอ​ลี​เม​เล้ก
lute	ลู​เท
kilion	คิ​ลิ​โอน
boaatg	โบ​อาด
sanjmon	สัน​โมน
obetg	โอ​เบด
jyetgsi	เจียด​ซี
peninnaa	เป​นิน​นา
saamuen	ซา​มู​เอน
atgdotg	อัด​โดด
aabinaadapg	อา​บี​นา​ดับ
yaabetg	ยา​เบด
naahaatg	นา​หาด
mikqmaatq	มิก​ม้าด
suan	ซู​อัน
yonaataan	โย​นา​ทาน
aahiyaa	อา​หิ​ยา
apgne	อับ​เน
aabien	อา​บี​เอน
koliatg	โก​ลิ​อัด
saaaalaaim	ซา​อา​ลา​อิม
aahimelekq	อา​หิ​เม​เล้ก
doekg	โด​เอก
aahitupq	อา​หิ​ทู้บ
aabiyaataa	อา​บี​ยา​ทา
keilaa	เค​อี​ลา
naabaan	นา​บาน
aabikaayin	อา​บี​กา​ยิน
aahinoam	อา​หิ​โน​อัม
sejluyaa	เส​ลุ​ยา
yoaapg	โย​อาบ
aabiqai	อา​บี​ไช
kinboaa	กิน​โบ​อา
keleti	เค​เล​ที
yaatqti	ย้าด​ที
yelaameen	เย​ลา​เม​เอน
itgbosetq	อิด​โบ​เซ้ด
maahaanaaim	มา​หะ​นา​อิม
aasaajhen	อา​สา​เฮน
aadoniyaa	อา​โด​นี​ยา
hakqkitg	ฮัก​กีด
sefaatiyaa	เซ​ฟา​ทิ​ยา
kitgtaaim	กิด​ทา​อิม
baaaanaa	บา​อา​นา
saalomxn	ซา​โล​มอน
ipghaa	อิบ​ฮา
elisuwaa	เอ​ลี​ซู​วา
eliyaadaa	เอ​ลี​ยา​ดา
elifeletq	เอ​ลี​เฟ​เล้ด
kebaa	เก​บา
utgsaa	อุด​ซา
sijdaa	สี​ดา
sojbaa	โส​บา
haadatgese	ฮา​ดัด​เอ​เซ
yufetitg	ยู​เฟ​ติด
yehoyaadaa	เย​โฮ​ยา​ดา
benaiyaa	เบ​ไน​ยา
sibaa	ซิ​บา
mefibosetq	เม​ฟี​โบ​เซ้ด
batgqebaa	บัด​เช​บา
uliaa	อุ​ลี​อา
lapqbaa	ลับ​บา
apgsaalom	อับ​ซา​โลม
yonaadapg	โย​นา​ดับ
tekoaa	เท​โค​อา
itgtai	อิด​ไท
saajdokg	สา​โดก
aahimaaatg	อา​หิ​มา​อัด
aahitofen	อา​หิ​โท​เฟน
baasinlai	บา​ซิน​ไล
aamaasaaj	อา​มา​สา
bikgli	บีก​ลี
ilaa	อิ​ละ
aiaa	ไอ​อา
litqpaa	ลิด​ปา
simehaa	ซี​เม​ฮา
aahojhai	อา​โห​ไฮ
dodo	โด​โด
enhaanan	เอน​ฮา​นัน
heletqte	เฮ​เล้ด​เท
ikgketg	อิก​เขด
aanaatotq	อา​นา​โท้ด
netofaa	เน​โท​ฟา
maahaalai	มา​หะ​ไล
libai	ลี​ไบ
kaaatg	กา​อัด
baahulim	บา​ฮู​ลิม
atgmaawetq	อัด​มา​เว้ด
aahiyam	อา​หิ​ยัม
hetqlo	เฮ้ด​โล
naahaalai	นา​หะ​ไล
itglai	อิด​ไล
uliyaa	อุ​ลี​ยา
aalaaunaa	อา​ลาว​นา
aabiqaakq	อา​บี​ช้าก
aasaaliyaa	อา​ซา​ลิ​ยา
aahilutq	อา​หิ​ลู้ด
itgdo	อิด​โด
yehosaafatq	เย​โฮ​ซา​ฟัด
lebaanxn	เล​บา​นอน
aadonilam	อา​โด​นี​ลัม
sion	สิ​โอน
kaalili	กา​ลิ​ลี
taapenetq	ทา​เป​เน้ด
yeloboam	เย​โล​โบ​อัม
lehojboam	เล​โห​โบ​อัม
aabiyaa	อา​บี​ยา
nebatg	เน​บัด
aabiyam	อา​บี​ยัม
aabiqaalom	อา​บี​ชา​โลม
baaaaqaa	บา​อา​ชา
saamaalia	สะ​มา​เลีย
aahapg	อา​หับ
aaselaa	อา​เซ​ลา
eliyaa	เอ​ลี​ยา
obaadi	โอ​บา​ดี
yeseben	เย​เซ​เบน
yehu	เย​ฮู
elisaa	เอ​ลี​ซา
haasaaen	ฮา​ซา​เอน
naabotg	นา​โบด
mikaayaa	มี​คา​ยา
aahatgyaa	อา​หัด​ยา
sinhi	ซิน​หิ
aasubaa	อา​ซุ​บา
yeholam	เย​โฮ​ลัม
kehaasi	เก​หะ​ซี
yehoaahaatg	เย​โฮ​อา​หาด
aataaliyaa	อา​ทา​ลิ​ยา
yehoaatg	เย​โฮ​อาด
aamaasiyaa	อา​มา​ซิ​ยา
sejkaaliyaa	เส​คา​ลิ​ยา
utgsiyaa	อุด​ซี​ยา
kaadi	กา​ดี
menaahem	เม​นา​เฮม
atgsilia	อัด​ซี​เลีย
pekaahiyaa	เป​คา​หิ​ยา
lemaaliyaa	เล​มา​ลิ​ยา
aahatg	อา​หัด
kiaa	คี​อา
midia	มี​เดีย
baabilon	บา​บี​โลน
sejfaanwaaim	เส​ฟาน​วา​อิม
hesekiyaa	เฮ​เซ​คี​ยา
sennaakelipq	เซน​นา​เค​ลิบ
isaayaa	อิ​สะ​ยา
ipgwaa	อิบ​วา
yosiyaa	โย​สิ​ยา
aadaayaa	อา​ดา​ยา
mesunlaam	เม​ซุน​ลาม
aasaalaiyaa	อา​ซา​ไล​ยา
hinkiyaa	ฮิน​คี​ยา
aahikam	อา​หิ​คัม
aasaajyaa	อา​สา​ยา
hundaa	ฮุน​ดา
kitglon	ขิด​โลน
haamutaan	ฮา​มุ​ทาน
yelemi	เย​เล​มี
lipqlaa	ลิบ​ลา
yehoyaakim	เย​โฮ​ยา​คิม
pedaayaa	เป​ดา​ยา
yehoyaakin	เย​โฮ​ยา​คีน
ennaatan	เอน​นา​ทัน
sejdekiyaa	เส​เด​คี​ยา
matqsaaj	มัด​สา
mitqsaa	มิด​ซา
binhaan	บิน​ฮาน
saajwaan	สา​วาน
matqlekaa	มัด​เล​คา
makqdien	มัก​ดี​เอน
ilaam	อิ​ลาม
daandaa	ดาน​ดา
yete	เย​เท
aabihaain	อา​บี​ฮา​อิน
itgi	อิด​อี
akglai	อัก​ไล
saajbaatg	สา​บาด
eleaasaaj	เอ​เล​อา​สา
yekaamiyaa	เย​คา​มิ​ยา
efaa	เอ​ฟา
saaapg	ซา​อับ
simeaa	ซิ​เม​อา
sejlupqbaaben	เส​ลุบ​บา​เบน
haananyaa	ฮา​นัน​ยา
belekiyaa	เบ​เล​คิ​ยา
pelaatiyaa	เป​ลา​ที​ยา
yesaayaa	เย​ซา​ยา
lefaiyaa	เล​ไฟ​ยา
sekaaniyaa	เซ​คา​นิ​ยา
semaiaa	เซ​ไม​อา
hatqtatq	ฮัด​ทัด
neaaliyaa	เน​อา​ลี​ยา
elionai	เอ​ลี​โอ​ไน
atglikam	อัด​ลี​คัม
hodaawiyaa	โฮ​ดา​วิ​ยา
eliyaasipq	เอ​ลี​ยา​ซี้บ
pelaiyaa	เป​ไล​ยา
akgkupg	อัก​ขูบ
yohaanan	โย​ฮา​นัน
delaiyaa	เด​ไล​ยา
leaayaa	เล​อา​ยา
yaahaatg	ยา​หาด
itgmaa	อิด​มา
paasejaa	ปา​เส​อา
sejlaiaa	เส​ไล​อา
etglaa	เอด​ลา
maahaalaalen	มา​หะ​ลา​เลน
metusejlaa	เม​ทู​เส​ลา
isakg	อี​สัก
haadatg	ฮา​ดัด
yudaa	ยู​ดา
amminaadapg	อัม​มี​นา​ดับ
sanjmon	สัน​โมน
obetg	โอ​เบด
jaai	จา​อี
yehu	เย​ฮู
lehojboam	เล​โห​โบ​อัม
aabiyaa	อา​บี​ยา
aamaasiyaa	อา​มา​ซิ​ยา
aasaaliyaa	อา​ซา​ลิ​ยา
aahatg	อา​หัด
hesekiyaa	เฮ​เซ​คี​ยา
yehoyaakin	เย​โฮ​ยา​คีน
sejlupqbaaben	เส​ลุบ​บา​เบน
yesaayaa	เย​ซา​ยา
lefaiyaa	เล​ไฟ​ยา
obaadi	โอ​บา​ดี
semaiaa	เซ​ไม​อา
yaahaatg	ยา​หาด
maalesaa	มา​เล​ซา
kedelaa	เก​เด​ลา
nemuen	เน​มู​เอน
mipqsamj	มิบ​สัม
sakgke	สัก​เก
yoen	โย​เอน
aasien	อา​สิ​เอน
aadien	อา​ดี​เอน
yedaayaa	เย​ดา​ยา
kileaatg	กิ​เล​อาด
mikaaen	มี​คา​เอน
aahi	อา​หิ
elien	เอ​ลี​เอน
finehatg	ฟี​เน​หัด
aabiquwaa	อา​บี​ชู​วา
bukgki	บุก​คี
utgsi	อุด​ซี
sejlaahiyaa	เส​ลา​หิ​ยา
sejlaahiyaa	เส​ลา​หิ​ยา
melaayotq	เม​ลา​โย้ด
aamaaliyaa	อา​มา​ลิ​ยา
aamaaliyaa	อา​มา​ลิ​ยา
saajdokg	สา​โดก
hinkiyaa	ฮิน​คี​ยา
yehosaadakg	เย​โฮ​ซา​ดัก
nebukatqnetqsaa	เน​บู​คัด​เน้ด​ซา
simjmaa	สิม​มา
yoaa	โย​อา
enkaanaa	เอน​คา​นา
ebiyaasaapg	เอ​บี​ยา​สาบ
ebiyaasaapg	เอ​บี​ยา​สาบ
taahatg	ทา​หัด
ulien	อุ​ลี​เอน
utgsiyaa	อุด​ซี​ยา
eliapg	เอ​ลี​อับ
yeloham	เย​โล​ฮัม
yeloham	เย​โล​ฮัม
simeaa	ซิ​เม​อา
maahaatq	มา​ฮ้าด
aamaasaij	อา​มา​ไส
yoen	โย​เอน
sejfanyaa	เส​ฟัน​ยา
atgsij	อัด​สี
itghaa	อิด​ฮา
kohaatq	โค​ฮ้าด
belekiyaa	เบ​เล​คิ​ยา
mankiyaa	มัน​คิ​ยา
simjmaa	สิม​มา
apgdi	อับ​ดี
haasaapiyaa	ฮา​ซา​ปิ​ยา
haasaapiyaa	ฮา​ซา​ปิ​ยา
melaali	เม​ลา​ลี
utgsi	อุด​ซี
melaayotq	เม​ลา​โย้ด
daabelatq	ดา​เบ​ลัด
puaa	พู​อา
yediyaaen	เย​ดี​ยา​เอน
yelimotq	เย​ลี​โม้ด
yelemotq	เย​เล​โม้ด
aalemetq	อา​เล​เม้ด
kenaaaanaa	เค​นา​อะ​นา
hupgpim	หุบ​ปิม
supqpim	ซุบ​ปิม
taahan	ทา​ฮัน
laadaan	ลา​ดาน
laadaan	ลา​ดาน
mankien	มัน​คี​เอน
yaafeletq	ยา​เฟ​เล้ด
some	โซ​เม
atgdaa	อัด​ดา
enpaaan	เอน​ปา​อัน
aahiyo	อา​หิ​โย
sejbaadiyaa	เส​บา​ดิ​ยา
ede	เอ​เด
yohaa	โย​ฮา
sinjletai	สิน​เล​ไท
yeien	เย​อี​เอน
simjli	สิม​ลี
bineaa	บิ​เน​อา
bineaa	บิ​เน​อา
eleaasaaj	เอ​เล​อา​สา
bokelu	โบ​เค​ลู
seaaliyaa	เซ​อา​ลิ​ยา
isaalaaen	อิ​สะ​ลา​เอน
yeuen	เย​อู​เอน
sanjlu	สัน​ลู
hatgsejnuaa	หัด​เส​นู​อา
mesunlaam	เม​ซุน​ลาม
sefaatiyaa	เซ​ฟา​ทิ​ยา
leuen	เล​อู​เอน
aadaayaa	อา​ดา​ยา
paatghe	ปาด​เฮ
paatghe	ปาด​เฮ
mankiyaa	มัน​คิ​ยา
matqtaaniyaa	มัด​ทา​นิ​ยา
sikgli	สิก​ลี
yedutun	เย​ดู​ทูน
yedutun	เย​ดู​ทูน
mikqlotq	มิก​โล้ด
yebutg	เย​บุด
sipgbekai	สิบ​เบ​ไค
saaanbon	ซา​อัน​โบน
eliyaabaa	เอ​ลี​ยา​บา
uaa	อู​อา
itglai	อิด​ไล
yaaaasien	ยา​อา​ซี​เอน
semaaliyaa	เซ​มา​ลิ​ยา
itgsiyaa	อิด​ซี​ยา
aasaalen	อา​ซา​เลน
yaasobeam	ยา​โซ​เบ​อัม
aabiqai	อา​บี​ไช
selomotq	เซ​โล​โม้ด
miyaamin	มิ​ยา​มิน
hakqkotg	ฮัก​โขด
yesuaa	เย​ซู​อา
binkaa	บิน​กา
petaahiyaa	เป​ทา​หิ​ยา
maaaasiyaa	มา​อา​ซิ​ยา
yaaaasiyaa	ยา​อา​ซี​ยา
kedaaliyaa	เก​ดา​ลิ​ยา
yedutun	มัด​ที​ทิ​ยา
sebuen	เซ​บู​เอน
haanaani	ฮา​นา​นี
yehohaanan	เย​โฮ​ฮา​นัน
hendai	เฮน​ได
elihu	เอ​ลี​ฮู
itgmaiaa	อิด​ไม​อา
saalomxn	ซา​โล​มอน
yapqfaa	ยับ​ฟา
kelubim	เค​ลู​บิม
isaalaaen	อิ​สะ​ลา​เอน
saalomxn	ซา​โล​มอน
yeloboam	เย​โล​โบ​อัม
maahaalatq	มา​หะ​ลัด
yelusaalem	เย​ลู​ซา​เลม
yudaa	ยู​ดา
odetg	โอ​เดด
baaaaqaa	บา​อา​ชา
yehosaafatq	เย​โฮ​ซา​ฟัด
netaaniyaa	เน​ทา​นิ​ยา
tobiyaa	โท​บี​ยา
yehosaabaatg	เย​โฮ​ซา​บาด
aahapg	อา​หับ
yaahaasien	ยา​ฮา​ซี​เอน
se	เส​คา​ลิ​ยา
se	เบ​ไน​ยา
aahatgyaa	อา​หัด​ยา
yeholam	เย​โฮ​ลัม
yehien	เย​ฮี​เอน
etiopia	เอ​ที​โอ​เปีย
yehu	เย​ฮู
yehoyaadaa	เย​โฮ​ยา​ดา
simeatg	ซิ​เม​อัด
yehoaatg	เย​โฮ​อาด
yekoliyaa	เย​โค​ลี​ยา
filisaatia	ฟี​ลิ​สะ​เตีย
maaaasejaa	มา​อา​เส​อา
mesinlemotq	เม​ซิน​เล​โม้ด
maanatqsej	มะ​นัด​เส
yosaabaatg	โย​ซา​บาด
yoaahaatg	โย​อา​หาด
yelemi	เย​เล​มี
haaditg	ฮา​ดิด
sejnaaaa	เส​นา​อา
aantaasesitq	อาน​ทา​เซ​ซี้ด
mitqledaatg	มิด​เล​ดาด
daaliatg	ดา​ลิ​อัด
hakqkai	ฮัก​ไก
aahitupq	อา​หิ​ทู้บ
aabiquwaa	อา​บี​ชู​วา
eleaasaa	เอ​เล​อา​ซา
esaalaa	เอ​สะ​ลา
aahaawaa	อา​หะ​วา
esaalaa	เอ​สะ​ลา
sapqbetai	ซับ​เบ​ไท
kelitaa	เค​ลิ​ทา
melemotq	เม​เล​โม้ด
matqtenai	มัด​เท​ไน
selemiyaa	เซ​เล​มิ​ยา
haakaaliyaa	ฮา​คา​ลิ​ยา
nehaami	เน​หะ​มี
sanjbaanlatq	สัน​บาน​ลัด
tobiaa	โท​บี​อา
mesesaaben	เม​เซ​ซา​เบน
yoyaadaa	โย​ยา​ดา
haasapqneyaa	ฮา​ซับ​เน​ยา
hatgsupq	หัด​ซู้บ
hanlohetg	ฮัน​โล​เหด
lehum	เล​ฮูม
sapgbai	สับ​ไบ
hatgsupq	หัด​ซู้บ
henaadatg	เฮ​นา​ดัด
tobiaa	โท​บี​อา
modekai	โม​เด​ไค
bikgwai	บิก​ไว
katgmien	ขัด​มี​เอน
qebaaniyaa	เช​บา​นี​ยา
selepiyaa	เซ​เล​ปี​ยา
hodiyaa	โฮ​ดี​ยา
daanien	ดา​นี​เอน
kinneton	กิน​เน​โทน
patglotq	ปัด​โล้ด
satgtu	สัด​ทู
atgkaatg	อัด​กาด
bebai	เบ​ไบ
aadin	อา​ดีน
aate	อา​เท
yaatqduwaa	ย้าด​ดู​วา
aanaayaa	อา​นา​ยา
sanjlai	สัน​ไล
yoyaalipq	โย​ยา​ลิบ
atglikam	อัด​ลี​คัม
sijhag	สี​หะ
seantien	เซ​อัน​ทิ​เอน
yoyaakim	โย​ยา​คิม
yonaataan	โย​นา​ทาน
minyaamin	มิน​ยา​มิน
hosaayaa	โฮ​ซา​ยา
matqtaaniyaa	มัด​ทา​นิ​ยา
mikaayaa	มี​คา​ยา
eliyaakim	เอ​ลี​ยา​คิม
aahaasuelatq	อา​หะ​สุ​เอ​ลัด
india	อิน​เดีย
watqqaati	วัด​ชา​ที
yekoniyaa	เย​โค​นี​ยา
modekai	โม​เด​ไค
esete	เอ​เซ​เท
esete	เอ​เซ​เท
esete	เอ​เซ​เท
kendia	เคน​เดีย
lewiaataan	เล​วี​อา​ทาน
bindatg	บิน​ดัด
naaaame	นา​อา​เม
elihu	เอ​ลี​ฮู
behemotq	เบ​เฮ​โม้ด
lebaanxn	เล​บา​นอน
kebaan	เก​บาน
menkisedekg	เมน​คี​เซ​เดก
jxdcn	จอ​แดน
efaataa	เอ​ฟา​ทา
itien	อิ​ที​เอน
itien	อิ​ที​เอน
anman	อัน​มัน
daamatqkatg	ดา​มัด​กัด
efaaim	เอ​ฟา​อิม
baabilon	บา​บี​โลน
moapg	โม​อับ
naiaa	ไน​อา
iyipq	อี​ยิบ
atgsilia	อัด​ซี​เลีย
sepqnaa	เซ้บ​นา
aalien	อา​ลี​เอน
aalien	อา​ลี​เอน
sion	สิ​โอน
isaayaa	อิ​สะ​ยา
zauj	ฟาน​เกน​เซน
baaan	บา​อัน
mankiaa	มัน​คี​อา
yosiyaa	โย​สิ​ยา
sijdaa	สี​ดา
atgkelon	อัด​เค​โลน
uliaa	อุ​ลี​อา
kemaaliyaa	เก​มา​ลิ​ยา
kolaayaa	โค​ลา​ยา
nehelaam	เน​เฮ​ลาม
sejfanyaa	เส​ฟัน​ยา
sejdekiyaa	เส​เด​คี​ยา
kendia	เคน​เดีย
neliyaa	เน​ลิ​ยา
koniyaa	โค​นิ​ยา
yehukan	เย​ฮู​คัน
benyaamin	เบน​ยา​มิน
matqtaan	มัด​ทาน
kaaleaa	คา​เล​อา
tanhumetq	ทัน​หุ​เม้ด
kaaleaa	คา​เล​อา
kedaaliyaa	เก​ดา​ลิ​ยา
taapaanhetg	ทา​ปาน​เหด
kiliyaataaim	คี​ลิ​ยา​ทา​อิม
dibon	ดี​โบน
edom	เอ​โดม
edom	เอ​โดม
baabilon	บา​บี​โลน
nebukatqnetqsaa	เน​บู​คัด​เน้ด​ซา
kebaa	เค​บา
yaaaasanyaa	ยา​อา​ซัน​ยา
oholaa	โอ​โฮ​ลา
oholibaa	โอ​โฮ​ลี​บา
etiopia	เอ​ที​โอ​เปีย
home	โฮ​เม
daanien	ดา​นี​เอน
bentesatqsaa	เบน​เท​ซัด​ซา
satqlakq	ซัด​ลัก
aabetgneko	อา​เบด​เน​โก
aabetgneko	อา​เบด​เน​โก
bensatqsaa	เบน​ซัด​ซา
kaabelyen	กา​เบ​เลียน
hoseyaa	โฮ​เซ​ยา
keliotg	เค​ลิ​โอด
kinkaan	กิน​กาน
finisia	ฟี​นี​เซีย
saajlefatq	สา​เล​ฟัด
ninaawe	นิ​นะ​เว
naahum	นา​ฮูม
libia	ลิ​เบีย
haabaakukg	ฮา​บา​กุก
yosuwaa	โย​ซู​วา
hetqlon	เฮ้ด​โลน
boaatg	โบ​อาด
jyetgsi	เจียด​ซี
eliyaakim	เอ​ลี​ยา​คิม
maaliyaa	มา​ลี​ยา
maaliyaa	มา​ลี​ยา
imaanuen	อี​มา​นู​เอน
yudia	ยู​เดีย
naasaaletq	นา​ซา​เล้ด
naasaaletq	นา​ซา​เล้ด
yohan	โย​ฮัน
yohan	โย​ฮัน
yohan	โย​ฮัน
sejbedi	เส​เบ​ดี
totqbuli	โท้ด​บุ​ลี
baatolomiu	บา​โท​โล​มิว
matqtaai	มัด​ทาย
anfeatg	อัน​เฟ​อัด
tatqdeatg	ทัด​เด​อัด
yudaatg	ยู​ดาด
isaakaaliotg	อิ​สะ​คา​ลิ​โอด
faalisij	ฟา​ลิ​สี
faalisij	ฟา​ลิ​สี
beensebun	เบ​เอน​เซ​บูน
helodyetg	เฮ​โล​เดียด
saadusij	สะ​ดู​สี
saadusij	สะ​ดู​สี
betaani	เบ​ทา​นี
kaayaafaatq	คา​ยา​ฟ้าด
yudaatg	ยู​ดาด
baalapqbatg	บา​ลับ​บัด
baalapqbatg	บา​ลับ​บัด
laamaasaabakgtaani	ลา​มา​ซา​บัก​ทา​นี
makqdaalaa	มัก​ดา​ลา
andaalu	อัน​ดา​ลู
kaapenaaum	คา​เป​นา​อุม
betgsaidaa	เบด​ไซ​ดา
hosaanaa	โฮ​ซา​นา
aalekqsaande	อา​เล้ก​ซาน​เด
matqtatq	มัด​ทัด
matqtatq	มัด​ทัด
matqtaatiatg	มัด​ทา​ที​อัด
matqtaatiatg	มัด​ทา​ที​อัด
eaa	เอ​อา
simeon	สิ​เม​โอน
apglaaham	อับ​ลา​ฮัม
naaho	นา​โฮ
leu	เล​อู
ebe	เอ​เบ
aanfaasatq	อาน​ฟา​ซัด
aadam	อา​ดัม
kelaasaa	เก​ลา​ซา
saamaalia	สะ​มา​เลีย
kaalili	กา​ลิ​ลี
sijloam	สี​โล​อัม
laasaalatq	ลา​ซา​ลัด
sakgkyetq	สัก​เคี้ยด
naataanaaen	นา​ทา​นา​เอน
nikodematq	นี​โค​เด​มัด
laasaalatq	ลา​ซา​ลัด
laasaalatq	ลา​ซา​ลัด
yudaatg	ยู​ดาด
aanaania	อา​นา​เนีย
aanaania	อา​นา​เนีย
saatefen	สะ​เท​เฟน
antiokg	อัน​ที​โอก
nikolau	นี​โค​เลา
aineatg	ไอ​เน​อัด
litqdaa	ลิด​ดา
koneliatg	โค​เน​ลิ​อัด
koneliatg	โค​เน​ลิ​อัด
sisaaliyaa	ซี​ซา​ลี​ยา
baanaabatg	บา​นา​บัด
baanaabatg	บา​นา​บัด
ikoniyum	อี​โค​นี​ยูม
maasidonia	มา​ซี​โด​เนีย
tesaalonikaa	เท​สะ​โล​นิ​กา
timotai	ทิ​โม​ไท
kolinto	โค​ลิน​โท
kaalitqpatg	คะ​ลิด​ปัด
kanlio	กัน​ลิ​โอ
aakaayaa	อา​คา​ยา
efeso	เอ​เฟ​โซ
pitgsinjlaa	ปิด​สิน​ลา
aakwinlaa	อา​ควิน​ลา
aapxlo	อา​ปอ​โล
aantemitq	อาน​เท​มิด
demetqliatg	เด​เม้ด​ลิ​อัด
beloaa	เบ​โล​อา
aalitqtaakatq	อา​ลิด​ทา​คัด
kaaiatg	กาย​อัด
tikikatg	ที​คิ​กัด
tofimatq	โต​ฟี​มัด
toatg	โต​อัด
silisia	ซี​ลี​เซีย
kaalaaudiatg	คา​ลาว​ดิ​อัด
fesaatatq	เฟ​สะ​ทัด
fesaatatq	เฟ​สะ​ทัด
aagipaa	อา​ฆี​พา
aagipaa	อา​ฆี​พา
apglaaham	อับ​ลา​ฮัม
lusiatg	ลู​สิ​อัด
saatefaanatq	สะ​เท​ฟา​นัด
aapxlo	อา​ปอ​โล
maasidonia	มา​ซี​โด​เนีย
epaafaa	เอ​ปา​ฟา
laudisia	เลา​ดี​เซีย
himeneatg	ฮี​เม​เน​อัด
kaalaatia	กา​ลา​เทีย
onesifolatq	โอ​เน​สิ​โฟ​ลัด
elatqtatq	เอ​ลัด​ทัด
miletatq	มิ​เล​ทัด
filemon	ฟี​เล​โมน
onesimatq	โอ​เน​สิ​มัด
baalaaam	บา​ลา​อัม
kaain	คา​อิน
tinb huvb	ทินฮู่ง
revg	ธีงเหฑ่ง
lrug	เจ๊าโหล่ว
buv	เนียบูง
kuq	แซงคู้
jweiq	ตอนเจว๊ย
faq	ฟุนฟะ
daub	เดาเป้ย
euvg	หญู่งๆ
zeib	เฒ้ยฟุน
fivj	ฝีงๆ
puv	เต่ยปูง
ziab	เหฒี่ยต้อง
havb	หฮญังเจ๊ย
zang	หฒั่นๆ
liub	ด๊บลิ่ว
tivb	จาตี้ง
lomb	หล่มฮวาง
myenb	ฟินเมี่ยน
miub	หมิ่วฝัง
hruj	ลุยโหว
pcvb	แปงเปย๊ย
wavq	วินวั้ง
len	ค้อยเฮลน
kapg	กั๊บจ๋าย
hog	จั๋งโห่
latg	เล์ยหลัด
penq	หละเปย๊ยเป๊น
fub	ฟูสู
scvb	แซงเยี้ยด
bwrnb	บ๊วนหม่วน
zag	ธะโป่ว
eeig	เล์ยเหญ่ย
kxg	เก๊าะเมี่ยน
huvb	ฮูงโล่ว
eiag	ฮนอยเหญียะ
sig	จาสี่
ryemb	เหฑียมย่าง
byaag	ปย๊าบย่า
taaij	องถาย
pcvg	ววนแป่ง
diaq	ปั์วเดี๊ย
maanb	ม์านหฮมวัง
zia	ม์าเธีย
yrud	ก๋อโย์ว
zunb	ธุนแกง
pxvb	ปองปั์ว
aiq	บงไอ๊
zivq	ววมฒี้ง
fivj	ด๊ามฝีง
nxmb	นอมๆ
zeq	เธียนเธะ
kanaaib	กะน้ายเธ้น
zinj	จวังหฒิน
pcv	จุนแปง
fyenb	เฌียนโย่ว
mevb	ธงเม่ง
myenb	กงเมี่ยน
zuq	ฒองฒุ
pcvb	แปงกวั้น
scvb	แซงเหฒียบ
fiub	ฟิ้วต้าน
laavg	ฌังหล่าง
havb	หฮญังๆ
syepq	เซี้ยบๆ
kovb	กงฒิ่น
lxg	ออนเหลาะ
zung	หฑยาวหฒุ่น
doq	กอนโด๊ะ
daub	เดาฮวาง
eij	แซงเอ๋ย
zovb	ธง
kxvb	ก๊องแปะ
lyenb	ค้อเลี่ยน
eeig	จ๊บเหญ่ย
qru	โชวๆ
fim	กงฟิม
gwaab	เดี๋ยงฆว่า
dyavb	เดี๋ยงก์า
fung	โซวหฌุ่น
zevj	ฒองเหฒง
tov	โพวทง
rru	ค้อยโฑว
kxb	ก๋อ
lovj	หลงๆ
zivb	เอนฒี่ง
nxi	โล์ฮนอย
syavb	เซียงฑูง
zyruq	แฒะเฒี้ยว
nxib	ฮนอยๆ
aadam	อา​ดัม
haawaa	ฮา​วา
kaain	คา​อิน
kanaaib	กะน้ายหฒวัง
aabcn	อา​แบน
enokq	เอ​โน้ก
ilaatq	อิ​ล้าด
mehujyaaen	เม​หู​ยา​เอน
metusaaen	เม​ทู​ซา​เอน
laamekq	ลา​เม้ก
aadaa	อา​ดา
sinjlaa	สิน​ลา
enotq	เอ​โน้ด
kenan	เค​นัน
maahaalaalen	มา​หะ​ลา​เลน
yaaletq	ยา​เล้ด
metusejlaa	เม​ทู​เส​ลา
noyaa	โน​ยา
yaafetq	ยา​เฟ้ด
kaanaaan	คา​นา​อัน
kome	โก​เม
maakokg	มา​โกก
maadai	มา​ได
yaawaan	ยา​วาน
tuban	ทู​บัน
mesekq	เม​เซ้ก
tilaatq	ทิ​ล้าด
atgkenatq	อัด​เค​นัด
lifaatq	ลี​ฟ้าด
tokaanmaa	โท​กาน​มา
eliseaa	เอ​ลี​เซ​อา
taansitq	ทาน​ซิด
kitqtim	คิด​ทิม
lodaanim	โล​ดา​นิม
iyipq	อี​ยิบ
sejbaa	เส​บา
haawilaa	ฮา​วิ​ลา
sapgtaa	สับ​ทา
laaaamaa	ลา​อา​มา
sapgtekaa	สับ​เท​คา
qebaa	เช​บา
dedaan	เด​ดาน
nimlotq	นิม​โล้ด
lesenj	เล​เสน
ninaawe	นิ​นะ​เว
kaalaa	คา​ลา
ludim	ลู​ดิม
aanaamim	อา​นา​มิม
lehaabim	เล​หะ​บิม
napqtuhim	นับ​ทู​ฮิม
hiwai	ฮี​ไว
aankaa	อาน​คา
sijni	สี​นี
elaam	เอ​ลาม
atgsu	อัด​ซู
aanfaasatq	อาน​ฟา​ซัด
lude	ลู​เด
aalam	อา​ลัม
kete	เก​เท
qelaa	เช​ลา
ebe	เอ​เบ
yokqtaan	โย้ก​ทาน
anmodatg	อัน​โม​ดัด
qelepq	เช​เล้บ
haasaanmaawetq	ฮา​ซาน​มา​เว้ด
yelaa	เย​ลา
haadolam	ฮา​โด​ลัม
usaan	อุ​ซาน
dikglaa	ดิก​ลา
obaan	โอ​บาน
aabimaaen	อา​บี​มา​เอน
ofi	โอ​ฟี
yobapg	โย​บับ
baaben	บา​เบน
pelekq	เป​เล้ก
leu	เล​อู
sejlukq	เส​ลุก
naaho	นา​โฮ
telaa	เท​ลา
apglaam	อับ​ลาม
haalaan	ฮา​ลาน
saalaai	ซา​ลาย
minkaa	มิน​คา
itgkaa	อิด​คา
nekepg	เน​เกบ
faalo	ฟา​โล
betgen	เบด​เอน
sojdom	โส​โดม
beilaa	เบย​ลา
komolaa	โก​โม​ลา
binsaa	บิน​ซา
atgmaa	อัด​มา
sinaapq	ซี​น้าบ
sejboyim	เส​โบ​ยิม
semebe	เซ​เม​เบ
belaa	เบ​ลา
sojaa	โส​อา
enmitqfatq	เอน​มิด​ฟัด
kaadetg	คา​เดด
haasaason	ฮา​ซา​โซน
taamaa	ทา​มา
aamaalekq	อา​มา​เล้ก
aamolai	อา​โม​ไล
sitgdim	สิด​ดิม
hobaa	โฮ​บา
daamatqkatg	ดา​มัด​กัด
kedolaaome	เค​โด​ลา​โอ​เม
saawe	ซา​เว
aane	อา​เน
etgko	เอด​โค
mamle	มัม​เล
paaib	ท้องป้าย
eliyese	เอ​ลี​เย​เซ
apglaaham	อับ​ลา​ฮัม
hitqtai	ฮิด​ไท
pelitqsi	เป​ลิด​ซี
lefaaim	เล​ฟา​อิม
haakaa	ฮา​กา
isaamaaen	อิ​สะ​มา​เอน
saalaa	ซา​ลา
kelaaaa	เก​ลา​อา
aabimelekq	อา​บี​เม​เล้ก
isakg	อี​สัก
beeqebaa	เบ​เอ​เช​บา
kesetg	เค​เสด
haaso	ฮา​โซ
pindaatg	ปิน​ดาด
yitqlaapq	ยิด​ล้าบ
betuen	เบ​ทู​เอน
lebekaa	เล​เบ​คา
kiliyaatqaanbaa	คี​ลิ​ย้าด​อาน​บา
hebolon	เฮ​โบ​โลน
sojhaaj	โส​หา
efolon	เอ​โฟ​โลน
laabaan	ลา​บาน
ketulaa	เค​ทู​ลา
yokqsaan	โย้ก​ซาน
atgsulim	อัด​ซู​ลิม
letusim	เล​ทู​ซิม
leummim	เล​อุม​มิม
mitqmaa	มิด​มา
dumaa	ดู​มา
matqsaa	มัด​ซา
haadatg	ฮา​ดัด
temaa	เท​มา
yetu	เย​ทู
naafitq	นา​ฟิด
kedemaa	เค​เด​มา
patgdaanaalam	ปัด​ดาน​อา​ลัม
esaau	เอ​ซาว
yaakopq	ยา​โค้บ
filisaatia	ฟี​ลิ​สะ​เตีย
beeli	เบ​เอ​ลี
yuditg	ยู​ดิด
elon	เอ​โลน
baasejmatq	บา​เส​มัด
laasen	ลา​เซน
laabaan	ลา​บาน
binhaa	บิน​ฮา
leaa	เล​อา
lewi	เล​วี
napqtaali	นับ​ทา​ลี
sinjpaa	สิน​ปา
dudaaim	ดู​ดา​อิม
dinaa	ดี​นา
isaalaaen	อิ​สะ​ลา​เอน
yosepq	โย​เซ้บ
seji	เส​อี
haamo	ฮา​โม
sekem	เซ​เคม
simeon	สิ​เม​โอน
efaalaataa	เอ​ฟา​ลา​ทา
benyaamin	เบน​ยา​มิน
aase	อา​เซ
elifatq	เอ​ลี​ฟัด
leuen	เล​อู​เอน
temaan	เท​มาน
omaa	โอ​มา
sejfo	เส​โฟ
naahatg	นา​หัด
zelaa	เฒ​ลา
aanaa	อา​นา
yeutg	เย​อูด
yaalaam	ยา​ลาม
kolaa	โค​ลา
oholibaamaa	โอ​โฮ​ลี​บา​มา
edom	เอ​โดม
holi	โฮ​ลี
homam	โฮ​มัม
lotaan	โล​ทาน
timnaa	ทิม​นา
sobaan	โซ​บาน
maanaahaatq	มา​นา​ฮ้าด
ebaan	เอ​บาน
qefo	เช​โฟ
onam	โอ​นัม
dison	ดี​โซน
hemdaan	เฮม​ดาน
etgbaan	เอด​บาน
itglaan	อิด​ลาน
kelaan	เค​ลาน
ese	เอ​เซ
aakaanj	อา​ขาน
disaan	ดี​ซาน
aalan	อา​ลัน
sibeon	สิ​เบ​โอน
edom	เอ​โดม
dinhaabaa	ดิน​ฮา​บา
bosaalaa	โบ​ซา​ลา
husaam	หุ​ซาม
bedatg	เบ​ดัด
moapg	โม​อับ
midyen	มี​เดียน
aawitq	อา​วี้ด
samjlaa	สัม​ลา
lehojbotg	เล​โห​โบด
saaun	ซา​อุน
akgbo	อัก​โบ
baaanhaanan	บา​อัน​ฮา​นัน
paau	ปา​อู
matqletq	มัด​เล้ด
mesaahapg	เม​ซา​หับ
anwaa	อัน​วา
yetetq	เย​เท้ด
elaa	เอ​ลา
pinon	ปี​โนน
kenatq	เค​นัด
mipqsaa	มิบ​ซา
dotaan	โด​ทาน
luben	ลู​เบน
yudaa	ยู​ดา
quaa	ชู​อา
eaa	เอ​อา
onan	โอ​นัน
kesipq	เค​ซี้บ
hipqlu	ฮิบ​ลู
naiaa	ไน​อา
haanokq	ฮา​โน้ก
panlu	ปัน​ลู
hetqlon	เฮ้ด​โลน
kaanmi	คาน​มี
yemuen	เย​มู​เอน
yaamin	ยา​มีน
ohaatg	โอ​หาด
yaakin	ยา​คีน
keson	เก​โซน
kohaatq	โค​ฮ้าด
melaali	เม​ลา​ลี
itgsaajkaa	อิด​สา​คา
tolaa	โท​ลา
puwaa	ปู​วา
iopg	อิ​โอบ
simlon	ซิม​โลน
sejbulun	เส​บู​ลุน
sejletq	เส​เล้ด
yaaleen	ยา​เล​เอน
hakqki	ฮัก​กี
suni	ซู​นี
etgbon	เอด​โบน
elei	เอ​เล​อี
aalodi	อา​โล​ดี
aaleli	อา​เล​ลี
imnaa	อิม​นา
itgwaa	อิด​วา
itgwi	อิด​วี
beliyaa	เบ​ลี​ยา
selaaaa	เซ​ลา​อา
hebe	เฮ​เบ
beke	เบ​เค
atgben	อัด​เบน
kelaa	เก​ลา
naaaamaan	นา​อา​มาน
ehai	เอ​ไฮ
loatg	โล​อัด
mapqpim	มับ​ปิม
husim	หุ​ซิม
yaasien	ยา​ซี​เอน
kuni	กุ​นี
yese	เย​เซ
sinlem	ซิน​เลม
kosen	โก​เซน
maanatqsej	มะ​นัด​เส
efaaim	เอ​ฟา​อิม
jxdcn	จอ​แดน
aataatq	อา​ท้าด
maaki	มา​คี
mose	โม​เซ
aalon	อา​โลน
lipqni	ลิบ​นี
simei	ซิ​เม​อี
maali	มา​ลี
musi	มู​ซี
itghaa	อิด​ฮา
nefekq	เน​เฟ้ก
sikgli	สิก​ลี
utgsien	อุด​ซี​เอน
misaaen	มิ​ซา​เอน
ensaafaan	เอน​ซา​ฟาน
sitgli	สิด​ลี
naason	นา​โซน
eliqebaa	เอ​ลี​เช​บา
naadapg	นา​ดับ
itaamaa	อิ​ทา​มา
atgsij	อัด​สี
enkaanaa	เอน​คา​นา
aabiyaasaapg	อา​บี​ยา​สาบ
eleaasaa	เอ​เล​อา​ซา
putien	ปู​ทิ​เอน
finehatg	ฟี​เน​หัด
len	เปย๊าเฮลน
raug	โต์วเหฑ่า
baali	บา​ลี
husopg	หุ​โสบ
laamaasetg	ลา​มา​เสด
sukgkotq	สุก​โค้ด
aabipg	อา​บีบ
milyem	มิ​เลียม
lefidim	เล​ฟี​ดิม
huaa	ฮู​อา
yosuwaa	โย​ซู​วา
yeto	เย​โท
sinaai	ซี​นาย
bovb	บง
genj	บงเหฆน
aabihu	อา​บี​ฮู
kelubim	เค​ลู​บิม
efotq	เอ​โฟ้ด
jyemb	เจียมป้าย
txv	ดามตอง
piag	ฌั้วเปียะ
faamb	ฟามปวน
uli	อุ​ลี
besaalen	เบ​ซา​เลน
setq	เซียวเซ้ด
yebutg	เย​บุด
aahisaamakq	อา​หิ​สะ​มัก
oholiapg	โอ​โฮ​ลี​อับ
laavb	ฮลางบั๊ว
jaavb	แธะจ้าง
ulim	อุ​ลิม
tummim	ทุม​มิม
puab	ปั์วฒ้าง
molekq	โม​เล้ก
selomitq	เซ​โล​มิด
dipgli	ดิบ​ลี
fivj	ป๊วนฝีง
sedee	เซ​เด​เอ
elisu	เอ​ลี​ซู
sujlisatqdai	สู​ลิ​ซัด​ได
selumien	เซ​ลู​มิ​เอน
amminaadapg	อัม​มี​นา​ดับ
zuaa	ฒู​อา
netanen	เน​ทัน​เอน
helon	เฮ​โลน
eliapg	เอ​ลี​อับ
ammihutq	อัม​มี​ฮู้ด
elisaamaa	เอ​ลี​ซา​มา
pedaasu	เป​ดา​ซู
kaamaalien	กา​มา​ลิ​เอน
kideoni	กิ​เด​โอ​นี
aabidan	อา​บี​ดัน
ammiqatqdai	อัม​มี​ชัด​ได
aahiyese	อา​หิ​เย​เซ
okaan	โอ​คาน
paakien	ปา​กี​เอน
deuen	เด​อู​เอน
eliyaasaapg	เอ​ลี​ยา​สาบ
enan	เอ​นัน
aahilaa	อา​หิ​ลา
amlaam	อัม​ลาม
elisaafaan	เอ​ลี​ซา​ฟาน
naasij	นา​สี
taabelaa	ทา​เบ​ลา
maanaa	มา​นา
kipglotqhatgtaaaawaa	ขิบ​โล้ด​หัด​ตา​อา​วา
haaselotq	ฮา​เซ​โล้ด
sakgke	สัก​เก
sammuwaa	ซัม​มุ​วา
saafatq	ซา​ฟัด
yefunne	เย​ฟุน​เน
kaalepq	คา​เล้บ
ikaan	อิ​กาน
hoseyaa	โฮ​เซ​ยา
laafu	ลา​ฟู
panti	ปัน​ที
sojdi	โส​ดี
katgdyen	กัด​เดียน
susij	สุ​สี
katgdi	กัด​ดี
kemanli	เก​มัน​ลี
ammien	อัม​มี​เอน
mikaaen	มี​คา​เอน
sejtu	เส​ทู
wopqsij	โว้บ​สี
naabi	นา​บี
keuen	เก​อู​เอน
homaa	โฮ​มา
tekg	ต๋อยเตก
daataan	ดา​ทาน
aabilam	อา​บี​ลัม
syavb	เซียงสี่
avung	เซียงอะหงุ่น
melibaa	เม​ลี​บา
kaadetg	คา​เดด
hoaa	โฮ​อา
aalaatq	อา​ล้าด
aataalim	อา​ทา​ลิม
tog	นางโตะ
zeletq	เฒ​เล้ด
matqtaanaa	มัด​ทา​นา
naahaalien	นา​หะ​ลี​เอน
baamotq	บา​โม้ด
sihonj	สิ​โหน
hetqbon	เฮ้ด​โบน
kemotq	เค​โม้ด
sipgpo	สิบ​โป
baalaakq	บา​ล้าก
baalaaam	บา​ลา​อัม
kiliyaatqhusotq	คี​ลิ​ย้าด​หุ​โซ้ด
baaan	บา​อัน
beo	เบ​โอ
kenai	เค​ไน
sitqtim	ซิด​ทิม
peo	เป​โอ
simjli	สิม​ลี
saajlu	สา​ลู
kotqbi	โค้ด​บี
sujaa	สู​อา
otgni	โอด​นี
aalotq	อา​โล้ด
yaasupq	ยา​ซู้บ
atglien	อัด​ลี​เอน
semidaa	เซ​มิ​ดา
hefe	เฮ​เฟ
hefe	เฮ​เฟ
sejlofehatg	เส​โล​เฟ​หัด
maahaalaa	มา​ฮา​ลา
hokqlaa	โฮ้ก​ลา
tilaasaa	ที​ละ​ซา
sefufaam	เซ​ฟู​ฟาม
hufaam	หุ​ฟาม
suham	ซู​ฮัม
aase	อา​เซ
kileaatg	กิ​เล​อาด
maakile	มา​คี​เล
aabaalim	อา​บา​ลิม
ewi	เอ​วี
lekem	เล​เคม
lebaa	เล​บา
txnb	ตอนหละเก๊า
etaam	เอ​ทาม
pihaahilotq	ปี​หะ​หิ​โล้ด
baaansefon	บา​อัน​เซ​โฟน
mikqdon	มิก​โดน
dofaakaa	โด​ฟะ​คา
aalutq	อา​ลู้ด
litqmaa	ลิด​มา
limmonpeletq	ลิม​โมน​เป​เล้ด
lipqnaa	ลิบ​นา
litqsaaj	ลิด​สา
kehelaataa	เค​เฮ​ลา​ทา
sefe	เซ​เฟ
haalaadaa	ฮา​ลา​ดา
makqhelotq	มัก​เฮ​โล้ด
taahatg	ทา​หัด
mitqkaa	มิด​คา
hatqmonaa	ฮัด​โม​นา
mosejlotq	โม​เส​โล้ด
beneyaaaakan	เบ​เน​ยา​อะ​คัน
hohakqkitgkaatg	โฮ​ฮัก​กีด​กาด
yotqbaataa	โย้ด​บา​ทา
apglonaa	อับ​โล​นา
esionkebe	เอ​ซี​โอน​เก​เบ
sanjmonaa	สัน​โม​นา
punon	ปู​โนน
obotg	โอ​โบด
iyeaabaalim	อี​เย​อา​บา​ลิม
dibonkaatg	ดี​โบน​กาด
anmondipglaataaim	อัน​โมน​ดิบ​ลา​ทา​อิม
nebo	เน​โบ
atgmon	อัด​โมน
meditelenyen	เม​ดิ​เต​เล​เนียน
haamatq	ฮา​มัด
sejdatg	เส​ดัด
semuen	เซ​มู​เอน
qitqlon	ชิด​โลน
elidaatg	เอ​ลี​ดาด
yokqli	โย้ก​ลี
bukgki	บุก​คี
hannien	ฮัน​นี​เอน
sipqtaan	ซิบ​ทาน
kemuen	เค​มู​เอน
paanaakq	ปา​น้าก
atgsaan	อัด​ซาน
pantien	ปัน​ที​เอน
selomi	เซ​โล​มี
aahihutq	อา​หิ​ฮู้ด
pedaahen	เป​ดา​เฮน
edeni	เอ​เดน​อี
atgtaalotq	อัด​ทา​โล้ด
baasaan	บา​ซาน
holepq	โฮ​เล้บ
emim	เอ​มิม
aanaakq	อา​น้าก
kaadetgbaania	คา​เดด​บา​เนีย
yaahaatq	ยา​ฮ้าด
aankopg	อาน​โกบ
hemon	เฮ​โมน
saidxn	ไซ​ดอน
sijlixn	สี​ลี​ออน
sejni	เส​นี
aalaabaa	อา​ลา​บา
pitgkaa	ปิด​กา
faav	เดี๋ยงฟาง
kutgkodaa	กุด​โก​ดา
puad	ขูงปั์ว
ammon	อัม​โมน
kelisim	เก​ลิ​ซิม
aamen	อา​เมน
laahapg	ลา​หับ
kinkaan	กิน​กาน
lau	โต์วเลา
yeliko	เย​ลี​โค
qebaalim	เช​บา​ลิม
sapgdi	สับ​ดี
aakaan	อา​คาน
kibeon	กิ​เบ​โอน
kefilaa	เค​ฟี​ลา
beelotq	เบ​เอ​โล้ด
kiliyaatqyeaalim	คี​ลิ​ย้าด​เย​อา​ลิม
yelusaalem	เย​ลู​ซา​เลม
aadonisedekg	อา​โด​นี​เซ​เดก
hoham	โฮ​ฮัม
yaanmutq	ยาน​มู้ด
pilaam	ปี​ลาม
laakitq	ลา​คี้ด
yaafia	ยา​เฟีย
ekglon	เอก​โลน
debi	เด​บี
betgholon	เบด​โฮ​โลน
aasekaa	อา​เซ​คา
makqkedaa	มัก​เค​ดา
aiyaalon	ไอ​ยา​โลน
kese	เก​เซ
holaam	โฮ​ลาม
yaabin	ยา​บิน
maadon	มา​โดน
akgsaapq	อัก​ซ้าบ
melom	เม​โลม
uamb	ววม
mitqlefotqmaaim	มิด​เล​โฟ้ด​มา​อิม
mitqpaa	มิด​ปา
kede	เก​เด
aadunlam	อา​ดุน​ลัม
tapqpuwaa	ทับ​ปู​วา
aafekq	อา​เฟ้ก
laasaalon	ลา​ซา​โลน
simlonmelon	ซิม​โลน​เม​โลน
taaaanaakq	ทา​อา​น้าก
mekitgdo	เม​กิด​โด
kedetg	เค​เดด
kaanmen	คาน​เมน
yokqneam	โย้ก​เน​อัม
naafotqdoaa	นา​โฟ้ด​โด​อา
doaa	โด​อา
kaalilieei	กา​ลิ​ลีเญย
koyim	โก​ยิม
kesu	เก​ซู
maaaakaa	มา​อา​คา
saajlekaa	สา​เล​คา
kedemotq	เค​เด​โม้ด
mefaaaatg	เม​ฟา​อาด
betgpeo	เบด​เป​โอ
betgyesimotq	เบด​เย​ซิ​โม้ด
baaaalaa	บา​อา​ลา
yelaalim	เย​ลา​ลิม
kesaalon	เค​สะ​โลน
betgsemetq	เบด​เซ​เม้ด
timnaahaa	ทิม​นา​ฮา
kiliyaatqsejfe	คี​ลิ​ย้าด​เส​เฟ
akgsaaj	อัก​สา
otgnien	โอด​นี​เอน
kinaa	คี​นา
dimonaa	ดี​โม​นา
aadaadaa	อา​ดา​ดา
itgnaan	อิด​นาน
sipgaa	สิบ​อา
telem	เท​เลม
beaalotq	เบ​อา​โล้ด
haasohaadatgtaa	ฮา​โซ​ฮา​ดัด​ทา
keliotghetqlon	เค​ลิ​โอด​เฮ้ด​โลน
aamam	อา​มัม
semaa	เซ​มา
molaadaa	โม​ลา​ดา
haasaankatgdaa	ฮา​ซาน​กัด​ดา
hetqmon	เฮ้ด​โมน
betgpeletq	เบด​เป​เล้ด
haasaansuaan	ฮา​ซาน​ซู​อาน
bisiotiyaa	บิ​ซิ​โอ​ทิ​ยา
iyim	อิ​ยิม
esem	เอ​เซม
entolatq	เอน​โท​ลัด
kesinj	เค​สิน
honmaa	โฮน​มา
sikglaakq	สิก​ล้าก
matqmannaa	มัด​มัน​นา
sanjsanjnaa	สัน​สัน​นา
saajnoaa	สา​โน​อา
enkannim	เอน​กัน​นิม
enaam	เอ​นาม
sojko	โส​โค
sejnan	เส​นัน
haadaaqaa	ฮา​ดา​ชา
mikqdankaatg	มิก​ดัน​กาด
dilean	ดิ​เล​อัน
yotqteen	โย้ด​เท​เอน
botgkaatq	โบด​ค้าด
kapqbon	คับ​โบน
laamam	ลา​มัม
kitqlitq	คิด​ลิด
ete	เอ​เท
aaqan	อา​ชัน
ipgtaa	อิบ​ทา
atgnaa	อัด​นา
nesipq	เน​ซี้บ
daannaa	ดาน​นา
kiliyaatqsanjnaa	คี​ลิ​ย้าด​สัน​นา
aanaapq	อา​น้าบ
etgtemoaa	เอด​เท​โม​อา
aanim	อา​นิม
aalapg	อา​หลับ
esaan	เอ​ซาน
yaanim	ยา​นิม
betgtapqpuwaa	เบด​ทับ​ปู​วา
aafekaa	อา​เฟ​คา
maaon	มา​โอน
yutqtaa	ยุด​ทา
yitqleen	ยิด​เล​เอน
yokqdeam	โย้ก​เด​อัม
hanhun	ฮัน​ฮูน
betgsujaa	เบด​สู​อา
kedo	เก​โด
yaanoaa	ยา​โน​อา
aataalotq	อา​ทา​โล้ด
naaaalaa	นา​อา​ลา
silo	ซี​โล
betghokqlaa	เบด​โฮ้ก​ลา
emekqkesitq	เอ​เม้ก​เค​ซี้ด
betgaalaabaa	เบด​อา​ลา​บา
sejmaalaaim	เส​มา​ลา​อิม
apgwim	อับ​วิม
paalaa	ปา​ลา
ofaalaa	โอ​ฟา​ลา
laamaa	ลา​มา
mosaa	โม​ซา
inpeen	อิน​เป​เอน
taalaalaa	ทา​ละ​ลา
qebaa	เช​บา
baalaa	บา​ลา
betgmaankaabotg	เบด​มาน​คา​โบด
haasaansujsaaj	ฮา​ซาน​สู​สา
haafaalaaim	ฮา​ฟา​ลา​อิม
siyon	ซี​โยน
aanaahaalaatq	อา​นา​หะ​ล้าด
lapqbitg	ลับ​บีด
kision	คี​ซิ​โอน
ebetg	เอ​เบด
lemetq	เล​เม้ด
enhatgdaa	เอน​หัด​ดา
betgpatgsetq	เบด​ปัด​เซ้ด
zeaa	เฒ​อา
hammatq	ฮัม​มัด
lakqkatq	ลัก​คัด
kinneletq	คิน​เน​เล้ด
aadaamaa	อา​ดา​มา
enhaaso	เอน​ฮา​โซ
sojlaa	โส​ลา
etgtaaon	เอด​ทา​โอน
insemetq	อิน​เซ​เม้ด
saaanbin	ซา​อัน​บิน
itglaa	อิด​ลา
ekolon	เอ​โค​โลน
enteke	เอน​เท​เค
kipgbeton	กิบ​เบ​โทน
baaaalatq	บา​อา​ลัด
yehutq	เย​ฮู้ด
benebelaakq	เบ​เน​เบ​ล้าก
katglimmon	กัด​ลิม​โมน
besekq	เบ​เซ้ก
aadonibesekq	อา​โด​นี​เบ​เซ้ก
sesai	เซ​ไซ
aahimaan	อา​หิ​มาน
tanmai	ทัน​ไม
akgko	อัก​โค
akglaapq	อัก​ล้าบ
akgsipq	อัก​ซี้บ
henbaa	เฮน​บา
lehopg	เล​โหบ
ehutq	เอ​ฮู้ด
aanaatq	อา​น้าด
samkaa	ซัม​กา
lapqpidotg	ลับ​ปิ​โดด
debolaa	เด​โบ​ลา
aabinoam	อา​บี​โน​อัม
taabo	ทา​โบ
sisejlaa	สิ​เส​ลา
kideon	กิ​เด​โอน
yoaatg	โย​อาด
uamb	ววมเฮลน
aabiyese	อา​บี​เย​เซ
zebaa	เฒ​บา
sanjmunnaa	สัน​มุน​นา
penuen	เป​นู​เอน
heletq	เฮ​เล้ด
yelupqbaaan	เย​ลุบ​บา​อัน
baaanbelitq	บา​อัน​เบ​ลี้ด
betgminlo	เบด​มิน​โล
yotaam	โย​ทาม
bee	เบ​เอ
sejbun	เส​บุน
kaaan	กา​อัน
tebetg	เท​เบด
saami	ซา​มี
jaai	จา​อี
haauwotqjaai	ฮาว​โว้ด​จา​อี
kaamon	คา​โมน
yepqtaa	เย้บ​ทา
aaloe	อา​โล​เอ
minnitq	มิน​นิด
aabenkelaamim	อา​เบน​เค​ลา​มิม
saajfon	สา​โฟน
betglehem	เบด​เล​เฮม
ipgsaan	อิบ​ซาน
pilaaton	ปิ​ลา​โทน
hinlen	ฮิน​เลน
apgdon	อับ​โดน
maanoaa	มา​โน​อา
scmsanj	แซม​สัน
lehi	เล​ฮี
laamaatqlehi	ลา​ม้าด​เล​ฮี
kaasaa	กา​ซา
sojlekq	โส​เล้ก
delilaa	เด​ลิ​ลา
mikaa	มี​คา
maahaanedaan	มา​หะ​เน​ดาน
laaitg	ลา​อิด
betglehopg	เบด​เล​โหบ
kibeaa	กิ​เบ​อา
baaantaamaa	บา​อัน​ทา​มา
yaabetgkileaatg	ยา​เบด​กิ​เล​อาด
lebonaa	เล​โบ​นา
naaomi	นา​โอ​มี
elimelekq	เอ​ลี​เม​เล้ก
ofaa	โอ​ฟา
lute	ลู​เท
maalon	มา​โลน
kilion	คิ​ลิ​โอน
jaa	เซียงจา
niaq	เฮนี้ยๆ
maalaa	มา​ลา
boaatg	โบ​อาด
zamq	ธั้มๆ
sanjmon	สัน​โมน
obetg	โอ​เบด
jyetgsi	เจียด​ซี
daawitq	ดา​วิด
eei	ป๊วนฒี่ง
eli	เอ​ลี
peninnaa	เป​นิน​นา
hannaa	ฮัน​นา
yuvd	แซงยู์ง
jeij	ฮวั้วเจ๋ย
lafapg	หละฟับดุย
saamuen	ซา​มู​เอน
atgdotg	อัด​โดด
txvj	โล์ต๋อง
aabinaadapg	อา​บี​นา​ดับ
betgkaa	เบด​คา
saulo	เซา​โล
senjsaa	เสน​ซา
dwi	กะน้ายดุย
yaabetg	ยา​เบด
naahaatg	นา​หาด
mikqmaatq	มิก​ม้าด
suan	ซู​อัน
yonaataan	โย​นา​ทาน
mikon	มิ​โกน
aahiyaa	อา​หิ​ยา
apgne	อับ​เน
aabien	อา​บี​เอน
telaaim	เท​ลา​อิม
suwaa	ซู​วา
aakakg	อา​กัก
sinb	ซินเพย
sammaa	ซัม​มา
myenb	เฮมียนฝัง
koliatg	โก​ลิ​อัด
saaaalaaim	ซา​อา​ลา​อิม
siag	เซียะโฮล
mikaan	มี​คาน
naayotq	นา​โย้ด
aahimelekq	อา​หิ​เม​เล้ก
aakitq	อา​คิด
doekg	โด​เอก
aahitupq	อา​หิ​ทู้บ
aabiyaataa	อา​บี​ยา​ทา
keilaa	เค​อี​ลา
selaahammaalekotq	เซ​ลา​ฮัม​มา​เล​โค้ด
enkedi	เอน​เก​ดี
naabaan	นา​บาน
aabikaayin	อา​บี​กา​ยิน
aahinoam	อา​หิ​โน​อัม
sejluyaa	เส​ลุ​ยา
yoaapg	โย​อาบ
aabiqai	อา​บี​ไช
maaokg	มา​โอก
sunem	ซู​เนม
kinboaa	กิน​โบ​อา
endo	เอน​โด
besoj	เบ​โส
keleti	เค​เล​ที
laamotq	ลา​โม้ด
yaatqti	ย้าด​ที
sipgmotq	สิบ​โม้ด
laakaan	ลา​คาน
yelaameen	เย​ลา​เม​เอน
bolaaqaan	โบ​ลา​ชาน
aataakq	อา​ท้าก
mankisuwaa	มัน​คี​ซู​วา
betgsaan	เบด​ซาน
yaasaa	ยา​ซา
itgbosetq	อิด​โบ​เซ้ด
maahaanaaim	มา​หะ​นา​อิม
henkatghatqsulim	เฮน​ขัด​ฮัด​ซู​ลิม
aasaajhen	อา​สา​เฮน
bitqlon	บิ๊ด​โลน
amnon	อัม​โนน
aadoniyaa	อา​โด​นี​ยา
hakqkitg	ฮัก​กีด
sefaatiyaa	เซ​ฟา​ทิ​ยา
aabitan	อา​บี​ทัน
itgleam	อิด​เล​อัม
ekglaa	เอก​ลา
kitgtaaim	กิด​ทา​อิม
limmon	ลิม​โมน
lekaapq	เล​ค้าบ
baaaanaa	บา​อา​นา
minlo	มิน​โล
sobapg	โซ​บับ
naatan	นา​ทัน
saalomxn	ซา​โล​มอน
ipghaa	อิบ​ฮา
elisuwaa	เอ​ลี​ซู​วา
eliyaadaa	เอ​ลี​ยา​ดา
elifeletq	เอ​ลี​เฟ​เล้ด
kebaa	เก​บา
utgsaa	อุด​ซา
peletqutgsaa	เป​เล้ด​อุด​ซา
obetgedom	โอ​เบด​เอ​โดม
jung	ตอนจุ่น
sijdaa	สี​ดา
sojbaa	โส​บา
haadatgese	ฮา​ดัด​เอ​เซ
yufetitg	ยู​เฟ​ติด
silia	ซี​เลีย
betaa	เบ​ทา
belotai	เบ​โล​ไท
yehoyaadaa	เย​โฮ​ยา​ดา
benaiyaa	เบ​ไน​ยา
peletq	เพ​เล้ด
sibaa	ซิ​บา
lodebaa	โล​เด​บา
mefibosetq	เม​ฟี​โบ​เซ้ด
haanun	ฮา​นูน
eliam	เอ​ลี​อัม
batgqebaa	บัด​เช​บา
uliaa	อุ​ลี​อา
yelupqbesetq	เย​ลุบ​เบ​เซ้ด
lapqbaa	ลับ​บา
apgsaalom	อับ​ซา​โลม
yonaadapg	โย​นา​ดับ
baaanhaaso	บา​อัน​ฮา​โซ
tekoaa	เท​โค​อา
itgtai	อิด​ไท
saajdokg	สา​โดก
aahimaaatg	อา​หิ​มา​อัด
aahitofen	อา​หิ​โท​เฟน
husai	หุ​ไซ
sobi	โซ​บี
lokelim	โล​เก​ลิม
baasinlai	บา​ซิน​ไล
kimhaam	คิม​ฮาม
aamaasaaj	อา​มา​สา
bikgli	บีก​ลี
ilaa	อิ​ละ
aiaa	ไอ​อา
litqpaa	ลิด​ปา
aanmoni	อาน​โม​นี
mehojlaa	เม​โห​ลา
aatglien	อาด​ลี​เอน
simehaa	ซี​เม​ฮา
aahojhai	อา​โห​ไฮ
dodo	โด​โด
haalaa	ฮา​ลา
aake	อา​เก
enhaanan	เอน​ฮา​นัน
haalotq	ฮา​โล้ด
elikaa	เอ​ลี​คา
heletqte	เฮ​เล้ด​เท
ikgketg	อิก​เขด
aanaatotq	อา​นา​โท้ด
husaa	หุ​ซา
mebunnai	เม​บุน​ไน
netofaa	เน​โท​ฟา
maahaalai	มา​หะ​ไล
libai	ลี​ไบ
kaaatg	กา​อัด
hitqdai	ฮิด​ได
aabiyanbon	อา​บี​ยัน​โบน
baahulim	บา​ฮู​ลิม
atgmaawetq	อัด​มา​เว้ด
saamaa	ซา​มา
qaalaa	ชา​ลา
aahiyam	อา​หิ​ยัม
aahatgbai	อา​หัด​ไบ
kilon	กิ​โลน
hetqlo	เฮ้ด​โล
aalaapq	อา​ล้าบ
paalai	ปา​ไล
baani	บา​นี
sejlekq	เส​เล้ก
naahaalai	นา​หะ​ไล
itglai	อิด​ไล
kaalepq	กา​เล้บ
uliyaa	อุ​ลี​ยา
yaase	ยา​เซ
taatimhotgqi	ตา​ทิม​โหด​ชี
danyaaan	ดัน​ยา​อัน
aalaaunaa	อา​ลาว​นา
aabiqaakq	อา​บี​ช้าก
aasaaliyaa	อา​ซา​ลิ​ยา
bendeke	เบน​เด​เค
maakaatq	มา​ค้าด
saaanbim	ซา​อัน​บิม
elonbetghaanan	เอ​โลน​เบด​ฮา​นัน
benhesetg	เบน​เฮ​เสด
aalupqbotg	อา​ลุบ​โบด
sojko	โส​โค
benaabinaadapg	เบน​อา​บี​นา​ดับ
taafatq	ทา​ฟัด
aahilutq	อา​หิ​ลู้ด
saajletaan	สา​เล​ทาน
aabenmeholaa	อา​เบน​เม​โฮ​ลา
yokqmeam	โย้ก​เม​อัม
itgdo	อิด​โด
aahinaadapg	อา​หิ​นา​ดับ
paaluaa	พา​ลู​อา
yehosaafatq	เย​โฮ​ซา​ฟัด
hilaam	ฮี​ลาม
lebaanxn	เล​บา​นอน
aadonilam	อา​โด​นี​ลัม
penq	เดี๋ยงเป๊น
tailaq	ไท​ละ
sion	สิ​โอน
etaanim	เอ​ทา​นิม
lebohaamatq	เล​โบ​ฮา​มัด
kaalili	กา​ลิ​ลี
kaabun	คา​บุน
iyipq	อี​ยิบ
taapenetq	ทา​เป​เน้ด
kenubatg	เก​นู​บัด
yeloboam	เย​โล​โบ​อัม
lehojboam	เล​โห​โบ​อัม
zyruq	โล์เฒี้ยว
aabiyaa	อา​บี​ยา
daavg	จาด่าง
naaaamaa	นา​อา​มา
sisakq	ซิ​ซัก
nebatg	เน​บัด
aabiyam	อา​บี​ยัม
aabiqaalom	อา​บี​ชา​โลม
aasaaj	อา​สา
baaaaqaa	บา​อา​ชา
benhaadatg	เบน​ฮา​ดัด
omli	โอม​ลี
kinatq	กี​นัด
tipqni	ทิบ​นี
saamaalia	สะ​มา​เลีย
aahapg	อา​หับ
aaselaa	อา​เซ​ลา
kelitqtaa	เค​ลี้ด​ทา
dog	โด๊ะ
eliyaa	เอ​ลี​ยา
obaadi	โอ​บา​ดี
yeseben	เย​เซ​เบน
kison	คี​โซน
nimsi	นิม​ซี
yehu	เย​ฮู
elisaa	เอ​ลี​ซา
haasaaen	ฮา​ซา​เอน
naabotg	นา​โบด
laamotqkileaatg	ลา​โม้ด​กิ​เล​อาด
imlaa	อิม​ลา
mikaayaa	มี​คา​ยา
aahatgyaa	อา​หัด​ยา
sinhi	ซิน​หิ
aasubaa	อา​ซุ​บา
baaansebupg	บา​อัน​เซ​บูบ
yolam	โย​ลัม
yeholam	เย​โฮ​ลัม
saib	ไซเตี๋ย
kehaasi	เก​หะ​ซี
teib	เต่ย
yolam	โย​ลัม
aahapg	อา​หับ
betgeketg	เบด​เอ​เขด
yehonaadapg	เย​โฮ​นา​ดับ
aannon	อาน​โนน
yehoaahaatg	เย​โฮ​อา​หาด
aataaliyaa	อา​ทา​ลิ​ยา
kaali	คา​ลี
suje	สู​เอ
sibiyaa	สิ​บี​ยา
yehoaatg	เย​โฮ​อาด
aamaasiyaa	อา​มา​ซิ​ยา
elatq	เอ​ลัด
sejkaaliyaa	เส​คา​ลิ​ยา
sanlum	ซัน​ลูม
utgsiyaa	อุด​ซี​ยา
kaadi	กา​ดี
menaahem	เม​นา​เฮม
atgsilia	อัด​ซี​เลีย
pulaa	ปู​ลา
pekaahiyaa	เป​คา​หิ​ยา
lemaaliyaa	เล​มา​ลิ​ยา
pekaa	เป​คา
tikqlatqpilesej	ทิก​ลัด​ปิ​เล​เส
iyon	อิ​โยน
aabenbetgmaaaakaa	อา​เบน​เบด​มา​อะ​คา
aahatg	อา​หัด
lesin	เล​ซิน
kiaa	คี​อา
haalaaaa	ฮา​ลา​อา
haabo	ฮา​โบ
kosaan	โก​ซาน
midia	มี​เดีย
baabilon	บา​บี​โลน
sukgkotqbenotq	สุก​โค้ด​เบ​โน้ด
kutaa	คู​ทา
nekan	เน​กัน
aasimaa	อา​ซิ​มา
apgwaa	อับ​วา
nipqhatg	นิบ​หัด
taantakq	ทาน​ทัก
sejfaanwaaim	เส​ฟาน​วา​อิม
atglammelekq	อัด​ลัม​เม​เล้ก
aanammelekq	อา​นัม​เม​เล้ก
hesekiyaa	เฮ​เซ​คี​ยา
scnmaanesej	แซน​มา​เน​เส
sennaakelipq	เซน​นา​เค​ลิบ
isaayaa	อิ​สะ​ยา
aanpatg	อาน​ปัด
henaa	เฮ​นา
ipgwaa	อิบ​วา
baalaadan	บา​ลา​ดัน
melodakgbaalaadan	เม​โล​ดัก​บา​ลา​ดัน
hepqsibaa	เฮ้บ​ซี​บา
aamon	อา​โมน
yosiyaa	โย​สิ​ยา
yedidaa	เย​ดี​ดา
aadaayaa	อา​ดา​ยา
mesunlaam	เม​ซุน​ลาม
aasaalaiyaa	อา​ซา​ไล​ยา
saafaan	ซา​ฟาน
hinkiyaa	ฮิน​คี​ยา
aahikam	อา​หิ​คัม
aasaajyaa	อา​สา​ยา
hundaa	ฮุน​ดา
haanhatq	ฮาน​ฮัด
tikqwaa	ที้ก​วา
kitglon	ขิด​โลน
sin	ป๊วนซิน
tofetq	โท​เฟ้ด
benhinnom	เบน​ฮิน​โนม
faaloneko	ฟา​โล​เน​โค
haamutaan	ฮา​มุ​ทาน
yelemi	เย​เล​มี
lipqlaa	ลิบ​ลา
yehoyaakim	เย​โฮ​ยา​คิม
sejbidaa	เส​บิ​ดา
lumaa	ลู​มา
pedaayaa	เป​ดา​ยา
yehoyaakin	เย​โฮ​ยา​คีน
nehutgtaa	เน​หุด​ทา
ennaatan	เอน​นา​ทัน
sejdekiyaa	เส​เด​คี​ยา
ewinmelodakg	เอ​วิน​เม​โล​ดัก
aanwatq	อาน​วัด
sejme	เส​เม
apglaam	อับ​ลาม
matqsaaj	มัด​สา
zefi	เฒ​ฟี
kaataam	กา​ทาม
mitqsaa	มิด​ซา
anwaan	อัน​วาน
sefi	เซ​ฟี
hamlaan	ฮัม​ลาน
binhaan	บิน​ฮาน
saajwaan	สา​วาน
yaaaakaan	ยา​อา​คาน
matqlekaa	มัด​เล​คา
mehetaaben	เม​เฮ​ทา​เบน
makqdien	มัก​ดี​เอน
ilaam	อิ​ลาม
peletq	เป​เล้ด
haamun	ฮา​มูน
etaan	เอ​ทาน
hemaan	เฮ​มาน
kaanko	คาน​โค
daandaa	ดาน​ดา
latqdai	ลัด​ได
osem	โอ​เซม
yete	เย​เท
yeliotg	เย​ลี​โอด
aandon	อาน​โดน
sejkupg	เส​กุบ
kaalepqefaalaataa	คา​เล้บ​เอ​ฟา​ลา​ทา
atghu	อัด​ฮู
aataalaa	อา​ทา​ลา
sammai	ซัม​ไม
yaadaa	ยา​ดา
aabiqu	อา​บี​ชู
aabihaain	อา​บี​ฮา​อิน
akgbaan	อัก​บาน
molitq	โม​ลิด
seleletq	เซ​เล​เล้ด
apgpaaim	อับ​ปา​อิม
itgi	อิด​อี
sesan	เซ​ซัน
akglai	อัก​ไล
yaalaahaa	ยา​ละ​ฮา
atgtai	อัด​ไท
saajbaatg	สา​บาด
efaan	เอ​ฟาน
eleaasaaj	เอ​เล​อา​สา
sisaamai	สิ​สะ​ไม
yekaamiyaa	เย​คา​มิ​ยา
laaham	ลา​ฮัม
yolaakeam	โย​ละ​เค​อัม
yaadai	ยา​ได
kesaan	เก​ซาน
peletg	เป​เหลด
efaa	เอ​ฟา
saaapg	ซา​อับ
makqbenaa	มัก​เบ​นา
qewaa	เช​วา
sanjmaa	สัน​มา
haaletq	ฮา​เล้ด
betgkaade	เบด​กา​เด
putai	ปุ​ไท
sumatq	ซู​มัด
mitqlaa	มิด​ลา
simeaa	ซิ​เม​อา
enpeletq	เอน​เป​เล้ด
nokaa	โน​กา
mankilaam	มัน​คี​ลาม
senaatqsaa	เซ​น้าด​ซา
hosaamaa	โฮ​ซา​มา
nedaabiyaa	เน​ดา​บี​ยา
sejlupqbaaben	เส​ลุบ​บา​เบน
haananyaa	ฮา​นัน​ยา
haasubaa	ฮา​ซู​บา
ohen	โอ​เฮน
belekiyaa	เบ​เล​คิ​ยา
haasaajdiyaa	ฮา​สา​ดิ​ยา
yusapqhesetg	ยู​ซับ​เฮ​เสด
pelaatiyaa	เป​ลา​ที​ยา
yesaayaa	เย​ซา​ยา
lefaiyaa	เล​ไฟ​ยา
aannan	อาน​นัน
sekaaniyaa	เซ​คา​นิ​ยา
semaiaa	เซ​ไม​อา
hatqtatq	ฮัด​ทัด
baaliyaa	บา​ลี​ยา
neaaliyaa	เน​อา​ลี​ยา
elionai	เอ​ลี​โอ​ไน
atglikam	อัด​ลี​คัม
hodaawiyaa	โฮ​ดา​วิ​ยา
eliyaasipq	เอ​ลี​ยา​ซี้บ
pelaiyaa	เป​ไล​ยา
akgkupg	อัก​ขูบ
yohaanan	โย​ฮา​นัน
delaiyaa	เด​ไล​ยา
aanaani	อา​นา​นี
leaayaa	เล​อา​ยา
yaahaatg	ยา​หาด
aahumai	อา​หุ​ไม
laahaatq	ลา​ฮ้าด
etaam	เอ​ตาม
itgmaa	อิด​มา
itgbaatg	อิด​บาด
hatqselenponi	ฮัด​เซ​เลน​โพ​นี
helaa	เฮ​ลา
zeeletq	เธ​เอ​เล้ด
etgnaan	เอด​นาน
suhaa	ซู​ฮา
mehi	เม​หิ
etgton	เอด​โทน
betglaafaa	เบด​ลา​ฟา
paasejaa	ปา​เส​อา
tehinjnaa	เท​หิน​นา
lekaa	เล​คา
sejlaiaa	เส​ไล​อา
haataatq	ฮา​ท้าด
meonotai	เม​โอ​โน​ไท
ilu	อิ​ลู
naaam	นา​อัม
yehaanlelen	เย​ฮาน​เล​เลน
sifaa	สิ​ฟา
tiliyaa	ทิ​ลี​ยา
aasaajlen	อา​สา​เลน
etglaa	เอด​ลา
meletq	เม​เล้ด
efe	เอ​เฟ
kenan	เค​นัน
maahaalaalen	มา​หะ​ลา​เลน
enokq	เอ​โน้ก
metusejlaa	เม​ทู​เส​ลา
noyaa	โน​ยา
nimlotq	นิม​โล้ด
aalam	อา​ลัม
qelaa	เช​ลา
isakg	อี​สัก
lotaan	โล​ทาน
dison	ดี​โซน
haadatg	ฮา​ดัด
mehetaaben	เม​เฮ​ทา​เบน
yudaa	ยู​ดา
amminaadapg	อัม​มี​นา​ดับ
naason	นา​โซน
sanjmon	สัน​โมน
obetg	โอ​เบด
sejluyaa	เส​ลุ​ยา
yeliotg	เย​ลี​โอด
uli	อุ​ลี
jaai	จา​อี
atghu	อัด​ฮู
aataalaa	อา​ทา​ลา
aabihaain	อา​บี​ฮา​อิน
itgi	อิด​อี
sesan	เซ​ซัน
yete	เย​เท
naatan	นา​ทัน
efaan	เอ​ฟาน
yehu	เย​ฮู
heletqte	เฮ​เล้ด​เท
sisaamai	สิ​สะ​ไม
yekaamiyaa	เย​คา​มิ​ยา
laaham	ลา​ฮัม
maaon	มา​โอน
daawitq	ดา​วิด
lehojboam	เล​โห​โบ​อัม
aabiyaa	อา​บี​ยา
aasaaj	อา​สา
aamaasiyaa	อา​มา​ซิ​ยา
aasaaliyaa	อา​ซา​ลิ​ยา
aahatg	อา​หัด
hesekiyaa	เฮ​เซ​คี​ยา
ammon	อัม​โมน
yehoyaakin	เย​โฮ​ยา​คีน
sejlupqbaaben	เส​ลุบ​บา​เบน
yesaayaa	เย​ซา​ยา
lefaiyaa	เล​ไฟ​ยา
aannan	อาน​นัน
obaadi	โอ​บา​ดี
sekaaniyaa	เซ​คา​นิ​ยา
semaiaa	เซ​ไม​อา
yaahaatg	ยา​หาด
mehi	เม​หิ
tehinjnaa	เท​หิน​นา
yaalon	ยา​โลน
itgbaa	อิด​บา
bitiyaa	บิ​ทิ​ยา
yeletq	เย​เล้ด
yekutien	เย​คู​ที​เอน
siqmon	ซิ​โมน
linnaa	ลิน​นา
benhaanan	เบน​ฮา​นัน
tilon	ทิ​โลน
sojhetg	โส​เหด
bensohetq	เบน​โซ​เฮ้ด
maalesaa	มา​เล​ซา
laaaadaa	ลา​อา​ดา
betgatgbeaa	เบด​อัด​เบ​อา
netaaim	เน​ทา​อิม
kedelaa	เก​เด​ลา
nemuen	เน​มู​เอน
yaalipq	ยา​ลี้บ
sanlum	ซัน​ลูม
mipqsamj	มิบ​สัม
mipqsamj	มิบ​สัม
hammuen	ฮัม​มู​เอน
hammuen	ฮัม​มู​เอน
sakgke	สัก​เก
tolatq	โท​ลัด
haasaansujsimj	ฮา​ซาน​สู​สิม
betgbili	เบด​บี​ลี
aayin	อา​ยิน
token	โท​เคน
mesobapg	เม​โซ​บับ
yamlekq	ยัม​เล้ก
yosaa	โย​ซา
yoen	โย​เอน
yosibiyaa	โย​ซิ​บี​ยา
yosibiyaa	โย​ซิ​บี​ยา
aasien	อา​สิ​เอน
aasien	อา​สิ​เอน
yaaaakobaa	ยา​อา​โค​บา
yesohaayaa	เย​โซ​ฮา​ยา
aadien	อา​ดี​เอน
yesimien	เย​สิ​มี​เอน
zizaa	ฒี​ฒา
zizaa	ฒี​ฒา
sifi	ซิ​ฟี
sifi	ซิ​ฟี
anlon	อัน​โลน
anlon	อัน​โลน
yedaayaa	เย​ดา​ยา
yedaayaa	เย​ดา​ยา
simli	ซิม​ลี
simli	ซิม​ลี
mikaa	มี​คา
leaayaa	เล​อา​ยา
beelaa	เบ​เอ​ลา
beelaa	เบ​เอ​ลา
saafaam	ซา​ฟาม
yaanai	ยา​ไน
huli	หุ​ลี
huli	หุ​ลี
yaaloaa	ยา​โล​อา
yaaloaa	ยา​โล​อา
kileaatg	กิ​เล​อาด
mikaaen	มี​คา​เอน
yesisai	เย​ซิ​ไซ
yesisai	เย​ซิ​ไซ
yaado	ยา​โด
yaado	ยา​โด
apgdien	อับ​ดี​เอน
aahi	อา​หิ
nodapg	โน​ดับ
elien	เอ​ลี​เอน
yaadien	ยา​ดี​เอน
finehatg	ฟี​เน​หัด
aabiquwaa	อา​บี​ชู​วา
bukgki	บุก​คี
utgsi	อุด​ซี
sejlaahiyaa	เส​ลา​หิ​ยา
sejlaahiyaa	เส​ลา​หิ​ยา
melaayotq	เม​ลา​โย้ด
aamaaliyaa	อา​มา​ลิ​ยา
aamaaliyaa	อา​มา​ลิ​ยา
saajdokg	สา​โดก
hinkiyaa	ฮิน​คี​ยา
sejlaiaa	เส​ไล​อา
yehosaadakg	เย​โฮ​ซา​ดัก
nebukatqnetqsaa	เน​บู​คัด​เน้ด​ซา
simjmaa	สิม​มา
yoaa	โย​อา
yoaa	โย​อา
itgdo	อิด​โด
zelaa	เฒ​ลา
yeaatelai	เย​อา​เท​ไล
enkaanaa	เอน​คา​นา
ebiyaasaapg	เอ​บี​ยา​สาบ
ebiyaasaapg	เอ​บี​ยา​สาบ
taahatg	ทา​หัด
ulien	อุ​ลี​เอน
ulien	อุ​ลี​เอน
utgsiyaa	อุด​ซี​ยา
aahimotq	อา​หิ​โม้ด
sojfai	โส​ไฟ
sojfai	โส​ไฟ
eliapg	เอ​ลี​อับ
yeloham	เย​โล​ฮัม
yeloham	เย​โล​ฮัม
simeaa	ซิ​เม​อา
hakqkiyaa	ฮัก​กี​ยา
hakqkiyaa	ฮัก​กี​ยา
elien	เอ​ลี​เอน
toaa	โท​อา
maahaatq	มา​ฮ้าด
maahaatq	มา​ฮ้าด
aamaasaij	อา​มา​ไส
yoen	โย​เอน
sejfanyaa	เส​ฟัน​ยา
atgsij	อัด​สี
itghaa	อิด​ฮา
kohaatq	โค​ฮ้าด
lewi	เล​วี
aasaapg	อา​สาบ
aasaapg	อา​สาบ
belekiyaa	เบ​เล​คิ​ยา
baaaasejyaa	บา​อา​เส​ยา
baaaasejyaa	บา​อา​เส​ยา
mankiyaa	มัน​คิ​ยา
etgni	เอด​นี
etgni	เอด​นี
etaan	เอ​ทาน
simjmaa	สิม​มา
keson	เก​โซน
kisi	คี​ซี
kisi	คี​ซี
apgdi	อับ​ดี
apgdi	อับ​ดี
manlukq	มัน​ลุก
haasaapiyaa	ฮา​ซา​ปิ​ยา
haasaapiyaa	ฮา​ซา​ปิ​ยา
amsi	อัม​ซี
amsi	อัม​ซี
baani	บา​นี
qeme	เช​เม
maali	มา​ลี
musi	มู​ซี
melaali	เม​ลา​ลี
utgsi	อุด​ซี
melaayotq	เม​ลา​โย้ด
hilen	ฮี​เลน
daabelatq	ดา​เบ​ลัด
maasaan	มา​ซาน
puaa	พู​อา
yediyaaen	เย​ดี​ยา​เอน
yelimotq	เย​ลี​โม้ด
ili	อิ​ลี
sejmilaa	เส​มิ​ลา
yelemotq	เย​เล​โม้ด
aalemetq	อา​เล​เม้ด
binhaan	บิน​ฮาน
kenaaaanaa	เค​นา​อะ​นา
sejtaan	เส​ทาน
aahiqaahaa	อา​หิ​ชา​ฮา
hupgpim	หุบ​ปิม
supqpim	ซุบ​ปิม
sejlofehatg	เส​โล​เฟ​หัด
pelctq	เป​แล้ด
qeletq	เช​เล้ด
pelctq	เป​แล้ด
ulaam	อุ​ลาม
laakem	ลา​เคม
hammoleketq	ฮัม​โม​เล​เค้ด
itghotq	อิด​โฮ้ด
aahiyan	อา​หิ​ยัน
likqhi	ลิก​ฮี
aaniyam	อา​นี​ยัม
qeelaa	เช​เอ​ลา
utgsenqeelaa	อุด​เซน​เช​เอ​ลา
lefaa	เล​ฟา
lefaa	เล​ฟา
lesepq	เล​เซ้บ
lesepq	เล​เซ้บ
telaa	เท​ลา
taahan	ทา​ฮัน
laadaan	ลา​ดาน
laadaan	ลา​ดาน
ammihutq	อัม​มี​ฮู้ด
binsaaitg	บิน​ซา​อิด
mankien	มัน​คี​เอน
yaafeletq	ยา​เฟ​เล้ด
some	โซ​เม
hotaam	โฮ​ทาม
paasakg	ปา​สัก
bimhaan	บิม​ฮาน
atgwaatq	อัด​ว้าด
lokaa	โล​กา
yehupqbaa	เย​ฮุบ​บา
helem	เฮ​เลม
sojfaa	โส​ฟา
qeeletq	เช​เอ​เล้ด
aaman	อา​มัน
suaa	สุ​อา
haannefe	ฮาน​เน​เฟ
beli	เบ​ลี
bese	เบ​เซ
sinsaa	ซิน​ซา
pitgpaa	ปิด​ปา
aalaa	อา​ลา
unlaa	อุน​ลา
lisiaj	ลี​เสีย
nohaa	โน​ฮา
laafaa	ลา​ฟา
atgdaa	อัด​ดา
aabihutq	อา​บี​ฮู้ด
aahojaa	อา​โห​อา
sefufaan	เซ​ฟู​ฟาน
hulaam	หุ​ลาม
kelaa	เก​ลา
saahaalaaim	ซา​หะ​ลา​อิม
baaaalaaaa	บา​อา​ลา​อา
hodetg	โฮ​เดด
sibia	สิ​เบีย
mesaa	เม​ซา
mankaam	มัน​คาม
yeutge	เย​อุด​เอ
saajkia	สา​เคีย
minmaa	มิน​มา
aabitupq	อา​บี​ทู้บ
enpaaan	เอน​ปา​อัน
aahiyo	อา​หิ​โย
saasakq	ซา​ซัก
sejbaadiyaa	เส​บา​ดิ​ยา
ede	เอ​เด
itgpaa	อิด​ปา
yohaa	โย​ฮา
hitqki	ฮิด​คี
itgmelai	อิด​เม​ไล
isaaliyaa	อิ​สะ​ลิ​ยา
yaakim	ยา​คิม
eliyenai	เอ​ลี​เย​ไน
sinjletai	สิน​เล​ไท
belaiaa	เบ​ไล​อา
simlaatq	ซิม​ล้าด
itgpaan	อิด​ปาน
haanan	ฮา​นัน
antotiyaa	อัน​โท​ที​ยา
ipgdaiyaa	อิบ​ได​ยา
samselai	ซัม​เซ​ไล
sehaaliyaa	เซ​หะ​ลี​ยา
yaaaalesiyaa	ยา​อา​เล​ซี​ยา
yeien	เย​อี​เอน
sejke	เส​เค
saulo	เซา​โล
etgbaaan	เอด​บา​อัน
melipqbaaan	เม​ลิบ​บา​อัน
melipqbaaan	เม​ลิบ​บา​อัน
piton	ปิ​โทน
melekq	เม​เล้ก
taalia	ทา​เลีย
yehoatgdaa	เย​โฮ​อัด​ดา
yehoatgdaa	เย​โฮ​อัด​ดา
simjli	สิม​ลี
bineaa	บิ​เน​อา
bineaa	บิ​เน​อา
laafaa	ลา​ฟา
eleaasaaj	เอ​เล​อา​สา
aasen	อา​เซน
bokelu	โบ​เค​ลู
seaaliyaa	เซ​อา​ลิ​ยา
isaalaaen	อิ​สะ​ลา​เอน
yeuen	เย​อู​เอน
sanjlu	สัน​ลู
hodaawiyaa	โฮ​ดา​วิ​ยา
hatgsejnuaa	หัด​เส​นู​อา
ipgneyaa	อิบ​เน​ยา
ipgneyaa	อิบ​เน​ยา
elaa	เอ​ลา
mikqli	มิก​ลี
mikqli	มิก​ลี
mesunlaam	เม​ซุน​ลาม
sefaatiyaa	เซ​ฟา​ทิ​ยา
leuen	เล​อู​เอน
ipgniyaa	อิบ​นี​ยา
yehoyaalipq	เย​โฮ​ยา​ลิบ
aadaayaa	อา​ดา​ยา
paatghe	ปาด​เฮ
paatghe	ปาด​เฮ
mankiyaa	มัน​คิ​ยา
maaaasaij	มะ​อา​ไส
maaaasaij	มะ​อา​ไส
aadien	อา​ดี​เอน
yaaselaa	ยา​เซ​ลา
yaaselaa	ยา​เซ​ลา
mesinlemitq	เม​ซิน​เล​มิด
mesinlemitq	เม​ซิน​เล​มิด
imme	อิม​เม
bakgbakgkaa	บัก​บัก​คา
heletqsej	เฮ​เล้ด​เส
kaalaan	กา​ลาน
matqtaaniyaa	มัด​ทา​นิ​ยา
sikgli	สิก​ลี
kaalaan	กา​ลาน
yedutun	เย​ดู​ทูน
yedutun	เย​ดู​ทูน
yeien	เย​อี​เอน
mikqlotq	มิก​โล้ด
yaalaa	ยา​ลา
yaalaa	ยา​ลา
yebutg	เย​บุด
patgdammim	ปัด​ดัม​มิม
sammotq	ซัม​โม้ด
pelon	เป​โลน
sipgbekai	สิบ​เบ​ไค
ilai	อิ​ไล
itai	อิ​ไท
hulai	หุ​ไล
aanbaa	อาน​บา
saaanbon	ซา​อัน​โบน
eliyaabaa	เอ​ลี​ยา​บา
kimso	กิม​โซ
haasem	ฮา​เซม
saaki	ซา​กี
saajkaa	สา​คา
uaa	อู​อา
elifan	เอ​ลี​ฟัน
mekelaa	เม​เค​ลา
etgbai	เอด​ไบ
naaaalai	นา​อา​ไล
haaki	ฮา​กี
mipqhaa	มิบ​ฮา
itglai	อิด​ไล
sisaaaa	ซิ​ซา​อา
aadinaa	อา​ดี​นา
mitqne	มิด​เน
yosaafatq	โย​ซา​ฟัด
tisai	ทิ​ไซ
maahaawai	มา​หะ​ไว
ennaaam	เอน​นา​อัม
yelibai	เย​ลี​ไบ
yosaawiyaa	โย​ซา​วิ​ยา
mesobai	เม​โซ​ไบ
yaaaasien	ยา​อา​ซี​เอน
semaaaa	เซ​มา​อา
yesien	เย​ซี​เอน
peletg	เพ​เหลด
belaakaa	เบ​ลา​คา
elusai	เอ​ลู​ไซ
beanyaa	เบ​อัน​ยา
semaaliyaa	เซ​มา​ลิ​ยา
haalupq	ฮา​ลู้บ
itgsiyaa	อิด​ซี​ยา
aasaalen	อา​ซา​เลน
yoese	โย​เอ​เซ
yaasobeam	ยา​โซ​เบ​อัม
yoelaa	โย​เอ​ลา
mitqmannaa	มิด​มัน​นา
ensaabaatg	เอน​ซา​บาด
makqbannai	มัก​บัน​ไน
kidon	คิ​โดน
beenyaadaa	เบ​เอน​ยา​ดา
kenaaniyaa	เค​นา​นี​ยา
aabiqai	อา​บี​ไช
silia	ซี​เลีย
saataan	ซา​ตาน
selomotq	เซ​โล​โม้ด
haasien	ฮา​ซี​เอน
kesom	เก​โซม
haalim	ฮา​ลิม
sejolim	เส​โอ​ลิม
miyaamin	มิ​ยา​มิน
hakqkotg	ฮัก​โขด
yesuaa	เย​ซู​อา
hupgpaa	หุบ​ปา
yesebeapg	เย​เซ​เบ​อับ
binkaa	บิน​กา
hesi	เฮ​ซี
hapgpitgsetq	หับ​ปิด​เซ้ด
petaahiyaa	เป​ทา​หิ​ยา
yeheseken	เย​เฮ​เซ​เคน
kaamun	กา​มุน
maaaasiyaa	มา​อา​ซิ​ยา
yaaaasiyaa	ยา​อา​ซี​ยา
beno	เบ​โน
kedaaliyaa	เก​ดา​ลิ​ยา
yesaayaa	เส​ลี
yedutun	มัด​ที​ทิ​ยา
bukgkiyaa	บุก​คี​ยา
sebuen	เซ​บู​เอน
haanaani	ฮา​นา​นี
eliyaataa	เอ​ลี​ยา​ทา
kitgdaanti	กิด​ดาน​ที
lomamtiese	โล​มัม​ที​เอ​เซ
yotqbekaasaa	โย้ด​เบ​คา​ซา
manloti	มัน​โล​ที
hoti	โฮ​ที
maahaasiotg	มา​หะ​ซิ​โอด
yehohaanan	เย​โฮ​ฮา​นัน
elihonai	เอ​ลี​โฮ​ไน
peunletai	เป​อุน​เล​ไท
hosaaj	โฮ​สา
sanleketq	ซัน​เล​เค้ด
ye	เย​ฮี​เอ​ลี
yoen	เส​ทาม
yeliyaa	เย​ลี​ยา
sapgdien	สับ​ดี​เอน
isaalaa	อิ​สะ​ลา
samhutg	ซัม​หุด
hendai	เฮน​ได
elihu	เอ​ลี​ฮู
itgmaiaa	อิด​ไม​อา
kelupq	เค​ลู้บ
esaali	เอ​สะ​ลี
sefaam	เซ​ฟาม
obin	โอ​บิน
melonotq	เม​โล​โน้ด
aanki	อาน​คี
saalomxn	ซา​โล​มอน
tailaq	ไท​ละ
yapqfaa	ยับ​ฟา
kelubim	เค​ลู​บิม
kelubim	เค​ลู​บิม
saalomxn	ซา​โล​มอน
isaalaaen	อิ​สะ​ลา​เอน
haamatqsojbaa	ฮา​มัด​โส​บา
betgholon	เบด​โฮ​โลน
saalomxn	ซา​โล​มอน
sekem	เซ​เคม
yeloboam	เย​โล​โบ​อัม
lehojboam	เล​โห​โบ​อัม
aadolaaim	อา​โด​ลา​อิม
maahaalatq	มา​หะ​ลัด
maahaalatq	มา​หะ​ลัด
maahaalatq	มา​หะ​ลัด
saajham	สา​ฮัม
maaaakaa	มา​อา​คา
atqtai	อั๊ด​ไท
yelusaalem	เย​ลู​ซา​เลม
yudaa	ยู​ดา
sejfaataa	เส​ฟา​ทา
odetg	โอ​เดด
baaaaqaa	บา​อา​ชา
yehosaafatq	เย​โฮ​ซา​ฟัด
netaaniyaa	เน​ทา​นิ​ยา
semilaamotq	เซ​มิ​ลา​โม้ด
yehonaatan	เย​โฮ​นา​ทัน
tobiyaa	โท​บี​ยา
topqaadoniyaa	โท้บ​อา​โด​นิ​ยา
yehosaabaatg	เย​โฮ​ซา​บาด
aahapg	อา​หับ
laamotqkileaatg	ลา​โม้ด​กิ​เล​อาด
meuni	เม​อู​นี
txvj	เซียงต๋อง
yaahaasien	ยา​ฮา​ซี​เอน
aahatgyaa	อา​หัด​ยา
yeholam	เย​โฮ​ลัม
yehien	เย​ฮี​เอน
aasaaliyaahu	อา​ซา​ลี​ยา​ฮู
yeholam	เย​โฮ​ลัม
etiopia	เอ​ที​โอ​เปีย
yeholam	เย​โฮ​ลัม
aahapg	อา​หับ
yolam	โย​ลัม
yolam	โย​ลัม
yehu	เย​ฮู
yehoyaadaa	เย​โฮ​ยา​ดา
simeatg	ซิ​เม​อัด
simlitq	ซิม​ลิด
yehoaatg	เย​โฮ​อาด
yehoaatg	เย​โฮ​อาด
aamaasiyaa	อา​มา​ซิ​ยา
laakitq	ลา​คี้ด
yekoliyaa	เย​โค​ลี​ยา
yapqne	ยับ​เน
filisaatia	ฟี​ลิ​สะ​เตีย
kuaabaaan	กู​อา​บา​อัน
utgsiyaa	อุด​ซี​ยา
aamxtq	อา​ม้อด
ofen	โอ​เฟน
yotaam	โย​ทาม
maaaasejaa	มา​อา​เส​อา
mesinlemotq	เม​ซิน​เล​โม้ด
yehitqkiyaa	เย​ฮิด​คี​ยา
hatglai	หัด​ไล
konaaniyaa	โค​นา​นิ​ยา
kole	โค​เล
sennaakelipq	เซน​นา​เค​ลิบ
diaq	ปั์วเดี๊ย
hesekiyaa	เฮ​เซ​คี​ยา
maanatqsej	มะ​นัด​เส
aamon	อา​โมน
haasaabiyaa	ฮา​ซา​บี​ยา
yosaabaatg	โย​ซา​บาด
neko	เน​โค
kaankemitq	คาน​เค​มิด
yoaahaatg	โย​อา​หาด
yelemi	เย​เล​มี
pesia	เป​เซีย
sailatq	ไซ​ลัด
makqbitg	มัก​บีด
haaditg	ฮา​ดิด
ono	โอ​โน
sejnaaaa	เส​นา​อา
aantaasesitq	อาน​ทา​เซ​ซี้ด
bitglaam	บิด​ลาม
mitqledaatg	มิด​เล​ดาด
taabeen	ทา​เบ​เอน
aantaasesitq	อาน​ทา​เซ​ซี้ด
aantaasesitq	อาน​ทา​เซ​ซี้ด
daaliatg	ดา​ลิ​อัด
ekgbaataanaa	เอก​บา​ทา​นา
hakqkai	ฮัก​ไก
yiutai	ยิว​ไท
aahitupq	อา​หิ​ทู้บ
maalaayotq	มา​ลา​โย้ด
aabiquwaa	อา​บี​ชู​วา
eleaasaa	เอ​เล​อา​ซา
esaalaa	เอ​สะ​ลา
aahaawaa	อา​หะ​วา
esaalaa	เอ​สะ​ลา
esaalaa	เอ​สะ​ลา
yaasaiaa	ยา​ไซ​อา
sapqbetai	ซับ​เบ​ไท
kelaayaa	เค​ลา​ยา
kelitaa	เค​ลิ​ทา
bedaiyaa	เบ​ได​ยา
keluhi	เค​ลุ​ฮี
waaniyaa	วา​นิ​ยา
melemotq	เม​เล​โม้ด
matqtenai	มัด​เท​ไน
yaaaasu	ยา​อา​สุ
selemiyaa	เซ​เล​มิ​ยา
makqnaadebai	มัก​นา​เด​ไบ
saasai	ซา​ไซ
saalai	ซา​ไล
selemiyaa	เซ​เล​มิ​ยา
haakaaliyaa	ฮา​คา​ลิ​ยา
nehaami	เน​หะ​มี
kitqlepq	คิด​เล้บ
susaaj	สุ​สา
nisaanj	นิ​สาน
sanjbaanlatq	สัน​บาน​ลัด
tobiaa	โท​บี​อา
kesem	เก​เซม
imli	อิม​ลี
mesesaaben	เม​เซ​ซา​เบน
yoyaadaa	โย​ยา​ดา
besojdaiaa	เบ​โส​ได​อา
yesaanaa	เย​ซา​นา
haalumapq	ฮา​ลุ​มับ
haasapqneyaa	ฮา​ซับ​เน​ยา
paahatgmoapg	ปา​หัด​โม​อับ
hatgsupq	หัด​ซู้บ
hanlohetg	ฮัน​โล​เหด
lehum	เล​ฮูม
sapgbai	สับ​ไบ
baalukq	บา​ลุก
hatgsupq	หัด​ซู้บ
aanaaniyaa	อา​นา​นี​ยา
henaadatg	เฮ​นา​ดัด
binnwi	บิน​นุย
usai	อุ​ไซ
paalaan	ปา​ลาน
paalotq	ปา​โล้ด
saajlaapq	สา​ล้าบ
tobiaa	โท​บี​อา
noatgyaa	โน​อัด​ยา
laaaamiaa	ลา​อา​มี​อา
naahaamaani	นา​หะ​มา​นี
modekai	โม​เด​ไค
binsaan	บิน​ซาน
mitqpeletq	มิด​เป​เล้ด
bikgwai	บิก​ไว
nehum	เน​ฮูม
betgatgmaawetq	เบด​อัด​มา​เว้ด
katgmien	ขัด​มี​เอน
qebaaniyaa	เช​บา​นี​ยา
bunni	บุน​นี
selepiyaa	เซ​เล​ปี​ยา
kenaani	เค​นา​นี
katgmien	ขัด​มี​เอน
selepiyaa	เซ​เล​ปี​ยา
hodiyaa	โฮ​ดี​ยา
qebaaniyaa	เช​บา​นี​ยา
daanien	ดา​นี​เอน
kinneton	กิน​เน​โทน
binkai	บิน​ไก
beninu	เบ​นิ​นู
patglotq	ปัด​โล้ด
satgtu	สัด​ทู
atgkaatg	อัด​กาด
bebai	เบ​ไบ
aadin	อา​ดีน
aate	อา​เท
haasum	ฮา​ซูม
besai	เบ​ไซ
haalipq	ฮา​ลิบ
nebai	เน​ไบ
makqbiaatg	มัก​บี​อาด
yaatqduwaa	ย้าด​ดู​วา
aanaayaa	อา​นา​ยา
pinhaaj	ปิน​หา
sobekg	โซ​เบก
haasapqnaa	ฮา​ซับ​นา
aahiaa	อา​หิ​อา
aanan	อา​นัน
kapgbai	กับ​ไบ
sanjlai	สัน​ไล
yoyaalipq	โย​ยา​ลิบ
atglikam	อัด​ลี​คัม
sapgdi	สับ​ดี
bakgbukiyaa	บัก​บู​คิ​ยา
apgdaa	อับ​ดา
sijhag	สี​หะ
kitgpaa	กิด​ปา
betgpeletg	เบด​เพ​เหลด
enlimmon	เอน​ลิม​โมน
sejboim	เส​โบ​อิม
nebanlatq	เน​บัน​ลัด
seantien	เซ​อัน​ทิ​เอน
kinnetxi	กิน​เน​ทอย
maaaadiyaa	มา​อา​ดี​ยา
yoyaakim	โย​ยา​คิม
yoyaakim	โย​ยา​คิม
eliyaasipq	เอ​ลี​ยา​ซี้บ
yoyaadaa	โย​ยา​ดา
yonaataan	โย​นา​ทาน
yoyaakim	โย​ยา​คิม
melaayaa	เม​ลา​ยา
manluki	มัน​ลู​คี
henkaai	เฮน​คาย
minyaamin	มิน​ยา​มิน
moatgyaa	โม​อัด​ยา
pintai	ปิน​ไท
kaanlai	คาน​ไล
aamokq	อา​โม้ก
tanmon	ทัน​โมน
betgkinkaan	เบด​กิน​กาน
hosaayaa	โฮ​ซา​ยา
matqtaaniyaa	มัด​ทา​นิ​ยา
mikaayaa	มี​คา​ยา
eliyaakim	เอ​ลี​ยา​คิม
minyaamin	มิน​ยา​มิน
yitqsaalaayaa	ยิด​สะ​ลา​ยา
atgdotg	อัด​โดด
aahaasuelatq	อา​หะ​สุ​เอ​ลัด
india	อิน​เดีย
aahaasuelatq	อา​หะ​สุ​เอ​ลัด
susaaj	สุ​สา
watqqaati	วัด​ชา​ที
aahaasuelatq	อา​หะ​สุ​เอ​ลัด
watqqaati	วัด​ชา​ที
kaansenaa	คาน​เซ​นา
qetaa	เช​ทา
atgmaataa	อัด​มา​ทา
maansejnaa	มาน​เส​นา
memukaan	เม​มู​คาน
pesia	เป​เซีย
memukaan	เม​มู​คาน
watqqaati	วัด​ชา​ที
yekoniyaa	เย​โค​นี​ยา
modekai	โม​เด​ไค
esete	เอ​เซ​เท
hekai	เฮ​ไก
esete	เอ​เซ​เท
esete	เอ​เซ​เท
tebetq	เท​เบ๊ด
esete	เอ​เซ​เท
esete	เอ​เซ​เท
esete	เอ​เซ​เท
esete	เอ​เซ​เท
esete	เอ​เซ​เท
modekai	โม​เด​ไค
bikgtaan	บิก​ทาน
teletq	เท​เล้ด
esete	เอ​เซ​เท
esete	เอ​เซ​เท
haamaan	ฮา​มาน
haamaan	ฮา​มาน
puaa	ปู​อา
haamaan	ฮา​มาน
haataakq	ฮา​ท้าก
haataakq	ฮา​ท้าก
haataakq	ฮา​ท้าก
bikgtaanaa	บิก​ทา​นา
paanqandaataa	ปาน​ชัน​ดา​ทา
daanfon	ดาน​โฟน
atgpaataa	อัด​ปา​ทา
polaataa	โป​ลา​ทา
aadanyaa	อา​ดัน​ยา
aalidaataa	อา​ลี​ดา​ทา
paanmatqtaa	ปาน​มัด​ทา
aalisaij	อา​ลี​ไส
aalidai	อา​ลี​ได
waisaataa	ไว​ซา​ทา
pulim	ปู​ลิม
pulim	ปู​ลิม
kendia	เคน​เดีย
lewiaataan	เล​วี​อา​ทาน
quwaa	ชู​วา
bindatg	บิน​ดัด
naaaame	นา​อา​เม
elihu	เอ​ลี​ฮู
behemotq	เบ​เฮ​โม้ด
selaa	เซ​ลา
selaa	เซ​ลา
txb	ตอเหฒี่ย
myenb	ฒุ์ยเมี่ยน
lebaanxn	เล​บา​นอน
silion	ซี​ลี​โอน
tonj	ตั๋งต๋น
misaa	มิ​ซา
kebaan	เก​บาน
olepq	โอ​เล้บ
sejepg	เส​เอบ
saanjmunnaa	สาน​มุน​นา
aamen	อา​เมน
laavg	ววมหล่าง
menkisedekg	เมน​คี​เซ​เดก
jxdcn	จอ​แดน
daaletq	ดา​เล้ด
laametq	ลา​เม้ด
yaakopq	ยา​โค้บ
efaataa	เอ​ฟา​ทา
yaaaa	ยา​อา
qiaj	ซีงเฉีย
pwrng	ฟุป่วน
faauj	ก๊องหฌาว
yaake	ยา​เค
aaku	อา​กู
itien	อิ​ที​เอน
itien	อิ​ที​เอน
ukaan	อู​คาน
lemuen	เล​มู​เอน
saalon	ซา​โลน
janb	จั๋น
anman	อัน​มัน
sulem	ซู​เลม
sulem	ซู​เลม
bcvj	หละเปย๊ยแบ๋ง
txvb	สี่ต้อง
zyruq	ปี๋งเธี้ยว
waav	เปย๊าฮวาง
tomb	ววมต้ม
lemaaliyaa	เล​มา​ลิ​ยา
daamatqkatg	ดา​มัด​กัด
maahesaalaanhatgbatg’	มา​เฮ​ซา​ลาน​หัด​บัด’
nxmb	ตาวน่อม
efaaim	เอ​ฟา​อิม
kaanno	คาน​โน
vaaid	แป่งง์าย
donj	เดี๋ยงด๋น
aiyaatq	ไอ​ย้าด
matqmenaa	มัด​เม​นา
kebim	เก​บิม
baabilon	บา​บี​โลน
moapg	โม​อับ
moapg	โม​อับ
ekglaaim	เอก​ลา​อิม
beeelim	เบ​เอ​เอ​ลิม
kinhaalesetq	คีน​หะ​เล​เซ้ด
naiaa	ไน​อา
iyipq	อี​ยิบ
atgsilia	อัด​ซี​เลีย
ywavb	ฮยวังเฮยี้ยน
sepqnaa	เซ้บ​นา
naavj	ไลหฮนาง
lewiaataan	เล​วี​อา​ทาน
aalien	อา​ลี​เอน
aalien	อา​ลี​เอน
jiaq	หฑยาวเจี๊ยะ
sion	สิ​โอน
isaayaa	อิ​สะ​ยา
saipatg	ไซ​ปัด
jxib	เปี๊ยวจ้อย
riab	เฑียววม
kcv	โล์แกง
yufetitg	ยู​เฟ​ติด
baaan	บา​อัน
halrub	เนียหะโล่ว
zauj	ปั์วเหฒา
mankiaa	มัน​คี​อา
yosiyaa	โย​สิ​ยา
sijdaa	สี​ดา
atgkelon	อัด​เค​โลน
uliaa	อุ​ลี​อา
elaasaa	เอ​ลา​ซา
kemaaliyaa	เก​มา​ลิ​ยา
kolaayaa	โค​ลา​ยา
nehelaam	เน​เฮ​ลาม
sejfanyaa	เส​ฟัน​ยา
nehelaam	เน​เฮ​ลาม
puvb	ปู๋งหฒัวะ
koaa	โก​อา
sejdekiyaa	เส​เด​คี​ยา
kendia	เคน​เดีย
ikgdaaliyaa	อิก​ดา​ลิ​ยา
neliyaa	เน​ลิ​ยา
baalukq	บา​ลุก
kxg	เก๊าะเมี่ยน
baalukq	บา​ลุก
baalukq	บา​ลุก
baalukq	บา​ลุก
koniyaa	โค​นิ​ยา
yehukan	เย​ฮู​คัน
benyaamin	เบน​ยา​มิน
iliyaa	อิ​ลี​ยา
matqtaan	มัด​ทาน
ebetgmelekq	เอ​เบด​เม​เล้ก
ebetgmelekq	เอ​เบด​เม​เล้ก
ebetgmelekq	เอ​เบด​เม​เล้ก
yelemi	เย​เล​มี
nekansaalese	เน​กัน​ซา​เล​เซ
samjkaanebo	สัม​กา​เน​โบ
saanjsejkim	สาน​เส​คิม
nekansaalese	เน​กัน​ซา​เล​เซ
kaaleaa	คา​เล​อา
tanhumetq	ทัน​หุ​เม้ด
efaai	เอ​ฟาย
yesanyaa	เย​ซัน​ยา
kaaleaa	คา​เล​อา
kedaaliyaa	เก​ดา​ลิ​ยา
taapaanhetg	ทา​ปาน​เหด
taapaanhetg	ทา​ปาน​เหด
memfitq	เมม​ฟิด
aapitg	อา​ปิด
kiliyaataaim	คี​ลิ​ยา​ทา​อิม
matqmen	มัด​เมน
luhitg	ลู​หิด
holonaaim	โฮ​โล​นา​อิม
kemotq	เค​โม้ด
dibon	ดี​โบน
betgdipglaataaim	เบด​ดิบ​ลา​ทา​อิม
kiliyaataaim	คี​ลิ​ยา​ทา​อิม
betgkaamun	เบด​กา​มุน
betgmeon	เบด​เม​โอน
sipgmaa	สิบ​มา
yaase	ยา​เซ
eleaale	เอ​เล​อา​เล
holonaaim	โฮ​โล​นา​อิม
ekglatqselisiyaa	เอก​ลัด​เซ​ลี​ซี​ยา
nimlim	นิม​ลิม
edom	เอ​โดม
edom	เอ​โดม
elaam	เอ​ลาม
jyemb	เจียมฒ้าน
fxvb	ฟองธัง
baabilon	บา​บี​โลน
maasejyaa	มา​เส​ยา
nebukatqnetqsaa	เน​บู​คัด​เน้ด​ซา
pwrnb	ป๊วนกั๊วะ
scvb	แซงฮม์
kebaa	เค​บา
kebaa	เค​บา
yaaaasanyaa	ยา​อา​ซัน​ยา
lwib	ลุยจั๊วะ
baamaa	บา​มา
oholaa	โอ​โฮ​ลา
oholibaa	โอ​โฮ​ลี​บา
oholaa	โอ​โฮ​ลา
oholibaa	โอ​โฮ​ลี​บา
oholaa	โอ​โฮ​ลา
oholibaa	โอ​โฮ​ลี​บา
oholaa	โอ​โฮ​ลา
oholibaa	โอ​โฮ​ลี​บา
oholi	โอ​โฮ​ลี
oholibaa	โอ​โฮ​ลี​บา
esejken	เอ​เส​เคน
betgtokaanmaa	เบด​โท​กาน​มา
kaanbun	กาน​บุน
etiopia	เอ​ที​โอ​เปีย
pelusyem	เป​ลู​เซียม
pelusyem	เป​ลู​เซียม
pibesetg	พี​เบ​เสด
scvb	แซงเธี้ยด
tweiq	เดี๋ยงเตว๊ย
miab	เมี้ยเธี้ยง
home	โฮ​เม
home	โฮ​เม
home	โฮ​เม
sekenj	เซ​เขน
sekenj	เซ​เขน
sekenj	เซ​เขน
sekenj	เซ​เขน
sekenj	เซ​เขน
minaa	มี​นา
sekenj	เซ​เขน
home	โฮ​เม
home	โฮ​เม
home	โฮ​เม
atgpenatq	อัด​เป​นัด
hannanyaa	ฮัน​นัน​ยา
daanien	ดา​นี​เอน
daanien	ดา​นี​เอน
bentesatqsaa	เบน​เท​ซัด​ซา
daanien	ดา​นี​เอน
satqlakq	ซัด​ลัก
mesaakq	เม​ซ้าก
aabetgneko	อา​เบด​เน​โก
aabetgneko	อา​เบด​เน​โก
aabetgneko	อา​เบด​เน​โก
aabetgneko	อา​เบด​เน​โก
bensatqsaa	เบน​ซัด​ซา
bensatqsaa	เบน​ซัด​ซา
bensatqsaa	เบน​ซัด​ซา
mene	เม​เน
mene	เม​เน
teken	เท​เคน
paasin	ปา​ซิน
paasin	ปา​ซิน
daaliatg	ดา​ลิ​อัด
ulai	อู​ไล
ulai	อู​ไล
kaabelyen	กา​เบ​เลียน
taikitg	ไท​กิด
yeleboam	เย​เล​โบ​อัม
hoseyaa	โฮ​เซ​ยา
dipglaaim	ดิบ​ลา​อิม
kome	โก​เม
loluhaamaa	โล​ลุ​หะ​มา
loammi	โล​อัม​มี
ammi	อัม​มี
luhaamaa	ลู​ฮา​มา
lomb	หล่ม
aako	อา​โค
betgaawen	เบด​อา​เวน
sanman	ซัน​มัน
betgaanben	เบด​อาน​เบน
aamotq	อา​โม้ด
aamotq	อา​โม้ด
aawen	อา​เวน
betgeden	เบด​เอ​เดน
kaasaa	กา​ซา
keliotg	เค​ลิ​โอด
kinkaan	กิน​กาน
kaannaaim	คาน​นา​อิม
finisia	ฟี​นี​เซีย
saajlefatq	สา​เล​ฟัด
sejfaalaatq	เส​ฟา​ล้าด
aamitqtai	อา​มิด​ไท
yonaa	โย​นา
yonaa	โย​นา
ninaawe	นิ​นะ​เว
saafi	ซา​ฟี
saanan	ซา​นัน
betgesen	เบด​เอ​เซน
maalotq	มา​โล้ด
pyeib	เปย๊ยเฒ้ย
enkotg	เอน​โขด
naahum	นา​ฮูม
libia	ลิ​เบีย
haabaakukg	ฮา​บา​กุก
sikionotq	ซิ​กิ​โอ​โน้ด
kusi	คู​ซี
minkom	มิน​โคม
tiub	ติ๊วโหฌะ
hxvg	จายห่อง
baav	เปย๊าบาง
favb	ฌังหล่าง
hakqkai	ฮัก​ไก
isaalaaen	อิ​สะลา​เอน
yosuwaa	โย​ซู​วา
yosaadatg	โย​ซา​ดัด
zaib	ไธต๋อย
peletq	เป​เล้ด
hetqlon	เฮ้ด​โลน
boaatg	โบ​อาด
jyetgsi	เจียด​ซี
seantien	เซ​อัน​ทิ​เอน
aabiyutq	อา​บี​ยุด
aabiyutq	อา​บี​ยุด
eliyaakim	เอ​ลี​ยา​คิม
aasx	อา​ซอ
aasx	อา​ซอ
aakim	อา​คิม
aakim	อา​คิม
eliutg	เอ​ลี​อูด
eliutg	เอ​ลี​อูด
matqtaan	มัด​ทาน
yosepq	โย​เซ้บ
maaliyaa	มา​ลี​ยา
maaliyaa	มา​ลี​ยา
yesu	เย​ซู
yesu	เย​ซู
kitug	กี​ตู่
maaliyaa	มา​ลี​ยา
yesu	เย​ซู
imaanuen	อี​มา​นู​เอน
helotq	เฮ​โล้ด
yudia	ยู​เดีย
naasaaletq	นา​ซา​เล้ด
naasaaletq	นา​ซา​เล้ด
yohan	โย​ฮัน
yohan	โย​ฮัน
yohan	โย​ฮัน
yohan	โย​ฮัน
yohan	โย​ฮัน
txnb	ตอน
sejbedi	เส​เบ​ดี
yaakxpg	ยา​กอบ
totqbuli	โท้ด​บุ​ลี
kilo	กี​โล
kilo	กี​โล
filipq	ฟี​ลิบ
baatolomiu	บา​โท​โล​มิว
tomatq	โท​มัด
matqtaai	มัด​ทาย
anfeatg	อัน​เฟ​อัด
tatqdeatg	ทัด​เด​อัด
simon	ซี​โมน
yudaatg	ยู​ดาด
isaakaaliotg	อิ​สะ​คา​ลิ​โอด
faalisij	ฟา​ลิ​สี
faalisij	ฟา​ลิ​สี
beensebun	เบ​เอน​เซ​บูน
saataan	ซา​ตาน
helodyetg	เฮ​โล​เดียด
yesu	เย​ซู
txn	เบย์าตอน
saadusij	สะ​ดู​สี
saadusij	สะ​ดู​สี
pite	ปี​เต
pite	ปี​เต
saib	ไซ
betaani	เบ​ทา​นี
sisaa	ซี​ซา
sisaa	ซี​ซา
sisaa	ซี​ซา
saadusij	สะ​ดู​สี
kitug	กี​ตู่
kaayaafaatq	คา​ยา​ฟ้าด
zxvb	ฒอง
pite	ปี​เต
lomaa	โล​มา
pilaatq	ปี​ล้าด
yudaatg	ยู​ดาด
pilaatq	ปี​ล้าด
pilaatq	ปี​ล้าด
pilaatq	ปี​ล้าด
zwib	ฒุ์ย
baalapqbatg	บา​ลับ​บัด
pilaatq	ปี​ล้าด
baalapqbatg	บา​ลับ​บัด
pilaatq	ปี​ล้าด
pilaatq	ปี​ล้าด
baalapqbatg	บา​ลับ​บัด
pilaatq	ปี​ล้าด
baalapqbatg	บา​ลับ​บัด
pilaatq	ปี​ล้าด
pilaatq	ปี​ล้าด
pilaatq	ปี​ล้าด
pilaatq	ปี​ล้าด
sailin	ไซ​ลีน
simon	ซี​โมน
eli	เอ​ลี
laamaasaabakgtaani	ลา​มา​ซา​บัก​ทา​นี
makqdaalaa	มัก​ดา​ลา
pilaatq	ปี​ล้าด
pilaatq	ปี​ล้าด
makqdaalaa	มัก​ดา​ลา
pilaatq	ปี​ล้าด
andaalu	อัน​ดา​ลู
kaapenaaum	คา​เป​นา​อุม
idumeaa	อิ​ดู​เม​อา
yesu	เย​ซู
yesu	เย​ซู
boaaneye	โบ​อา​เน​เย
yesu	เย​ซู
helotq	เฮ​โล้ด
betgsaidaa	เบด​ไซ​ดา
mose	โม​เซ
baatimeatg	บา​ทิ​เม​อัด
hosaanaa	โฮ​ซา​นา
lomaa	โล​มา
naadaa	นา​ดา
aalekqsaande	อา​เล้ก​ซาน​เด
lufatq	ลู​ฟัด
eloi	เอ​โล​อี
eloi	เอ​โล​อี
yosetg	โย​เสด
saalome	สะ​โล​เม
sejkaaliyaa	เส​คา
sejkaaliyaa	เส​คา​ลิ​ยา
elisaabetg	เอ​ลี​ซา​เบด
elisaabetg	เอ​ลี​ซา​เบด
annaa	อัน​นา
faanuen	ฟา​นู​เอน
annaa	อัน​นา
tibeliatg	ทิ​เบ​ลิ​อัด
pxntiatg	ปอน​ทิ​อัด
itulia	อิ​ทู​เลีย
taakonititg	ตา​โค​นิ​ติด
lisaanyetq	ลี​ซา​เนี้ยด
aabilen	อา​บี​เลน
heli	เฮ​ลี
heli	เฮ​ลี
matqtatq	มัด​ทัด
matqtatq	มัด​ทัด
menki	เมน​คี
menki	เมน​คี
yannaai	ยัน​นาย
yannaai	ยัน​นาย
matqtaatiatg	มัด​ทา​ที​อัด
matqtaatiatg	มัด​ทา​ที​อัด
naahum	นา​ฮูม
etgli	เอด​ลี
etgli	เอด​ลี
nakqkaai	นัก​กาย
nakqkaai	นัก​กาย
maaaatg	มา​อาด
maaaatg	มา​อาด
matqtaatiatg	มัด​ทา​ที​อัด
matqtaatiatg	มัด​ทา​ที​อัด
sejmein	เส​เม​อิน
sejmein	เส​เม​อิน
yosekg	โย​เสก
yosekg	โย​เสก
yodaa	โย​ดา
yodaa	โย​ดา
yoaanan	โย​อา​นัน
yoaanan	โย​อา​นัน
lesaa	เล​ซา
lesaa	เล​ซา
neli	เน​ลี
neli	เน​ลี
menki	เมน​คี
menki	เมน​คี
atgdi	อัด​ดี
atgdi	อัด​ดี
kosamj	โค​สัม
kosamj	โค​สัม
enmaadam	เอน​มา​ดัม
enmaadam	เอน​มา​ดัม
eaa	เอ​อา
eliyese	เอ​ลี​เย​เซ
yolim	โย​ลิม
yolim	โย​ลิม
matqtatq	มัด​ทัด
matqtatq	มัด​ทัด
simeon	สิ​เม​โอน
yonaam	โย​นาม
yonaam	โย​นาม
meleaa	เม​เล​อา
meleaa	เม​เล​อา
mennaa	เมน​นา
mennaa	เมน​นา
matqtaataa	มัด​ตะ​ทา
matqtaataa	มัด​ตะ​ทา
atgmin	อัด​มิน
atgmin	อัด​มิน
aanni	อาน​นี
aanni	อาน​นี
apglaaham	อับ​ลา​ฮัม
naaho	นา​โฮ
sejlukq	เส​ลุก
leu	เล​อู
pelekq	เป​เล้ก
ebe	เอ​เบ
kainaan	ไค​นาน
kainaan	ไค​นาน
aanfaasatq	อาน​ฟา​ซัด
laamekq	ลา​เม้ก
yaaletq	ยา​เล้ด
maahaalaaleen	มา​หะ​ลา​เล​เอน
maahaalaaleen	มา​หะ​ลา​เล​เอน
enotq	เอ​โน้ด
aadam	อา​ดัม
simon	ซี​โมน
pite	ปี​เต
kelaasaa	เก​ลา​ซา
yailatq	ไย​ลัด
pite	ปี​เต
saamaalia	สะ​มา​เลีย
pyaub	เปย๊าเฒี้ยว
maataa	มา​ทา
kaalili	กา​ลิ​ลี
sijloam	สี​โล​อัม
taan	แฒะตาน
laasaalatq	ลา​ซา​ลัด
kovb	กง
sakgkyetq	สัก​เคี้ยด
maali	มา​ลี
helotq	เฮ​โล้ด
kenopatg	เคน​โอ​ปัด
laavb	ล์าง
andaalu	อัน​ดา​ลู
kefaatq	เค​ฟ้าด
kefaatq	เค​ฟ้าด
filipq	ฟี​ลิบ
naataanaaen	นา​ทา​นา​เอน
naataanaaen	นา​ทา​นา​เอน
nikodematq	นี​โค​เด​มัด
nikodematq	นี​โค​เด​มัด
aainon	อาย​โนน
saajlim	สา​ลิม
sikaa	สิ​คา
yiutai	ยิว​ไท
kaanaa	คา​นา
kaapenaaum	คา​เป​นา​อุม
kaalili	ลิ​ลี
faalisij	ฟา​ลิ​สี
yesu	เย​ซู
laasaalatq	ลา​ซา​ลัด
laasaalatq	ลา​ซา​ลัด
maataa	มา​ทา
maataa	มา​ทา
laasaalatq	ลา​ซา​ลัด
kaayaafaatq	คา​ยา​ฟ้าด
yudaatg	ยู​ดาด
mankatq	มัน​คัด
annaatq	อัน​น้าด
laatin	ลา​ติน
teofilatq	เท​โอ​ฟี​ลัด
aakendaamaa	อา​เคน​ดา​มา
pentekxtq	เพน​เท​ค้อด
aanaania	อา​นา​เนีย
sapgfilaa	สับ​ฟี​ลา
aanaania	อา​นา​เนีย
saatefen	สะ​เท​เฟน
saatefen	สะ​เท​เฟน
pokolatq	โป​โค​ลัด
nikaano	นิ​คา​โน
timon	ทิ​โมน
paanmenatq	ปาน​เม​นัด
antiokg	อัน​ที​โอก
nikolau	นี​โค​เลา
saulo	เซา​โล
aineatg	ไอ​เน​อัด
aineatg	ไอ​เน​อัด
litqdaa	ลิด​ดา
litqdaa	ลิด​ดา
yapqfaa	ยับ​ฟา
litqdaa	ลิด​ดา
koneliatg	โค​เน​ลิ​อัด
koneliatg	โค​เน​ลิ​อัด
sisaaliyaa	ซี​ซา​ลี​ยา
baanaabatg	บา​นา​บัด
baanaabatg	บา​นา​บัด
taasatq	ทา​ซัด
aakaabatg	อา​กา​บัด
kaalaaudiatg	คา​ลาว​ดิ​อัด
maako	มา​โค
lodaa	โล​ดา
maako	มา​โค
elimaatq	เอ​ลี​ม้าด
paulo	เปา​โล
paulo	เปา​โล
ikoniyum	อี​โค​นี​ยูม
hemetq	เฮ​เม้ด
ikoniyum	อี​โค​นี​ยูม
pekaa	เป​กา
atgtaaliyaa	อัด​ทา​ลิ​ยา
silaa	ซี​ลา
maasidonia	มา​ซี​โด​เนีย
paulo	เปา​โล
silaa	ซี​ลา
amfibuli	อัม​ฟี​บุ​ลี
aapxlonia	อา​ปอ​โล​เนีย
tesaalonikaa	เท​สะ​โล​นิ​กา
yaasonj	ยา​โสน
yaasonj	ยา​โสน
aaten	อา​เทน
timotai	ทิ​โม​ไท
aaleopaakatg	อา​เล​โอ​ปา​กัด
aaten	อา​เทน
kolinto	โค​ลิน​โท
titiatgyusaatatq	ทิ​ทิ​อัด​ยุ​สะ​ทัด
kaalitqpatg	คะ​ลิด​ปัด
kolinto	โค​ลิน​โท
kanlio	กัน​ลิ​โอ
aakaayaa	อา​คา​ยา
kanlio	กัน​ลิ​โอ
kanlio	กัน​ลิ​โอ
efeso	เอ​เฟ​โซ
pitgsinjlaa	ปิด​สิน​ลา
aakwinlaa	อา​ควิน​ลา
efeso	เอ​เฟ​โซ
aapxlo	อา​ปอ​โล
pitgsinjlaa	ปิด​สิน​ลา
aakwinlaa	อา​ควิน​ลา
sejwaa	เส​วา
aantemitq	อาน​เท​มิด
esia	เอ​เซีย
aalekqsaande	อา​เล้ก​ซาน​เด
demetqliatg	เด​เม้ด​ลิ​อัด
beloaa	เบ​โล​อา
pilatq	ปี​ลัด
sojpaate	โส​ปา​เท
aalitqtaakatq	อา​ลิด​ทา​คัด
sejkundatg	เส​คุน​ดัด
kaaiatg	กาย​อัด
tikikatg	ที​คิ​กัด
tofimatq	โต​ฟี​มัด
toatg	โต​อัด
yutikatg	ยู​ทิ​กัด
yutikatg	ยู​ทิ​กัด
atgsotg	อัด​โสด
atgsotg	อัด​โสด
mitileni	มิ​ทิ​เล​นี
silisia	ซี​ลี​เซีย
paulo	เปา​โล
felikq	เฟ​ลิก
felikq	เฟ​ลิก
kaalaaudiatg	คา​ลาว​ดิ​อัด
lisyetq	ลี​เซี้ยด
tetulatq	เท​ทู​ลัด
pxsiatg	ปอ​สิ​อัด
fesaatatq	เฟ​สะ​ทัด
fesaatatq	เฟ​สะ​ทัด
fesaatatq	เฟ​สะ​ทัด
fesaatatq	เฟ​สะ​ทัด
aagipaa	อา​ฆี​พา
benitq	เบ​นิด
aagipaa	อา​ฆี​พา
fesaatatq	เฟ​สะ​ทัด
aagipaa	อา​ฆี​พา
pupgliatg	ปุบ​ลิ​อัด
sailaakiu	ไซ​ลา​คิว
leyium	เล​ยี​อูม
putioli	ปู​ที​โอ​ลี
yiutai	ยิว​ไท
apglaaham	อับ​ลา​ฮัม
winb	วิน
kitug	กี​ตู่
saapen	สะ​เปน
saapen	สะ​เปน
saapen	สะ​เปน
aapenletq	อา​เปน​เล้ด
aalitqtobulatq	อา​ลิด​โท​บู​ลัด
tifenaa	ตี​เฟ​นา
tifosaaj	ตี​โฟ​สา
pesitg	เป​สิด
lufatq	ลู​ฟัด
filolokatg	ฟี​โล​โล​กัด
yulia	ยู​เลีย
neleatg	เน​เล​อัด
olimpatg	โอ​ลิม​ปัด
lusiatg	ลู​สิ​อัด
sojsipaate	โส​สิ​ปา​เท
tetiatg	เท​ทิ​อัด
saatefaanatq	สะ​เท​ฟา​นัด
aapxlo	อา​ปอ​โล
maasidonia	มา​ซี​โด​เนีย
fxtunaatatq	ฟอ​ทู​นา​ทัด
aakaaikatq	อา​คาย​คัด
kitug	กี​ตู่
belian	เบ​ลี​อัน
titatg	ทิ​ตัด
titatg	ทิ​ตัด
titatg	ทิ​ตัด
aabaa	อา​บา
yuodia	ยู​โอ​เดีย
sinjtike	สิน​ทิ​เค
kenmen	เคน​เมน
epaafoditatq	เอ​ปา​โฟ​ดิ​ทัด
epaafaa	เอ​ปา​ฟา
epaafaa	เอ​ปา​ฟา
txnb	ตอน
laudisia	เลา​ดี​เซีย
yusaatatq	ยุ​สะ​ทัด
himeneatg	ฮี​เม​เน​อัด
pxvb	ปอง
fijelatq	ฟี​เจ​ลัด
hemokenetq	เฮ​โม​เก​เน้ด
filetatq	ฟี​เล​ทัด
yannetq	ยัน​เน้ด
yambe	ยัม​เบ
demaatq	เด​ม้าด
kelesen	เค​เล​เซน
kaalaatia	กา​ลา​เทีย
daanmaatia	ดาน​มา​เทีย
lukaa	ลู​กา
onesifolatq	โอ​เน​สิ​โฟ​ลัด
elatqtatq	เอ​ลัด​ทัด
miletatq	มิ​เล​ทัด
sejnaatq	เส​น้าด
filemon	ฟี​เล​โมน
onesimatq	โอ​เน​สิ​มัด
onesimatq	โอ​เน​สิ​มัด
onesimatq	โอ​เน​สิ​มัด
onesimatq	โอ​เน​สิ​มัด
saalem	ซา​เลม
menkisedekg	เมน​คี​เซ​เดก
saalem	ซา​เลม
saalem	ซา​เลม
menkisedekg	เมน​คี​เซ​เดก
aabcn	อา​แบน
mose	โม​เซ
baalaaam	บา​ลา​อัม
kaain	คา​อิน
yiudaa	ยิว​ดา
kolaa	โค​ลา
aalaamaaketgdon	อา​ละ​มา​เกด​โดน
aaleluyaa	อา​เล​ลู​ยา
anfaa	อัน​ฟา
omekaa	โอ​เม​กา
