yesu	ເຢຊູ
yesu	ເຢຊູ
tovb	ຕົ້ງ
Tinb huvb	ທິນຮູ່ງ
zeij	ເຕສີ໋ຍ
luvb	ລູ່ງ
Dau	ເດົາ
Zauj	ເຖສົາ
maang	ໝ່ານ
Navq	ຮນັ້ງ
naaiq	ນ້າຍ
nx	ນໍ
zyavj	ຕສຢັ໋ງ
Revg	ເດສ່ງ
aq	ອ໊ະ
Tauj	ເຖົາ
Nxi	ຮນອຍ
zruj	ໂຕສ໋ວ
ninb	ນິ່ນ
Eei	ເຍີຍ
kov	ກົງ
zyrug	ຕສ່ຽວ
Zwrtq	ທສວດ
Zeij	ເຖສີຍ
pun	ປຸນ
uaq	ວົ້ວ
nxm	ນອມ
penj	ເປ໋ນ
weig	ເຫວີ່ຍ
zug	ຕສຸ
yaag	ຢ່າ
lrug	ເຈົ໊າໂຫລ່ວ
se	ເຊ
zyruq	ຕສ໊ຽວ
zang	ຕສັ່ນ
maiq	ໄມ້
kcvb	ແກ້ງ
maaib	ມ່າຍ
haiq	ຫາຍ
Euvg	ຫຍູ່ງ
Dyavj	ດຢັ໋ງ
Kuvj	ຂູງ
uam	ວວມ
yem	ຢຽມ
taaib	ຕ້າຍ
kxmj	ກ໋ອມ
cvj	ແອ໋ງ
zxq	ເຕສ໊າະ
teij	ເຕີ໋ຍ
taub	ເຕົ້າ
myenb	ມ່ຽນ
Qiaj	ເຖຈຍ
piag	ເປັຍ
puv	ປູງ
kaEuad	ກະຍົ໌ວ
Diaq	ເດ໊ຍ
Jiad	ເຈ໌ຍ
Jyenq	ຈ໊ຽນ
faauj	ຝາວ
tuq	ຕຸ໊
siaq	ເຊັຍ
kxvq	ກ໊ອງ
Buaj	ບົ໋ວ
meib	ເມີ່ຍ
yetg	ຢຽດ
pyauq	ເປຢົ໊າ
xij	ອ໋ອຍ
Ravq	ດສັ໊ງ
Jaaj	ຈ໋າ
yia	ເຢຍ
pwatg	ປວັດ
kanb	ກັ້ນ
hxpg	ຫອບ
Hruq	ໂຮຍ້ວ
tafaanb	ຕະຟ່ານ
txb	ຕໍ້
siag	ເສ່ຍ
txij	ຕ໋ອຍ
trug	ໂຕ່ວ
zuvq	ຕສູ໊ງ
Yiab	ເຮ່ຍ
zxib	ຕສ້ອຍ
pwav	ປວັງ
waag	ຫວ່າ
txn	ຕອນ
Bua	ບົວ
pwavq	ປວັ໊ງ
teig	ເຕີ່ຍ
trub	ໂຕ້ວ
Daub	ເດົາເປີ້ຍ
kanaaiq	ກະນ້າຍ
Kxiq	ຄ້ອຍ
Jiu	ຈິວ
kunq	ກຸ໊ນ
haib	ໄຮ່
Eang	ຫຍັ່ນ
hopq	ຮົບ
Euvg	ຫຍູ່ງໆ
zinb	ຕສິ້ນ
Daavg	ດ່າງ
mivb	ມີ່ງ
zeib	ເຕສີ໊ຍຟຸນ
liud	ລິ໌ວ
Gahaaq	ອກະຮ້າ
pua	ປົວ
fib	ຟີ່
fivj	ຝີງ
mevb	ເມ່ງ
hog	ໂຫ່
fivj	ຝີງໆ
ziuj	ຕສິ໋ວ
Jauq	ເຈົ໊າ
Zyetq	ທສຽດ
zyepg	ຕສຽບ
Mmd	ຮມ໌
Havj	ຫຮຍັງ
auq	ເອົ໊າ
taub	ເຕົ້າໆ
puv	ເຕີ່ຍປູງ
mig	ໝີ່
kan	ກັນ
Jiaj	ເຈ໋ຍ
zivb	ຕສີ້ງ
tiub	ຕິ້ວ
tomb	ຕົ້ມ
ziag	ເຕສ່ຍ
huvb	ຮູ່ງ
Havb	ຫຮຍັງເຈີ໊ຍ
mwavj	ໝວັງ
lamb	ລ່ຳ
txvj	ຕ໋ອງ
liub	ດົ໊ບລິ່ວ
kaub	ເກົ້າ
zyavb	ຕສຢັ້ງ
zavg	ຕສັ່ງ
pcq	ແປ໊ະ
Eig	ຫຍີ່
Lav	ຮລັງ
koj	ໂກ໋
haig	ໄຫ່
lovg	ຫລົ່ງ
heug	ເຫ່ວ
Fiag	ເອຈ່ຍ
tivb	ຈາຕີ້ງ
Ripg	ດສິບ
zeiq	ເຕສີ໊ຍ
pwavb	ປວັ້ງ
kwanb	ກວັ້ນ
pweij	ເປວີ໋ຍ
myenb	ຟິນມ່ຽນ
pcv	ແປງ
fai	ໄຟ
Paaiq	ພ້າຍ
fyenj	ຝຽນ
lxd	ລໍ໌
Faauj	ອຈ໋າວ
kau	ເກົາ
feij	ເຝີຍ
Gxi	ອກອຍ
fuJweiq	ຝຸຈ໊ວຍ
i	ອີ
nrub	ໂນ່ວ
Puaq	ພົວະ
fatq	ຟັດ
mq paag	ມປ່າ
zipq	ຕສິ໊ບ
msiaq	ມເຊັຍ
haid	ໄຮ໌
Namq	ຮນ້ຳ
lovj	ຫລົງ
kwavg	ກວັ່ງ
hruj	ລຸຍໂຫວ
tia	ເຕຍ
leib	ເລີ່ຍ
taEeig	ຕະເຫຍີ່ຍ
mavg	ໝັ່ງ
waaig	ຫວ່າຍ
taig	ໄຕ່
Jyen	ຈຽນ
txvg	ຕ່ອງ
tiaj	ເຕ໋ຍ
kruj	ໂກ໋ວ
ting	ຕິ່ນ
pcvb	ແປງເປຢີ໊ຍ
laub	ເລົ່າ
Beij	ເບີ໋ຍ
sruq	ໂຊ້ວ
Daaib	ດ້າຍ
Len	ເຮລນ
yavb	ຢັ້ງ
vovb	ງົ່ງ
luag	ຫລົວະ
Kruq	ໂຄ້ວ
Eaanb	ຍ່ານ
Buag	ບົວະ
ei	ເອີຍ
fuvj	ຝູງ
Rwrnj	ດສ໋ວນ
ko	ໂກ
naaig	ໜ່າຍ
tiug	ຕິ່ວ
hiuq	ຮິ້ວ
kapq	ກັ໊ບ
zunq	ຕສຸ໊ນ
sig	ສີ່
aag	ອ່າ
Qaq	ທຈະ
zaeij	ຕສະເອີ໋ຍ
laavb	ລ່າງ
taij	ໄຕ໋
tavj	ຕັ໋ງ
wavq	ວິນວັ້ງ
Eia	ເຍຍ
pyruq	ປ໊ຽວ
Zamq	ທສ້ຳ
taauj	ຕ໋າວ
henq	ເຮ້ນ
laanb	ລ່ານ
BuDovj	ບຸດົ໋ງ
pcvb	ແປ້ງ
fim	ຟິມ
syemq	ຊ້ຽມ
pcg	ແປະ
pivj	ປີ໋ງ
Laaj	ຫຮລາ
Eiag	ເຫຍັຍ
an	ອັນ
RaMyen	ດສະຮມຽນ
vcvg	ແຫງ່ງ
hxvb	ຮ່ອງ
Taaib	ທ່າຍ
Bxq	ເບ໊າະ
o	ໂອ
zwavj	ຕສວັ໋ງ
lyepg	ຫລຽບ
sai	ໄຊ
sij	ເຊ
kinq	ກິ໊ນ
tuvq	ຕູ໋ງ
leid	ເລີ໌ຍ
Jyem	ຈຽມ
lamaab	ຫລະມ່າ
pyei	ເປຢີຍ
liug	ຫລິ່ວ
lcvd	ແລ໌ງ
faav	ຟາງ
kaEiag	ກະເຫຍ່ຍ
pyaa	ປຢາ
Dxg	ເດາະ
nctq	ແນດ
mcvj	ແໝງ
laatg	ຫລາດ
naamb	ນ່າມ
weib	ເວີ່ຍ
Zxv	ທສອງ
wrnq	ວ້ວນ
Ziq	ທສິ
pyavb	ປຢັ້ງ
fiaq	ເຟ້ຍ
zuq	ຕສຸ໊
sivj	ສີງ
mGxvq	ມອກ໊ອງ
zwid	ຕສຸ໌ຍ
Wiv	ຮວີງ
kxg	ເກ໊າະມ່ຽນ
mJavg	ມຈັ່ງ
tivg	ຕີ່ງ
zunb	ຕສຸ້ນ
Eeig	ເຫຍີ່ຍ
zuaq	ຕສົ໊ວ
maa	ມາ
yrud	ໂຢ໌ວ
kuaq	ກົ໊ວະ
pyeiq	ເປຢີ໊ຍ
livg	ຫລີ່ງ
huvj	ຫູງ
aNeiq	ອະເຮນີ້ຍ
Win	ຮວິນ
livb	ລີ່ງ
mziv	ມຕສີງ
Tov	ທົງ
pwrng	ປ່ວນ
tayetq	ຕະຢ໊ຽດ
zakevb	ຕສະເກ້ງ
Diaq	ປົ໌ວເດ໊ຍ
Raub	ເດສົ້າ
Eyemq	ຍ້ຽມ
muvq	ມູ້ງ
laavd	ລ໌າງ
zei	ເຕສີຍ
maad	ມ໌າ
Zia	ມ໌າເທສຍ
Doq	ໂດ໊ະ
yrud	ກໍ໋ໂຢ໌ວ
zuaq	ຕສົ໊ວະ
mnxmb	ມນ່ອມ
Toq	ໂທ້
Zaavq	ທສ້າງ
waang	ຫວ່ານ
mwrnd	ມ໌ວນ
hivb	ຮີ່ງ
puvb	ປູ້ງ
zevg	ເຕສ່ງ
nxmb	ນອມໆ
hod	ໂຮ໌
tau	ເຕົາ
maaig	ໝ່າຍ
scvq	ແຊ້ງ
tafeij	ຕະເຝີຍ
Zin	ທສິນ
Dovg	ດົ່ງ
pcv	ຈຸນແປງ
zov	ຕສົງ
tafaam	ຕະຟາມ
en	ເອນ
Jomg	ຈົ່ມ
syenj	ສຽນ
yetq	ຢ໊ຽດ
pcvb	ແປງກວັ້ນ
Qovj	ຖຈົງ
petq	ເປ໊ດ
kwaatq	ກວ໊າດ
taan	ຕານ
laavg	ອຈັງຫລ່າງ
zwrtg	ຕສວດ
Tiuq	ທິ້ວ
yopq	ໂຢ໊ບ
kwai	ໄກວ
tavq	ຕັ໊ງ
Kuq	ຄູ້
mun	ມຸນ
tiaq	ເຕ໊ຍ
Fimq	ອຈິ໊ມ
Gwin	ອກວິນ
zweib	ເຕສວີ້ຍ
Eyemg	ຫຍ່ຽມ
lyrug	ຫລ່ຽວ
levb	ເລ່ງ
Jaig	ໄຈ່
im	ອິມ
toq	ໂຕ໊
Zamj	ຖສຳ
Qxv	ທຈອງ
fov	ຟົງ
mwrnb	ມ່ວນ
maab	ມ່າະ
setg	ເສດ
paatg	ປາດ
Jxib	ຈ້ອຍ
Gwaq	ອກວ໊ະ
Dipg	ດິບ
maiq	ໄມ້
saaiq	ຊ້າຍ
Yaamj	ຫຮຢາມ
Byrub	ບ້ຽວໆ
aab	ອ້າ
meij	ເໝີຍ
puq	ປູ໊
lovb	ລົ່ງ
Kruj	ໂຂວ
kaaq	ກ໊າ
zyruq	ແຕສ໊ະຕສ໊ຽວ
Bruq	ໂບ໊ວ
peuq	ເປ໊ວ
Txvq	ທ້ອງ
Fipq	ອຈິ໊ບ
Nxib	ຮນອຍໆ
zyemj	ຕູ໋ງ
Ravb	ດສັ້ງ
mFxmb	ມອຈ້ອມ
saab	ຊ່າະ
peib	ເປີ້ຍ
ເຢ	ເຢ
ຊູ	ຊູ
tinb huvb	ທິນຮູ່ງ
lrug	ເຈົ໊າໂຫລ່ວ
daub	ເດົາເປີ້ຍ
euvg	ຫຍູ່ງໆ
zeib	ເຕສີ໊ຍຟຸນ
fivj	ຝີງໆ
puv	ເຕີ່ຍປູງ
havb	ຫຮຍັງເຈີ໊ຍ
liub	ດົ໊ບລິ່ວ
tivb	ຈາຕີ້ງ
myenb	ຟິນມ່ຽນ
hruj	ລຸຍໂຫວ
pcvb	ແປງເປຢີ໊ຍ
wavq	ວິນວັ້ງ
kxg	ເກ໊າະມ່ຽນ
diaq	ປົ໌ວເດ໊ຍ
zia	ມ໌າເທສຍ
yrud	ກໍ໋ໂຢ໌ວ
nxmb	ນອມໆ
pcv	ຈຸນແປງ
pcvb	ແປງກວັ້ນ
laavg	ອຈັງຫລ່າງ
zyruq	ແຕສ໊ະຕສ໊ຽວ
nxib	ຮນອຍໆ
