ເຢຊູ	yesu
ເຢຊູ	yesu
ຕົ້ງ	tovb
ທິນຮູ່ງ	Tinb huvb
ເຕສີ໋ຍ	zeij
ລູ່ງ	luvb
ເດົາ	Dau
ເຖສົາ	Zauj
ໝ່ານ	maang
ຮນັ້ງ	Navq
ນ້າຍ	naaiq
ນໍ	nx
ຕສຢັ໋ງ	zyavj
ເດສ່ງ	Revg
ອ໊ະ	aq
ເຖົາ	Tauj
ຮນອຍ	Nxi
ໂຕສ໋ວ	zruj
ນິ່ນ	ninb
ເຍີຍ	Eei
ກົງ	kov
ຕສ່ຽວ	zyrug
ທສວດ	Zwrtq
ເຖສີຍ	Zeij
ປຸນ	pun
ວົ້ວ	uaq
ນອມ	nxm
ເປ໋ນ	penj
ເຫວີ່ຍ	weig
ຕສຸ	zug
ຢ່າ	yaag
ເຈົ໊າໂຫລ່ວ	lrug
ເຊ	se
ຕສ໊ຽວ	zyruq
ຕສັ່ນ	zang
ໄມ້	maiq
ແກ້ງ	kcvb
ມ່າຍ	maaib
ຫາຍ	haiq
ຫຍູ່ງ	Euvg
ດຢັ໋ງ	Dyavj
ຂູງ	Kuvj
ວວມ	uam
ຢຽມ	yem
ຕ້າຍ	taaib
ກ໋ອມ	kxmj
ແອ໋ງ	cvj
ເຕສ໊າະ	zxq
ເຕີ໋ຍ	teij
ເຕົ້າ	taub
ມ່ຽນ	myenb
ເຖຈຍ	Qiaj
ເປັຍ	piag
ປູງ	puv
ກະຍົ໌ວ	kaEuad
ເດ໊ຍ	Diaq
ເຈ໌ຍ	Jiad
ຈ໊ຽນ	Jyenq
ຝາວ	faauj
ຕຸ໊	tuq
ເຊັຍ	siaq
ກ໊ອງ	kxvq
ບົ໋ວ	Buaj
ເມີ່ຍ	meib
ຢຽດ	yetg
ເປຢົ໊າ	pyauq
ອ໋ອຍ	xij
ດສັ໊ງ	Ravq
ຈ໋າ	Jaaj
ເຢຍ	yia
ປວັດ	pwatg
ກັ້ນ	kanb
ຫອບ	hxpg
ໂຮຍ້ວ	Hruq
ຕະຟ່ານ	tafaanb
ຕໍ້	txb
ເສ່ຍ	siag
ຕ໋ອຍ	txij
ໂຕ່ວ	trug
ຕສູ໊ງ	zuvq
ເຮ່ຍ	Yiab
ຕສ້ອຍ	zxib
ປວັງ	pwav
ຫວ່າ	waag
ຕອນ	txn
ບົວ	Bua
ປວັ໊ງ	pwavq
ເຕີ່ຍ	teig
ໂຕ້ວ	trub
ເດົາເປີ້ຍ	Daub
ກະນ້າຍ	kanaaiq
ຄ້ອຍ	Kxiq
ຈິວ	Jiu
ກຸ໊ນ	kunq
ໄຮ່	haib
ຫຍັ່ນ	Eang
ຮົບ	hopq
ຫຍູ່ງໆ	Euvg
ຕສິ້ນ	zinb
ດ່າງ	Daavg
ມີ່ງ	mivb
ເຕສີ໊ຍຟຸນ	zeib
ລິ໌ວ	liud
ອກະຮ້າ	Gahaaq
ປົວ	pua
ຟີ່	fib
ຝີງ	fivj
ເມ່ງ	mevb
ໂຫ່	hog
ຝີງໆ	fivj
ຕສິ໋ວ	ziuj
ເຈົ໊າ	Jauq
ທສຽດ	Zyetq
ຕສຽບ	zyepg
ຮມ໌	Mmd
ຫຮຍັງ	Havj
ເອົ໊າ	auq
ເຕົ້າໆ	taub
ເຕີ່ຍປູງ	puv
ໝີ່	mig
ກັນ	kan
ເຈ໋ຍ	Jiaj
ຕສີ້ງ	zivb
ຕິ້ວ	tiub
ຕົ້ມ	tomb
ເຕສ່ຍ	ziag
ຮູ່ງ	huvb
ຫຮຍັງເຈີ໊ຍ	Havb
ໝວັງ	mwavj
ລ່ຳ	lamb
ຕ໋ອງ	txvj
ດົ໊ບລິ່ວ	liub
ເກົ້າ	kaub
ຕສຢັ້ງ	zyavb
ຕສັ່ງ	zavg
ແປ໊ະ	pcq
ຫຍີ່	Eig
ຮລັງ	Lav
ໂກ໋	koj
ໄຫ່	haig
ຫລົ່ງ	lovg
ເຫ່ວ	heug
ເອຈ່ຍ	Fiag
ຈາຕີ້ງ	tivb
ດສິບ	Ripg
ເຕສີ໊ຍ	zeiq
ປວັ້ງ	pwavb
ກວັ້ນ	kwanb
ເປວີ໋ຍ	pweij
ຟິນມ່ຽນ	myenb
ແປງ	pcv
ໄຟ	fai
ພ້າຍ	Paaiq
ຝຽນ	fyenj
ລໍ໌	lxd
ອຈ໋າວ	Faauj
ເກົາ	kau
ເຝີຍ	feij
ອກອຍ	Gxi
ຝຸຈ໊ວຍ	fuJweiq
ອີ	i
ໂນ່ວ	nrub
ພົວະ	Puaq
ຟັດ	fatq
ມປ່າ	mq paag
ຕສິ໊ບ	zipq
ມເຊັຍ	msiaq
ໄຮ໌	haid
ຮນ້ຳ	Namq
ຫລົງ	lovj
ກວັ່ງ	kwavg
ລຸຍໂຫວ	hruj
ເຕຍ	tia
ເລີ່ຍ	leib
ຕະເຫຍີ່ຍ	taEeig
ໝັ່ງ	mavg
ຫວ່າຍ	waaig
ໄຕ່	taig
ຈຽນ	Jyen
ຕ່ອງ	txvg
ເຕ໋ຍ	tiaj
ໂກ໋ວ	kruj
ຕິ່ນ	ting
ແປງເປຢີ໊ຍ	pcvb
ເລົ່າ	laub
ເບີ໋ຍ	Beij
ໂຊ້ວ	sruq
ດ້າຍ	Daaib
ເຮລນ	Len
ຢັ້ງ	yavb
ງົ່ງ	vovb
ຫລົວະ	luag
ໂຄ້ວ	Kruq
ຍ່ານ	Eaanb
ບົວະ	Buag
ເອີຍ	ei
ຝູງ	fuvj
ດສ໋ວນ	Rwrnj
ໂກ	ko
ໜ່າຍ	naaig
ຕິ່ວ	tiug
ຮິ້ວ	hiuq
ກັ໊ບ	kapq
ຕສຸ໊ນ	zunq
ສີ່	sig
ອ່າ	aag
ທຈະ	Qaq
ຕສະເອີ໋ຍ	zaeij
ລ່າງ	laavb
ໄຕ໋	taij
ຕັ໋ງ	tavj
ວິນວັ້ງ	wavq
ເຍຍ	Eia
ປ໊ຽວ	pyruq
ທສ້ຳ	Zamq
ຕ໋າວ	taauj
ເຮ້ນ	henq
ລ່ານ	laanb
ບຸດົ໋ງ	BuDovj
ແປ້ງ	pcvb
ຟິມ	fim
ຊ້ຽມ	syemq
ແປະ	pcg
ປີ໋ງ	pivj
ຫຮລາ	Laaj
ເຫຍັຍ	Eiag
ອັນ	an
ດສະຮມຽນ	RaMyen
ແຫງ່ງ	vcvg
ຮ່ອງ	hxvb
ທ່າຍ	Taaib
ເບ໊າະ	Bxq
ໂອ	o
ຕສວັ໋ງ	zwavj
ຫລຽບ	lyepg
ໄຊ	sai
ເຊ	sij
ກິ໊ນ	kinq
ຕູ໋ງ	tuvq
ເລີ໌ຍ	leid
ຈຽມ	Jyem
ຫລະມ່າ	lamaab
ເປຢີຍ	pyei
ຫລິ່ວ	liug
ແລ໌ງ	lcvd
ຟາງ	faav
ກະເຫຍ່ຍ	kaEiag
ປຢາ	pyaa
ເດາະ	Dxg
ແນດ	nctq
ແໝງ	mcvj
ຫລາດ	laatg
ນ່າມ	naamb
ເວີ່ຍ	weib
ທສອງ	Zxv
ວ້ວນ	wrnq
ທສິ	Ziq
ປຢັ້ງ	pyavb
ເຟ້ຍ	fiaq
ຕສຸ໊	zuq
ສີງ	sivj
ມອກ໊ອງ	mGxvq
ຕສຸ໌ຍ	zwid
ຮວີງ	Wiv
ເກ໊າະມ່ຽນ	kxg
ມຈັ່ງ	mJavg
ຕີ່ງ	tivg
ຕສຸ້ນ	zunb
ເຫຍີ່ຍ	Eeig
ຕສົ໊ວ	zuaq
ມາ	maa
ໂຢ໌ວ	yrud
ກົ໊ວະ	kuaq
ເປຢີ໊ຍ	pyeiq
ຫລີ່ງ	livg
ຫູງ	huvj
ອະເຮນີ້ຍ	aNeiq
ຮວິນ	Win
ລີ່ງ	livb
ມຕສີງ	mziv
ທົງ	Tov
ປ່ວນ	pwrng
ຕະຢ໊ຽດ	tayetq
ຕສະເກ້ງ	zakevb
ປົ໌ວເດ໊ຍ	Diaq
ເດສົ້າ	Raub
ຍ້ຽມ	Eyemq
ມູ້ງ	muvq
ລ໌າງ	laavd
ເຕສີຍ	zei
ມ໌າ	maad
ມ໌າເທສຍ	Zia
ໂດ໊ະ	Doq
ກໍ໋ໂຢ໌ວ	yrud
ຕສົ໊ວະ	zuaq
ມນ່ອມ	mnxmb
ໂທ້	Toq
ທສ້າງ	Zaavq
ຫວ່ານ	waang
ມ໌ວນ	mwrnd
ຮີ່ງ	hivb
ປູ້ງ	puvb
ເຕສ່ງ	zevg
ນອມໆ	nxmb
ໂຮ໌	hod
ເຕົາ	tau
ໝ່າຍ	maaig
ແຊ້ງ	scvq
ຕະເຝີຍ	tafeij
ທສິນ	Zin
ດົ່ງ	Dovg
ຈຸນແປງ	pcv
ຕສົງ	zov
ຕະຟາມ	tafaam
ເອນ	en
ຈົ່ມ	Jomg
ສຽນ	syenj
ຢ໊ຽດ	yetq
ແປງກວັ້ນ	pcvb
ຖຈົງ	Qovj
ເປ໊ດ	petq
ກວ໊າດ	kwaatq
ຕານ	taan
ອຈັງຫລ່າງ	laavg
ຕສວດ	zwrtg
ທິ້ວ	Tiuq
ໂຢ໊ບ	yopq
ໄກວ	kwai
ຕັ໊ງ	tavq
ຄູ້	Kuq
ມຸນ	mun
ເຕ໊ຍ	tiaq
ອຈິ໊ມ	Fimq
ອກວິນ	Gwin
ເຕສວີ້ຍ	zweib
ຫຍ່ຽມ	Eyemg
ຫລ່ຽວ	lyrug
ເລ່ງ	levb
ໄຈ່	Jaig
ອິມ	im
ໂຕ໊	toq
ຖສຳ	Zamj
ທຈອງ	Qxv
ຟົງ	fov
ມ່ວນ	mwrnb
ມ່າະ	maab
ເສດ	setg
ປາດ	paatg
ຈ້ອຍ	Jxib
ອກວ໊ະ	Gwaq
ດິບ	Dipg
ໄມ້	maiq
ຊ້າຍ	saaiq
ຫຮຢາມ	Yaamj
ບ້ຽວໆ	Byrub
ອ້າ	aab
ເໝີຍ	meij
ປູ໊	puq
ລົ່ງ	lovb
ໂຂວ	Kruj
ກ໊າ	kaaq
ແຕສ໊ະຕສ໊ຽວ	zyruq
ໂບ໊ວ	Bruq
ເປ໊ວ	peuq
ທ້ອງ	Txvq
ອຈິ໊ບ	Fipq
ຮນອຍໆ	Nxib
ຕູ໋ງ	zyemj
ດສັ້ງ	Ravb
ມອຈ້ອມ	mFxmb
ຊ່າະ	saab
ເປີ້ຍ	peib
ເຢ	ເຢ
ຊູ	ຊູ
ທິນຮູ່ງ	tinb huvb
ເຈົ໊າໂຫລ່ວ	lrug
ເດົາເປີ້ຍ	daub
ຫຍູ່ງໆ	euvg
ເຕສີ໊ຍຟຸນ	zeib
ຝີງໆ	fivj
ເຕີ່ຍປູງ	puv
ຫຮຍັງເຈີ໊ຍ	havb
ດົ໊ບລິ່ວ	liub
ຈາຕີ້ງ	tivb
ຟິນມ່ຽນ	myenb
ລຸຍໂຫວ	hruj
ແປງເປຢີ໊ຍ	pcvb
ວິນວັ້ງ	wavq
ເກ໊າະມ່ຽນ	kxg
ປົ໌ວເດ໊ຍ	diaq
ມ໌າເທສຍ	zia
ກໍ໋ໂຢ໌ວ	yrud
ນອມໆ	nxmb
ຈຸນແປງ	pcv
ແປງກວັ້ນ	pcvb
ອຈັງຫລ່າງ	laavg
ແຕສ໊ະຕສ໊ຽວ	zyruq
ຮນອຍໆ	nxib
