yesu	เยซู
yesu	เยซู
nzaangc	หฑั่ง
janxtaiv	จั๋นไท้
dongh	ต้ง
cor	ธอ
tinhungh	ทินฮู่ง
zeix	เหฒย
lungh	ลู่ง
ndau	เดา
yohan	โยฮัน
caux	เหธา
maanc	หม่าน
muotc	หมวด
hnangv	ฮนั้ง
naaiv	น้าย
nor	นอ
ziangx	เหฒียง
nzengc	เหฑ่ง
aqv	อ๊ะ
taux	เถา
dacietv	ตะเธี้ยด
hnoi	ฮนอย
zoux	โหฒว
ninh	นิ่น
nyei	เญย
gong	กง
ziouc	ฯฒฯ
dingh	ตี้ง
hitv	ฮิด
kuonx	ขวน
cuotv	ธ้วด
iyipv	อียิบ
hipvlu	ฮิบลู
ceix	เหธย
fuqv	ฟุ
bun	ปุน
wuov	วั้ว
norm	นอม
benx	เป๋น
cingnzengc	ธีงเหฑ่ง
weic	เหว่ย
zuqc	หฒุ
yaac	หย่า
enden	เอเดน
huingx	หฮวีง
jauvlouc	เจ๊าโหล่ว
se	เซ
ziouv	เฒี้ยว
zanc	หฒั่น
maiv	ไม้
gaengh	แก้ง
maaih	ม่าย
haaix	หาย
nyungc	หญู่ง
miev	เมี้ย
ndiangx	เดี๋ยง
kungx	ขูง
wuom	ววม
yiem	เยียม
ndaundiev	เดาเดี๊ย
saamx	สาม
daaih	ต้าย
ndorn	ดอน
gormx	ก๋อม
aengx	แอ๋ง
zorqv	เฒาะ
deix	เต๋ย
niembung	เนียบูง
nanv	นั้น
dauh	เต้า
mienh	เมี่ยน
biomv	ปย๊ม
maengc	แหม่ง
qiex	เฉีย
bieqc	เปียะ
mbazorng	บะฒอง
kolinto	โคลินโท
dong	ตง
bung	ปูง
nyuoz	กะญั์ว
ndiev	เดี๊ย
maanh	ม่าน
jiez	เจี์ย
gorn	กอน
hiaangx	หฮยาง
jienv	เจี๊ยน
faaux	ฝาว
yungz	ยู์ง
duqv	ตุ๊
sieqv	เซียะ
gorngv	ก๊อง
mbuox	บั๋ว
noyaa	โนยา
meih	เม่ย
meih	เม่ย
yietc	เหยียด
biauv	เปย๊า
hmuangv	ฮมวั้ง
doic	ต่อย
oix	อ๋อย
nzangv	ฑั้ง
jaax	จ๋า
yie	เยีย
buatc	ปวัด
ganh	กั้น
horpc	หอบ
hnyouv	เฮญี้ยว
dafaanh	ตะฟ่าน
uix	หวุย
saengkuv	แซงคู้
dorh	ต้อ
siec	เสี่ย
doix	ต๋อย
gouv	โก๊ว
nyeiz	เญ์ย
ndaamvlungh	ด๊ามลู่ง
norqc	เหนาะ
gorngx	ก๋อง
siex	เสีย
douc	โต่ว
buonv	ป๊วน
zungv	ฒู้ง
kuqv	หละคุ
hieh	เฮยี่ย
zoih	ฒ่อย
buang	ปวัง
waac	หว่า
dorn	ตอน
mbuo	บัว
dornjueiv	ตอนเจว๊ย
funfaqv	ฟุนฟะ
buangv	ปวั๊ง
tin	ทิน
deic	เต่ย
douh	โต้ว
ndaubeih	เดาเป้ย
nyorng	ญอง
ganaaiv	กะน้าย
koiv	ค้อย
mbiauz	เบย์า
gamh	กั้ม
nziex	เหฑีย
jiu	จิว
gunv	กุ๊น
haih	ไฮ่
dongz	ต์ง
nyanc	หญั่น
hopv	ฮบ
ih	อี้
nyungcnyungc	หญู่งๆ
zinh	ฒิ่น
ndaangc	ด่าง
laimaeng	ไลแมง
laimiev	ไลเมี้ย
mingh	มี่ง
sem	เซม
haam	ฮาม
yaafetv	ยาเฟ้ด
zeivfun	เฒ้ยฟุน
mbiungcsuivimx	บยู่งซุ้ยอิ๋ม
yiemx	เหยียม
liuz	ลิ์ว
nqa	ฆะฮ้า
buo	ปัว
nduqc	ดุ
waaceix	หว่าเอ๋ย
fih	ฟี่
apclaam	อับลาม
fingx	ฝีง
hlo	โฮล
mengh	เม่ง
hoc	โห่
zioux	เหฒียว
fingxfingx	ฝีงๆ
mienh	เมี่ยน
gaalaatie	กาลาเทีย
ziux	หฒิว
jauv	เจ๊า
lotv	โล้ด
haalaan	ฮาลาน
cietv	เธี้ยด
ziepc	เหฒียบ
hmz	ฮม์
hnyangx	หฮญัง
auv	เอ๊า
saalaai	ซาลาย
fun	ฟุน
liemh	เลี่ยม
zornc	หฒ่อน
dauh	เต้าๆ
kaanaaan	คานาอัน
deicbung	เต่ยปูง
mi	หมี่
gan	กัน
jiex	เจี๋ย
sekem	เซเคม
zingh	ฒี่ง
diuh	ติ้ว
domh	ต้ม
mbaong	บะอง
zuei	เฒวย
mole	โมเล
hinc	หิ่น
naaiv	น้าย
funfaqv	ฟุนฟะ
gongzoh	กงโฒ่
ziecdorngh	เหฒี่ยต้อง
ziec	เหฒี่ย
sinaa	ซีนา
hungh	ฮู่ง
amlaafen	อัมลาเฟน
enlaasaax	เอนลาสา
aaliokc	อาลีโอก
elaam	เอลาม
kendolaaome	เคโดลาโอเม
goyim	โกยิม
tindaan	ทิดาน
hnyangxjeiv	หฮญังเจ๊ย
juov	จั๊ว
yie	เยีย
nernh	เน่น
en	เอนซัดได
muangx	หมวัง
zanczanc	หฒั่นๆ
lamh	ลั่ม
nqemh	เฆ่ม
dorngx	ต๋อง
apclaaham	อับลาฮัม
mamle	มัมเล
ndiangxlomc	เดี๋ยงหล่ม
zueiz	เฒว์ย
ndopvliuh	ด๊บลิ่ว
gauh	เก้า
yuoqv	ยัวะ
ziangh	เฒี่ยง
saalaa	ซาลา
seix	เสย
zaangc	หฒั่ง
baeqv	แป๊ะ
nyic	หญี่
hlang	ฮลัง
gox	โก๋
haic	ไห่
longc	หล่ง
heuc	เห่ว
ketulaa	เคทูลา
camvdauh	ธั้มเต้า
simxlaan	สิมลาน
yokvsaan	โย้กซาน
mendaan	เมดาน
mindien	มีเดียน
itcmbaakc	อิดบาก
quwaa	ชูวา
qembaa	เชบา
ndendaan	เดดาน
njiec	เหฌี่ย
atcsulim	อัดซูลิม
letusim	เลทูซิม
leummim	เลอุมมิม
efaa	เอฟา
efe	เอเฟ
haanokv	ฮาโน้ก
aambindaa	อาบีดา
enndaaaa	เอนดาอา
jaadingh	จาตี้ง
isakc	อีสัก
nzipc	หฑิบ
zeiv	เฒ้ย
buangh	ปวั้ง
nzunc	หฑุ่น
huaang	ฮวาง
ngorc	หง่อ
gelaaaa	เกลาอา
yaakopv	ยาโค้บ
wuomkuotv	ววมค้วด
lomchuaang	หล่มฮวาง
guanh	กวั้น
ba	ปะกี
yungh	ยู่ง
bueix	เปว๋ย
gahlen	กะเฮลน
finmienh	ฟินเมี่ยน
baeng	แปง
fai	ไฟ
tinhungh	ทินฮู่ง
ciangv	เธี้ยง
maahaanaaim	มาหะนาอิม
paaiv	พ้าย
fienx	เฝียน
sei	เสอี
endom	เอโดม
lorz	ล์อ
gorx	ก๋อ
esaau	เอซาว
njaaux	หฌาว
gau	เกา
feix	เฝย
nqoi	ฆอย
fujueiv	ฝุเจว๊ย
leaa	เลอา
laasen	ลาเซน
i	อี
nouh	โน่ว
beiz	เป์ย
puoqv	พัวะ
cingx	หธีง
fatv	ฟัด
mv baac	มป่า
tiux	ถิว
zipv	ฒิบ
qam	ชัม
zom	ฒม
yiutai	ยิวไท
leizfingx	เล์ยฝีง
ndinaa	ดีนา
m	มเซียะ
nziaauc	หฑย่าว
hiwai	ฮีไว
haiz	ไฮ์
hnamv	ฮนั้ม
longx	หลง
nduov	ดั๊ว
ih	อี้
suiv	ซุ้ย
mbetcen	เบดเอน
miucfangx	หมิ่วฝัง
guangc	กวั่ง
saax	สา
yienc	เหยี่ยน
luihoux	ลุยโหว
corc	หธ่อ
die	เตีย
yosepv	โยเซ้บ
lunx	หลุน
yundaa	ยูดา
leih	เล่ย
muozdoic	มั์วต่อย
biaux	เปย๋า
aandunlam	อาดุนลัม
hilaa	ฮีลา
quaa	ชูอา
sin	ซิน
eaa	เออา
danyeic	ตะเหญ่ย
onan	โอนัน
tengx	เถง
dornhlo	ตอนโฮล
taamaa	ทามา
mangc	หมั่ง
waaic	หว่าย
daic	ไต่
caamx	หธาม
faalo	ฟาโล
bouh	โป้ว
angunc	อะหงุ่น
diuv	ติ๊ว
jien	เจียน
njuov	ฌั้ว
dorngc	ต่อง
diex	เตี๋ย
goux	โก๋ว
dinc	ติ่น
baengbieiv	แปงเปย๊ย
wuonx	หววน
loh	โล่
lauh	เล่า
mbeix	เบ๋ย
souv	โซ้ว
naiaa	ไนอา
ndaaih	ด้าย
hlen	เฮลน
yangh	ยั่ง
ngongh	ง่ง
nzueic	เหฑว่ย
junc	จุ่น
luoqc	หลัวะ
diqc	ติ
normh	น่อม
mbiauh	เบย้า
maaiz	ม์าย
maah	ม่าะ
hnaangx	หฮนาง
daic	ไต่
kouv	โค้ว
zaanv	ฒ้าน
nyaanh	ญ่าน
dapv	ตั๊บ
youzlaai	โย์วลาย
mbuoqc	บัวะ
nzuih	ฑุ่ย
bou	โปว
ei	เอย
ndorm	ดอม
nziouv	เฑี้ยว
mbiouzmbiouz	เบี์ยวๆ
njang	ฌัง
fungx	ฝูง
lorh	ล่อ
nzuonx	หฑวน
ziqc	หฒิ
nangc	หนั่ง
go	โก
gaanv	ก๊าน
zunc	หฒุ่น
zaaic	หฒ่าย
naaic	หน่าย
gaax	ก๋า
yie	เยีย
diuc	ติ่ว
mbuo	บัว
nyienz	เญี์ยน
wuommueic	ววมเหมว่ย
beqv	เป๊ะ
maah	ม่าะ
hiuv	ฮิ้ว
nzoih	ฑ่อย
gapv	กั๊บ
zunv	ฒุ้น
hingv	ฮี้ง
sic	สี่
yaakopv	ยาโค้บ
aac	อ่า
isaalaaen	อิสะลาเอน
lumben	ลูเบน
qaqv	ชะ
daauh	ต้าว
simeon	สิเมโอน
lewi	เลวี
muoz	มั์ว
nzuqc	หฑุ
ndaauv	ด๊าว
doqc	โตะ
wuoqc	หวัวะ
ginc	กิ่น
daav	ต๊า
zaeix	หฒะเอ๋ย
caangh	ธ่าง
laangh	ล่าง
daix	ไต๋
sueih	เซว่ย
eix	เอ๋ย
hngaqv	ฮงะ
luangc	หลวั่ง
jaan	จาน
dangx	ตั๋ง
laaix	หลาย
ciouv	เธี้ยว
yundaa	ยูดา
ceng	เธง
buoz	ปั์ว
winwangv	วินวั้ง
jaang	จาง
gueic	เกว่ย
baaix	ป๋าย
sienh	เซี่ยน
saauv	ซ้าว
laauc	หล่าว
yaangh	ย่าง
ngaatc	หงาด
orv	อ๊อ
mbaapv	บ๊าบ
gaamv	ก๊าม
haeqv	แฮะ
nyie	เญีย
ndoh	โด้
hmei	เฮมย
nquaah	ฆว่า
nzox	โหฑ
siqv	ซิ
nziaamv	ฑย้าม
luindaauv	ลุยด๊าว
yiemc	เหยี่ยม
beiv	เป๊ย
ndautouv	เดาโท้ว
biouv	เปี๊ยว
camv	ธั้ม
sembulun	เสบูลุน
koivhlen	ค้อยเฮลน
nzangvbouc	ฑั้งโป่ว
gapvjaaix	กั๊บจ๋าย
daaux	ต๋าว
saindorn	ไซดอน
itcsaaxkaa	อิดสาคา
henv	เฮ้น
laanh	ล่าน
dorx	ต๋อ
ndongx	บุด๋ง
ndaan	ดาน
baengh	แป้ง
fim	ฟิม
siemv	เซี้ยม
baeqc	แปะ
fingxisaalaaen	ฝีงอิสะลาเอน
ndaan	ดาน
naang	นาง
bingx	ปี๋ง
hlaax	หฮลา
nyieqc	เหญียะ
mbueiz	เบว์ย
zieqv	เฒียะ
zung	ฒูง
naic	ไหน่
hlorpv	ฮล้อบ
gunguaaz	กู้งว์า
an	อัน
lomc	หล่ม
dorc	ต่อ
mose	โมเซ
mangc	หมั่ง
dorng	ตอง
nzahmien	หฑะเฮมียน
aalon	อาโลน
ngaengc	แหง่ง
horngh	ฮ่อง
jangxhoc	จั๋งโห่
nzamc	หฑั่ม
leizlatc	เล์ยหลัด
nzung	ฑูง
njoux	เหฌียว
tinhunghyie	ทินฮู่งเยีย
taaih	ท่าย
mborqv	เบ๊าะ
baeng	แปง
o	โอ
mbiaauc	บย่าว
jieqv	เจี๊ยะ
o	โอ
baaic	ป่าย
njopc	หฌบ
douz	โต์ว
buov	ปั๊ว
qui	ชุย
nqaauv	ฆ้าว
zuangx	หฒวัง
elim	เอลิม
sinx	สิน
deicbunghuaang	เต่ยปูงฮวาง
sinaai	ซีนาย
mbong	บง
kang	คัง
liepc	เหลียบ
ciangv	เธี้ยง
lefindim	เลฟีดิม
ongdaa	องตา
sai	ไซ
yeto	เยโท
meih	เม่ย
se	สี
ginv	กิ๊น
cuotv	ธ้วด
dungx	ตู๋ง
zienh	เฒี่ยน
leiz	เล์ย
beiv	เป๊ย
se	สี
zaqc	หฒะ
nimc	หนิ่ม
oix	อ๋อย
fongc	ฝ่ง
horc	ห่อ
jiem	เจียม
suix	สุย
setv	เซ้ด
mbuov	บั๊ว
siqvhongc	ซิห่ง
lamaah	ล่าม่า
ndiemuonc	เดียหม่วน
biei	เปยย
dang	ตัง
galanv	กะลั้น
youh	โย่ว
ndaang	ดาง
laapc	หลาบ
liuc	หลิ่ว
zorpc	หฒอบ
orn	ออน
hung	ฮูง
jaaix	จ๋าย
labieivsiqv	หละเปย๊ยซิ
jaadorngx	จาต๋อง
laengz	แล์ง
faang	ฟาง
ganyiec	กะเหญี่ย
bin	ปิน
hormh	ฮ่อม
dasuqv	ตะซุ
biaa	ปยา
ndorqc	เดาะ
jangv	จั๊ง
feixbung	เฝยปูง
gorqv	เก๊าะ
piaeng	แพยง
naetv	แน้ด
bienh	เปี้ยน
gandiev	กะเดี๊ย
maengx	แหมง
ndaamvziecdorngh	ด๊ามเหฒี่ยต้อง
gaeng	แกง
laatc	หลาด
naamh	น่าม
mbaeqc	แบะ
dongc	ต่ง
fai	ไฟ
ndie	เดีย
topv	ทบ
taapv	ท้าบ
weih	เว่ย
biaav	ปย๊า
corng	ธอง
wuonv	ว้วน
dingx	ตี๋ง
ngau	เงา
mbuox	บั๋ว
zaax	หฒา
dinh	ติ้น
zieqc	เหฒียะ
dieh	เตี้ย
jorng	จอง
ndongh	ด้ง
huaa	ฮูอา
uli	อุลี
mbesaalen	เบซาเลน
gaatv	ก๊าด
labieivjaaix	หละเปย๊ยจ๋าย
ciqv	ธิ
lorqc	เหลาะ
ndiangxzaangc	เดี๋ยงหฒั่ง
diu	ติว
biangh	เปี้ยง
buozdauh	ปั์วเต้า
aamolai	อาโมไล
hitvtai	ฮิดไท
belitvsi	เปลิดซี
yembutc	เยบุด
zuqc	หฒุ
kuaaiv	คว้าย
labieivbenv	หละเปย๊ยเป๊น
fiev	เฟี้ย
huv	ฮู้
hatc	หัด
bienx	เปี๋ยน
ndatv	ดั๊ด
zuqv	ฒุ
singx	สีง
fusux	ฟูสู
japv	จั๊บ
muonc	หม่วน
efotv	เอโฟ้ด
jaaiv	จ๊าย
jiemfinx	เจียมฝิน
yienx	เหยียน
zih	ฒี่
saengyietv	แซงเยี้ยด
wuic	หวุ่ย
maan	มาน
mnqorngv	มฆ้อง
fiqv	ฟิ
zuiz	ฒุ์ย
haaix	หาย
mbuonvmuonc	บ๊วนหม่วน
haaix	หาย
caqvbouc	ธะโป่ว
fiqv	ฟิ
leiznyeic	เล์ยเหญ่ย
pietv	เพี้ยด
huing	ฮวีง
nyutc	หญุด
beu	เปว
nitv	นิด
banv	ปั๊น
hlan	ฮลัน
orvmbiorngz	อ๊อบย์อง
dorh	ต้อ
bingv	ปี๊ง
dabetv	ตะเป๊ด
naandapc	นาดับ
aambihu	อาบีฮู
gorqvmienh	เก๊าะเมี่ยน
hunglouh	ฮูงโล่ว
hietv	เฮยี้ยด
deih	เต้ย
mbaaix	บ๋าย
hlengx	เหฮลง
faan	ฟาน
cov	โธ้
se	สี
mjangc	มจั่ง
zaeqv	แฒะ
nzaaux	หฑาว
hmuangx	หฮมวัง
muoqv	มัวะ
geh	เก้
niemor	เนียมอ
bide	ปีเต
mbienv	เบี๊ยน
hmien	เฮมียน
pai	ไพ
sai	ไซ
eseken	เอเสเคน
cien	เธียน
maac	หม่า
naaiv	น้าย
dingc	ตี่ง
zunh	ฒุ่น
nyeic	เหญ่ย
ziex	เหฒีย
maiv	ไม้
lengc	เหล่ง
jeiv	เจ๊ย
naasi	นาสี
gec	เก่
wuomsui	ววมซุย
yiem	เยียม
teix	เถย
zuov	ฒั้ว
hnoinyieqc	ฮนอยเหญียะ
liouh	เลี่ยว
mbabiei	บะเปยย
siaam	ซยาม
kuh	คู่
janxdaic	จั๋นไต่
sei	เซย
maa	มา
youz	โย์ว
muoc	หมั่ว
se	สี
zeih	เฒ่ย
guoqv	กั๊วะ
jaasic	จาสี่
juqv	จุ๊
cie	เธีย
gomv	ก๊ม
liuh	ลิ่ว
bieiv	เปย๊ย
zih	ฒี่
taux	เถา
nziemxyaangh	เหฑียมย่าง
nzatc	หฑัด
mbui	บุย
kutv	คู้ด
miliem	มิเลียม
sung	ซูง
biaavmbiaac	ปย๊าบย่า
ongtaaix	องถาย
juangc	จวั่ง
ziux	หฒิว
lingc	หลี่ง
nyeizsiqv	เญ์ยซิ
eleaasaa	เอเลอาซา
buozndoqv	ปั์วโด๊ะ
coqv	โธะ
hungx	หูง
tiu	ทิว
ndopv	ด๊บ
jaangh	จ้าง
sindaa	สีดา
zongh	ฒ่ง
kaandetc	คาเดด
guei	เกวย
zangx	หฒัง
guaix	ไกว๋
moapc	โมอับ
ndaubaengh	เดาแป้ง
jorndaen	จอแดน
yeliko	เยลีโค
doixngaanc	ต๋อยหง่าน
sipcbo	สิบโป
mbaalaakv	บาล้าก
gengh	เก้ง
camv	ธั้ม
mbaalaaam	บาลาอัม
hneiv	อะเฮน้ย
faatv	ฟ้าด
dahnaav	ตะฮน้า
huin	ฮวิน
lingh	ลี่ง
mbeo	เบโอ
mzing	มฒีง
tong	ทง
sitvtim	ซิดทิม
hienx	เหฮยียน
yuoqc	หยัวะ
wuonbaengc	ววนแป่ง
buonc	ป่วน
nzengc	เหฑ่ง
da	ตะเยี้ยด
houz	โฮ์ว
muozsieqv	มั์วเซียะ
cietv	เธี้ยด
leizbaaix	เล์ยป๋าย
houv	โฮ้ว
ndortv	ด๊อด
jouxjoux	โจ๋วๆ
matvtaai	มัดทาย
nqox	โหฆ
za	หฒะเก้ง
fai	หละไกว้
baac	ป่า
haaix	หาย
auvguaav	เอ๊ากว๊า
auvleih	เอ๊าเล่ย
jaa	จา
jaauv	จ๊าว
win	วิน
lumben	ลูเบน
gaatc	กาด
yaase	ยาเซ
gileaatc	กิเลอาด
buozndiev	ปั์วเดี๊ย
laamaasetc	ลามาเสด
sukckotv	สุกโค้ด
etaam	เอทาม
mbaasaan	บาซาน
okc	โอก
endeni	เอเดนอี
faix	ไฝ
jangx	จั๋ง
labieiv	หละเปย๊ย
nyouz	โญ์ว
nzauh	เฑ่า
nyiemv	เญี้ยม
jung	จูง
njaih	ไฌ่
mouz	โม์ว
aambipc	อาบีบ
deicjaaix	เต่ยจ๋าย
maanzhmuangx	ม์านหฮมวัง
mungv	มู้ง
fangx	ฝัง
youx	โหยว
nziev	เฑี้ย
hanc	หั่น
laangz	ล์าง
goix	ก๋อย
fengx	เฝง
bouv	โป๊ว
ndutv	ดุ๊ด
zei	เฒย
aeqv	แอ๊ะ
jiez	เจี์ย
balaqc	ปะหละ
capv	ธับ
maaz	ม์า
maazcie	ม์าเธีย
oc	โอ่
horngz	ฮ์อง
laih	ไล่
ndoqv	โด๊ะ
wuomdaaih	ววมต้าย
nauv	เน้า
gorxyouz	ก๋อโย์ว
naah	น่า
guen	เกวน
lui	ลุย
ndorpc	ดอบ
lauz	เล์า
jauvhlen	เจ๊าเฮลน
buoc	ปั่ว
jaux	เจ๋า
dorngh	ต้อง
zic	หฒี่
soux	โสว
mouc	โหม่ว
siou	เซียว
torngx	ถอง
cungaeng	ธุนแกง
don	ตน
hui	ฮวุย
wuotc	หววด
yosuwaa	โยซูวา
zuoqv	ฒัวะ
loqc	โหละ
doixdiuc	ต๋อยติ่ว
nzaanx	หฑาน
mnormh	มน่อม
baamh	ป้าม
gen	เกน
tov	โท้
nzuih	ฑุ่ย
nyinh	ญิ่น
borngbuoz	ปองปั์ว
nun	นุน
nqaai	ฆาย
zagengh	หฒะเก้ง
mbanziu	บะฑิว
yuqc	หยุ
guon	กวน
maiv	ไม้
ai	ไอ
caangv	ธ้าง
zuov	ฒั้ว
waanc	หว่าน
muonz	ม์วน
mbongaiv	บงไอ๊
mbongjuoqv	บงจั๊วะ
lembaanorn	เลบานอน
haaso	ฮาโซ
yaambin	ยาบิน
maandon	มาโดน
yombapc	โยบับ
simlon	ซิมโลน
akcsaapv	อักซ้าบ
hingh	ฮี่ง
aannon	อานโนน
hemon	เฮโมน
aalaambaa	อาลาบา
nzaeng	แฑง
corc	หธ่อ
filisaadie	ฟีลิสะเตีย
gesu	เกซู
nduoh	ดั้ว
fingxbienx	ฝีงเปี๋ยน
bungh	ปู้ง
koivnzauv	ค้อยเฑ้า
dueivmueiz	เตว๊ยเมว์ย
koivcongx	ค้อยหธง
wuomzingv	ววมฒี้ง
caengx	แหธง
lutv	ลู้ด
aataalotv	อาทาโล้ด
aanki	อานคี
maanatvse	มะนัดเส
maaki	มาคี
zengc	เหฒ่ง
aambiyese	อาบีเยเซ
helekv	เฮเล้ก
atclien	อัดลีเอน
hefe	เฮเฟ
semindaa	เซมิดา
selofehatc	เสโลเฟหัด
maakile	มาคีเล
maahaalaa	มาฮาลา
hokvlaa	โฮ้กลา
minkaa	มินคา
tilaasaa	ทีละซา
simeon	สิเมโอน
mbeeqembaa	เบเอเชบา
se	เซ
qembaa	เชบา
molaandaa	โมลาดา
ndaauh	ด้าว
kaux	เขา
caqvbouc	ธะโป่ว
nipc	หนิบ
ndaamvfingx	ด๊ามฝีง
taaixbaengh	ถายแป้ง
normnorm	นอมๆ
gingaan	กินกาน
mbokim	โบคิม
kauv	เค้า
hoz	โฮ์
ehutv	เอฮู้ด
ndembolaa	เดโบลา
aambinoam	อาบีโนอัม
baaux	ป๋าว
mbaengxngaamh	แบ๋งง่าม
mbaengxkuotv	แบ๋งค้วด
aamaalekv	อามาเล้ก
efaaim	เอฟาอิม
gindeon	กิเดโอน
mborqv	เบ๊าะ
dau	เตา
fungc	ฝู่ง
sic	สี่
nzauz	เฑ์า
gaeqv	แก๊ะ
zeiz	เฒ์ย
maanoaa	มาโนอา
solaa	โสลา
saemsanx	แซมสัน
timnaahaa	ทิมนาฮา
gaasaa	กาซา
maaic	หม่าย
mikaa	มีคา
hnyangxdaauh	หฮญังต้าว
etctaaon	เอดทาโอน
zaah	ฒ่า
mingh	มี่ง
oc	โอ่
mbetclehem	เบดเลเฮม
jaavzeih	จ๊าเฒ่ย
butv	ปุ๊ด
nyei	โหฆ
yundie	ยูเดีย
saengv	แซ้ง
kuinx	ขวิน
dafeix	ตะเฝย
sieqvlaangh	เซียะล่าง
nyanc	หญั่น
dangh	ตั้ง
manc	หมั่น
daaih	มี่ง
elimelekv	เอลีเมเล้ก
naaomi	นาโอมี
maalon	มาโลน
kilion	คิลิโอน
efaataa	เอฟาทา
cienceqv	เธียนเธะ
mboaatc	โบอาด
butv	ปุ๊ด
mbuangz	บวั์ง
fai	ไฟ
mbaali	บาลี
ganaaivcenv	กะน้ายเธ้น
nziaaux	หฑยาว
aanx	อ๋าน
bangc	ปั่ง
laamaataaim	ลามาทาอิม
sou	โซว
laamaataaim	ลามาทาอิมโซฟิม
laamaa	ลามา
enkaanaa	เอนคานา
yeloham	เยโลฮัม
elihu	เอลีฮู
tohu	โทหุ
faqv	ฟะ
supc	สูบ
saamuen	ซามูเอน
eli	เอลี
zien	เฒียน
embenese	เอเบนเอเซ
aafekv	อาเฟ้ก
mbaih	ไบ้
suei	เซวย
cin	ธิน
kiliyaatv	คีลิย้าดเยอาลิม
taux	อาบีนาดับ
gu	กู้
nguaaic	หงว่าย
mitvbaadorh	มิดปาต้อ
yoen	โยเอน
dornfaix	ตอนไฝ
aambiyaa	อาบียา
mbenyaamin	เบนยามิน
kitv	คี้ด
aambien	อาบีเอน
selo	เสโล
mbekolatv	เบโคลัด
aafiyaa	อาฟียา
butvzoih	ปุ๊ดฒ่อย
saulo	เซาโล
ndongc	ด่ง
mbaengc	แบ่ง
mbadauh	บะเต้า
dox	โต๋
fai	ไฟ
gikc	กีก
borqv	เป๊าะ
gunv	กุ๊น
cing	ธีง
buonc	ป่วน
ammon	อัมโมน
naahaatc	นาหาด
yaambetc	ยาเบดกิเลอาด
gileaatc	ยาเบด
tov	โท้
fusux	เม่ย
ndaawitv	ดาวิด
yonaataan	โยนาทาน
jaiv	ไจ๊
juangzinx	จวังหฒิน
houxhlaang	โหวฮลาง
junbaeng	จุนแปง
mueic	เหมว่ย
cangx	หธัง
heix	เหย
njienyouh	เฌียนโย่ว
nzoz	โฑ์
patv	พัด
daanh	ต้าน
baah	ป้า
binc	ปิ่น
saulo	เซาโล
cincin	ธินๆ
waancwaanc	หว่านๆ
ninh	นิ่น
waancwaanc	หว่านๆ
haaix	หญู่ง
bungx	ปู๋ง
orqv	เอ๊าะ
mienv	เมี้ยน
morh	ม่อ
nzang	ฑัง
cang	ธัง
biu	ปิว
nzopv	ฑบ
njongc	หฌ่ง
ding	ตีง
jienv	เจี๊ยน
simv	ซิ้ม
nopv	โน้บ
aahimelekv	อาหิเมเล้ก
zinx	หฒิน
weic	เหว่ย
maako	มาโค
lugaa	ลูกา
gatc	กัด
zong	ฒง
qiemx	เฉียม
ndaawitv	ดาวิด
en	เอนเกดี
nyei	เต่ยปูงฮวาง
mbaengx	แบ๋ง
ndo	โด
zouv	โฒ้ว
baalaan	ปาลาน
maaon	มาโอน
kaanmen	คานเมน
sipcaa	สิบอา
gimbeaa	กิเบอา
haakilaa	ฮาคีลา
yesimon	เยซิโมน
doixngaanc	ต๋อยหง่าน
yitvleen	ยิดเลเอน
aakitv	อาคิด
nqaang	ฆาง
ginmboaa	กินโบอา
hei	เฮย
hembolon	เฮโบโลน
amnon	อัมโนน
aahinoam	อาหิโนอัม
kileaapc	คิเลอาบ
naambaan	นาบาน
aambigaayin	อาบีกายิน
dafaam	ตะฟาม
apcsaalom	อับซาโลม
tanmai	ทันไม
maaaakaa	มาอาคา
aandoniyaa	อาโดนียา
hakvgitc	ฮักกีด
dahmz	ตะฮม์
sefaatiyaa	เซฟาทิยา
aambitan	อาบีทัน
daluoqc	ตะหลัวะ
itcleam	อิดเลอัม
ekclaa	เอกลา
apcne	อับเน
mdaaih	มต้าย
nziaamvfei	ฑย้ามเฟย
juangc	จวั่ง
mbungv	บู๊ง
orv	อ๊อ
hoic	ห่อย
naatan	นาทัน
ndopvliuh	ด๊บลิ่ว
maaih	ม่าย
winh	วิ่น
en	เอน
ninh	นิ่น
maaih	ม่าย
jomc	จ่ม
seluyaa	เสลุยา
yoaapc	โยอาบ
tekoaa	เทโคอา
congmengh	ธงเม่ง
nzaatv	ฑ้าด
mbongningv	บงนี้ง
mefimbosetv	เมฟีโบเซ้ด
simbaa	ซิบา
ken	เคน
buic	ปุ่ย
tor	ทอ
ndunh	ดุ้น
biouvnqaai	เปี๊ยวฆาย
gorng	กอง
ndopvmbuoqc	ด๊บบัวะ
aahitofen	อาหิโทเฟน
dimv	ติ๊ม
cuoqv	ธัวะ
mbikcli	บีกลี
jetcsi	เจียดซี
mueiz	เมว์ย
se	เซ
zoc	โหฒ่
homc	ห่ม
suangx	สวัง
siouv	เซี้ยว
saalomorn	ซาโลมอน
yelusaalem	เยลูซาเลม
gimbeon	กิเบโอน
saaxndokc	สาโดก
aasaaliyaa	อาซาลิยา
qiqaa	ชีชา
eliholepv	เอลีโฮเล้บ
aahiyaa	อาหิยา
soubiuv	โซวปิ๊ว
aahilutv	อาหิลู้ด
yehosaafatv	เยโฮซาฟัด
soudaan	โซวตาน
yehoyaandaa	เยโฮยาดา
mbenaiyaa	เบไนยา
aambiyaataa	อาบียาทา
saengvziouv	แซ้งเฒี้ยว
saaxmbutc	สาบุด
aahiqaa	อาหิชา
apcndaa	อับดา
aandonilam	อาโดนีลัม
aapv	อ๊าบ
gongmienh	กงเมี่ยน
juang	จวัง
tailaqv	ไทละ
hilaam	ฮีลาม
zuoqc	หฒัวะ
ndaawitv	ดาวิด
wuih	วุ่ย
bungbung	ปูงๆ
zauxndiev	เหฒาเดี๊ย
faam	ฟาม
gemh	เก้ม
faah	ฟ่า
liouz	เลี์ยว
ndiouh	เดี้ยว
haengh	แฮ่ง
sion	สิโอน
etaanim	เอทานิม
mbiorv	บย๊อ
funx	ฝุน
aqc	อะ
torh	ท่อ
hnaangxdieh	หฮนางเตี้ย
zorngzuqv	ฒองฒุ
diuvzaanv	ติ๊วฒ้าน
peix	เผย
fuc	ฝู่
sienx	เสียน
lehoxmboam	เลโหโบอัม
wuov	วั้ว
nembatc	เนบัด
yelomboam	เยโลโบอัม
iyipv	อียิบ
yietv	เยี้ยด
longc	หล่ง
ziec	เหฒี่ย
baengc	แป่ง
zorng	ฒอง
silo	ซีโล
haanaani	ฮานานี
yehu	เยฮู
mbaaaaqaa	บาอาชา
silie	ซีเลีย
aalam	อาลัม
haandatc	เบนฮาดัด
baengguanh	แปงกวั้น
saamaalie	สะมาเลีย
naambotc	นาโบด
aahapc	อาหับ
naaaamaan	นาอามาน
gomh	ก้ม
sieqvfaix	เซียะไฝ
elisaa	เอลีซา
hepc	เหบ
liuc	หลิ่ว
gileaatc	ลาโม้ดกิเลอาด
nimsi	นิมซี
qongx	ฉง
aahatcyaa	อาหัดยา
yoaatc	โยอาด
yehoaahaatc	เยโฮอาหาด
baamz	ป์าม
yehoaatc	เยโฮอาด
aamaasiyaa	อามาซิยา
yehoatcndin	เยโฮอัดดิน
lemaaliyaa	เลมาลิยา
bekaa	เปคา
yotaam	โยทาม
aahatc	อาหัด
elaa	เอลา
hoseyaa	โฮเซยา
hesekiyaa	เฮเซคียา
sekaaliyaa	เสคาลิยา
aambi	อาบี
betv	เป๊ด
ndiecou	เดียโธว
eliyaakim	เอลียาคิม
sepvnaa	เซ้บนา
aamortv	อาม้อด
isaayaa	อิสะยา
naanc	หน่าน
nyaiv	ไญ้
hepvsimbaa	เฮ้บซีบา
yelemi	เยเลมี
hlohlo	โฮลๆ
faixfaix	ไฝๆ
njunc	หฌุ่น
yehoyaakim	เยโฮยาคิม
mbaambilon	บาบีโลน
nembukatvnetvsaa	เนบูคัดเน้ดซา
ndaanien	ดานีเอน
sendekiyaa	เสเดคียา
dajuov	ตะจั๊ว
saengziepc	แซงเหฒียบ
saengjuov	แซงจั๊ว
itcsaaxkaa	อิดสาคา
sembulun	เสบูลุน
napvtaali	นับทาลี
aase	อาเซ
beletv	เปเล้ด
hetvlon	เฮ้ดโลน
kaanmi	คานมี
sombaan	โซบาน
leaayaa	เลอายา
yaahaatc	ยาหาด
aahumai	อาหุไม
laahaatv	ลาฮ้าด
geson	เกโซน
kohaatv	โคฮ้าด
melaali	เมลาลี
amlaam	อัมลาม
itchaa	อิดฮา
utcsien	อุดซีเอน
itaamaa	อิทามา
finehatc	ฟีเนหัด
aambiquwaa	อาบีชูวา
mbukcki	บุกคี
utcsi	อุดซี
selaahiyaa	เสลาหิยา
melaayotv	เมลาโย้ด
aamaaliyaa	อามาลิยา
aahitupv	อาหิทู้บ
aahimaaatc	อาหิมาอัด
yohaanan	โยฮานัน
guaatv	กว๊าด
yehosaandakc	เยโฮซาดัก
tolaa	โทลา
puaa	พูอา
yaasupv	ยาซู้บ
lefaiyaa	เลไฟยา
yelien	เยลีเอน
yaamai	ยาไม
ipcsamx	อิบสัม
daan	ตาน
isaalaahiyaa	อิสะลาหิยา
mikaaen	มีคาเอน
ombaandi	โอบาดี
itcsiyaa	อิดซียา
dorndiex	ตอนเตี๋ย
hietc	เหฮยียด
mbelaa	เบลา
mbeke	เบเค
yendiyaaen	เยดียาเอน
etcmbon	เอดโบน
yelimotv	เยลีโม้ด
ili	อิลี
semilaa	เสมิลา
eliyese	เอลีเยเซ
elionai	เอลีโอไน
omli	โอมลี
yelemotv	เยเลโม้ด
aanaatotv	อานาโท้ด
aalemetv	อาเลเม้ด
mbinhaan	บินฮาน
yeutc	เยอูด
kenaaaanaa	เคนาอะนา
setaan	เสทาน
taansitv	ทานซิด
aahiqaahaa	อาหิชาฮา
supvbim	ซุบปิม
hupcbim	หุบปิม
ilaqv	อีละ
husim	หุซิม
aahe	อาเฮ
atcmben	อัดเบน
aahaalaa	อาหะลา
nohaa	โนฮา
laafaa	ลาฟา
atcndaa	อัดดา
gelaa	เกลา
aambihutv	อาบีฮู้ด
aahoxaa	อาโหอา
sefufaan	เซฟูฟาน
hulaam	หุลาม
gembaa	เกบา
maanaahaatv	มานาฮ้าด
utcsaa	อุดซา
aahihutv	อาหิฮู้ด
saahaalaaim	ซาหะลาอิม
mbaaaalaaaa	บาอาลาอา
hondetc	โฮเดด
simbie	สิเบีย
mesaa	เมซา
mankaam	มันคาม
buonvdeic	ป๊วนเต่ย
nehaami	เนหะมี
sikclaakv	สิกล้าก
labieivzaangc	หละเปย๊ยหฒั่ง
sammuwaa	ซัมมุวา
sombapc	โซบับ
elisaamaa	เอลีซามา
mbeenyaandaa	เบเอนยาดา
elifeletv	เอลีเฟเล้ด
ulien	อุลีเอน
aasaaxyaa	อาสายา
elisaafaan	เอลีซาฟาน
semaiaa	เซไมอา
elien	เอลีเอน
amminaandapc	อัมมีนาดับ
fiuvlaangz	ฟิ้วล์าง
nzou	โฑว
sombaa	โสบา
haandatcese	ฮาดัดเอเซ
haamatv	ฮามัด
yufeditc	ยูเฟติด
zaangv	ฒ้าง
ndaamatvgatc	ดามัดกัด
baengciangv	แปงเธี้ยง
jiemtorngvbaaih	เจียมท้องป้าย
saadaan	ซาตาน
yiem	เยียม
fiev	เฟี้ย
dunx	ตุ๋น
calengc	หธะเหล่ง
aasaapc	อาสาบ
hemaan	เฮมาน
yendutun	เยดูทูน
fiuvdaanh	ฟิ้วต้าน
nqaapv	ฆ้าบ
caauh	ธ่าว
sakcge	สักเก
netaaniyaa	เนทานิยา
aaqaalelaa	อาชาเลลา
gendaaliyaa	เกดาลิยา
seli	เสลี
yesaayaa	เยซายา
simei	ซิเมอี
haasaabiyaa	ฮาซาปิยา
matvtitiyaa	มัดทีทิยา
hoqc	โหะ
banh	ปั้น
zeic	เหฒ่ย
hlieqv	เฮลียะ
ben	เปน
mbuovmaeng	บั๊วแมง
labieivmuonc	หละเปย๊ยหม่วน
labieivmau	หละเปย๊ยเมา
zinh	ฒิ่น
gengx	เก๋ง
ndormndorm	ดอมๆ
muonzmuonz	ม์วนๆ
sianghlaax	เซียงหฮลา
daux	เต๋า
gaux	เก๋า
njanglaangc	ฌังหล่าง
siangceix	เซียงเหธย
haamatv	ฮามัดโสบา
tatvmo	ทัดโม
joux	โจ๋ว
porv	พ้อ
sisakv	ซิซัก
ondetc	โอเดด
aasaax	อาสา
mbungh	บู้ง
mbaaan	บาอัน
zuotc	หฒวด
aaselaa	อาเซลา
cingjaa	ธีงจา
nzorng	ฑอง
nouz	โน์ว
baengbeiv	แปงเป๊ย
yehohaanan	เยโฮฮานัน
isaamaaen	อิสะมาเอน
ombetc	โอเบด
aandaayaa	อาดายา
maaaaseaa	มาอาเสอา
sikcli	สิกลี
elisaafatv	เอลีซาฟัด
simbiyaa	สิบียา
zorc	หฒ่อ
nzouzinh	โฑวฒิ่น
hnyangxhnyangx	หฮญังๆ
siepvsiepv	เซี้ยบๆ
mbenc	เบ่น
mv	สี่
gaanv	ก๊าน
yelusaa	เยลูซา
utcsiyaa	อุดซียา
borngz	ป์อง
biauv	เปย๊า
ofen	โอเฟน
laauh	ล่าว
koi	คอย
labieivdongc	หละเปย๊ยต่ง
caeqv	แธะ
mietc	เหมียด
bunsai	ปุนไซ
atcsilie	อัดซีเลีย
sennaakelipv	เซนนาเคลิบ
yosiyaa	โยสิยา
zaaix	หฒาย
goiv	ก๊อย
zaangcnyei	หฒั่งเญย
fioux	เฝียว
jorm	จอม
yoaahaatc	โยอาหาด
sailatv	ไซลัด
besie	เปเซีย
esaalaa	เอสะลา
buonvmungv	ป๊วนมู้ง
buonvlaangz	ป๊วนล์าง
selupvmbaamben	เสลุบบาเบน
yesuaa	เยซูอา
selaiaa	เสไลอา
leelaiyaa	เลเอไลยา
mondekai	โมเดไค
mbinsaan	บินซาน
mitvbaa	มิดปา
mbikcwai	บิกไว
lehum	เลฮูม
mbaaaanaa	บาอานา
baalotv	ปาโล้ด
aalaa	อาลา
hakvgai	ฮักไก
itcndo	อิดโด
dengv	เต๊ง
seantien	เซอันทิเอน
yosaandakc	โยซาดัก
mbahnoi	บะฮนอย
tatvtenai	ทัดเทไน
qetaa	เชทาโบเซไน
aengx	เซียงเหลียบ
siangliepc	เจี์ย
ndaaliatc	ดาลิอัด
mindie	มีเดีย
ekcmbaataanaa	เอกบาทานา
lapv	ลับ
nqenx	เหฆน
camvhnyangx	ธั้มหฮญัง
aantaasesitv	อานทาเซซี้ด
hinkiyaa	ฮินคียา
sanlum	ซันลูม
gesom	เกโซม
hatvtatv	ฮัดทัด
sekaaniyaa	เซคานิยา
sanxmbaanlatv	สันบานลัด
huotv	ฮว้วด
qaqv	ชะ
ngopv	งบ
haananyaa	ฮานันยา
qembaaniyaa	เชบานียา
manlukv	มันลุก
maaaasiyaa	มาอาซิยา
mbingai	บินไก
ginnetoi	กินเนทอย
aahaasuelatv	อาหะสุเอลัด
gaqiex	กะเฉีย
fiu	ฟิว
watvqaati	วัดชาที
aagakc	อากัก
hammendaataa	ฮัมเมดาทา
haamaan	ฮามาน
esete	เอเซเท
njormh	ฌ่อม
aandaa	อาดา
tiuv	ทิ้ว
temaan	เทมาน
elifatv	เอลีฟัด
yopv	โย้บ
aah	อ้า
feix	เฝย
faanh	ฟ่าน
nziang	เฑียง
baamh	ป้าม
gongzinh	กงฒิ่น
mbinndatc	บินดัด
zanc	หฒั่น
pien	เพียน
zingx	หฒีง
loz	โล์
ahnoi	อะฮนอย
koqv	โคะ
linh	ลิ่น
yopv	โย้บ
naaaame	นาอาเม
sofaa	โสฟา
gorngv	ก๊อง
guai	ไกว
aiv	ไอ๊
mienh	เมี่ยน
zoqc	โหฒะ
congmengh	ธงเม่ง
wuonh	ว่วน
zaang	ฒาง
dangv	ตั๊ง
morc	หม่อ
nangv	นั้ง
baav	ป๊า
ornlorqc	ออนเหลาะ
mbaang	บาง
fujueivfaix	ฝุเจว๊ยไฝ
hlauvndongh	เฮล้าด้ง
nux	หนู
nauc	เหน่า
nyitc	หญิด
kuv	คู้
dorngxdaauh	ต๋องต้าว
gornbaengx	กอนแป๋ง
laengh	แล่ง
gaengv	แก๊ง
om	อม
nernh	เน่น
ndeicnqenx	เด่ยเหฆน
orqc	เอาะ
gengh	เก้ง
ziangv	เฒี้ยง
mun	มุน
zien	เฒียน
wetv	เว้ด
hlaaxnyieqc	หฮลาเหญียะ
diev	เตี๊ย
jaav	จ๊า
dunh	ตุ้น
yunh	ยุ่น
siouc	เสี่ยว
piex	เผีย
nziaauxzunc	หฑยาวหฒุ่น
gornndoqv	กอนโด๊ะ
haaix	หาย
lorh	ล่อ
hlaang	ฮลาง
ndauhuaang	เดาฮวาง
ndaunzaaih	เดาฑ่าย
hlaang	ฮลาง
cunx	หธุน
kuangx	ขวัง
jaaxzinh	จ๋าฒิ่น
saengeix	แซงเอ๋ย
cangfou	ธังโฟว
congmengh	ธง
aax	อ๋า
hnaangxnqaai	หฮนางฆาย
sekv	เซ้ก
hngongx	หฮงง
bouc	โป่ว
waacsapv	หว่าซับ
mau	เมา
puix	ผุย
duih	ตุ้ย
sorng	ซอง
gaengzuangx	แกงหฒวัง
zaux	เหฒา
mbai	ไบ
zaux	เหฒา
ndiux	ดิ๋ว
hnangv	ฮนั้ง
njimv	ฌิ้ม
nyiec	เหญี่ย
yaake	ยาเค
aagu	อากู
beiv	เป๊ย
tipv	ทิบ
gorngvhemx	ก๊องเหม
gorngvbaeqc	ก๊องแปะ
cunciou	ธุนเธียว
jatv	จั๊ด
zoi	ฒอย
laaih	ล่าย
luic	หลุ่ย
longx	หลง
nyau	เญา
hienv	เฮยี้ยน
hniev	เฮนี้ย
ngatv	งัด
mienh	เมี่ยน
leiz	เล์ย
mungz	มู์ง
zueix	เหฒวย
diqv	ติ๊
kuotv	ค้วด
nyorqv	เญาะ
piqv	พิ
ndiangxndongh	เดี๋ยงด้ง
zeqc	เหฒะ
mbuonx	บ๋วน
baqv	ป๊ะ
siangmbuangz	เซียงบวั์ง
muyorc	มูหย่อ
mueizdorngh	เมว์ยต้อง
mueizpengx	เมว์ยเผง
nyorx	หญอ
daapc	ตาบ
heh	เฮ่
camh	ธั่ม
zuih	ฒุ่ย
junh	จุ้น
corx	หธอ
houh	โฮ่ว
saeng	แซง
sioux	เสียว
nzungh	ฑู่ง
nquaav	ฆว้า
zatv	ฒัด
jiepv	เจี๊ยบ
naangjieqv	นางเจี๊ยะ
kuotvndaangc	ค้วดด่าง
korvlienh	ค้อเลี่ยน
ngaanc	หง่าน
etiobie	เอทีโอเปีย
ndaatv	ด๊าด
ndatc	ดัดๆ
jopvnyeic	จ๊บเหญ่ย
sefanyaa	เสฟันยา
ciedoix	เธียต๋อย
yienh	เยี่ยน
siepv	เซี้ยบ
mingh	มี่งๆ
mingh	ต้ายๆ
luih	ลุ่ย
lewiaataan	เลวีอาทาน
qouqou	โชวๆ
nquin	ฆวิน
ndongx	ด๋ง
guaengv	แกว๊ง
dopv	ต๊บ
aauv	อ๊าว
dangcov	ตังโธ้
ganx	กั๋น
gunguaazmbuoqc	กู้งว์าบัวะ
muotv	ม้วด
cai	ไธ
nyie	เญีย
gongfim	กงฟิม
biux	ปิ๋ว
jiez	เจี์ย
cau	เธา
ningv	นี้ง
ndui	ดุย
ndiangxnquaah	เดี๋ยงฆว่า
nyang	ญัง
mbueix	เบว๋ย
lungh	ลู่ง
aamon	อาโมน
ziouv	เฒี้ยว
yie	เยีย
isaalaaen	อิสะลาเอน
hlungh	ฮลู่ง
hluotv	ฮล้วด
zingv	ฒี้ง
zueih	เฒว่ย
haanz	ฮ์าน
biopv	ปย๊บ
nqaiv	ไฆ้
imme	อิมเม
baatche	ปาดเฮ
baetv	แป๊ด
luv	ลู้
ndiangxgaaz	เดี๋ยงก์า
gaaz	ก์า
sounjunc	โซวหฌุ่น
nembusaalaandaan	เนบูซาละดาน
limc	หลิ่ม
mikvndon	มิกโดน
taabaanhetc	ทาปานเหด
memfitv	เมมฟิด
neliyaa	เนลิยา
haamutaan	ฮามุทาน
lipvnaa	ลิบนา
njuotv	ฌ้วด
maeqv	แมะ
forng	ฟอง
forngndongh	ฟองด้ง
cunv	ธุ้น
niezun	เนียฒุน
gornbuonv	กอนป๊วน
ndeic	เด่ย
mievbiangh	เมี้ยเปี้ยง
nor’meih	นอ
mancmanc	หมั่นๆ
youc	โหย่ว
jauh	เจ้า
ceux	เหธว
lunc	หลุ่น
mangc	หมั่ง
lakuotv	หละค้วด
sieqvlunx	เซียะหลุน
oholaa	โอโฮลา
nziez	เฑี์ย
oholimbaa	โอโฮลีบา
ciev	เธี้ย
aamotv	อาโม้ด
daziepc	ตะเหฒียบ
ting	ทีง
kembaa	เคบา
ziouv	เฒี้ยว
gunyuoz	กะญั์ว
cingh	ธี่ง
mborqc	เบาะ
nitv	นิด
dongh	ต้ง
zengc	เหฒ่ง
cingnzengc	ธีงเหฑ่ง
jiemfangx	เจียมฝัง
mbensatvsaa	เบนซัดซา
donx	ต๋น
hlo	โฮล
coux	โหธว
nzutv	ฑุด
wuov	วั้ว
aengx	แอ๋ง
sai	ไซ
hlaanghlopv	ฮลางฮลบ
taambo	ทาโบ
zaeng	แฒง
aakaasiezoux	อาคาเซีย
siem	เซียม
maux	เหมา
zorngzengx	ฒองเหฒง
ndiqv	ดิ๊
zuiznipc	ฒุ์ยหนิบ
janxzaqc	จั๋นหฒะ
zungh	ฒู่ง
betuen	เปทุเอน
kaanne	คานเน
aamitvtai	อามิดไท
yonaa	โยนา
gasie	กะเซีย
daav	ต๊า
ninaawe	นินะเว
jauvkuv	เจ๊าคู้
haambaagukc	ฮาบากุก
kusi	คูซี
nyiemc	เหญี่ยม
njunh	ฌุ่น
juv	จู๊
cau	เธา
ndaix	ได๋
kitvlepv	คิดเล้บ
saengfeix	แซงเฝย
cun	ธุน
gueix	เกว๋ย
mbiungc	บยู่ง
yesu	เยซู
giduc	กีตู่
uliyaa	อุลียา
yolam	โยลัม
helotv	เฮโล้ด
samx	สัม
hleix	เหฮลย
sie	เซีย
suonc	ส่วน
deixmaaih	เต๋ยม่าย
tindorngh	ทินต้อง
saigorx	ไซก๋อ
koivdorn	ค้อยตอน
poux	โผว
faalisi	ฟาลิสี
dau	บะฮนอย
aav	อ๊า
horh	ฮ่อ
njang	ฌัง
hlorngx	หฮลอง
aav	โล่ะ
ndormnziouv	ดอมเฑี้ยว
mbuonxjieqv	บ๋วนเจี๊ยะ
ih	อี้
mbiungcnziaaux	บยู่งหฑยาว
gaalili	กาลิลี
poutong	โพวทง
cingv	ธี้ง
huingxziouv	หฮวีงเฒี้ยว
maazli	มาลี
sieqvdorn	เซียะตอน
sianglaangh	เซียงล่าง
kaabenaaum	คาเปนาอุม
noic	หน่อย
biauvngorh	เปย๊าง่อ
zouvgemh	โฒ้วเก้ม
gennesaaletv	เกนเนซาเล้ด
nduov	ดั๊ว
waacbeiv	หว่าเป๊ย
kaanaa	คานา
cingjaayinh	ธีงจายิ่น
yiemtoi	เยียมทอย
maengh	แม่ง
hmeinquaah	เฮมยฆว่า
dueiv	เตว๊ย
gitv	กิ๊ด
tuix	ถุย
bilaatv	ปีล้าด
biaavbin	ปย๊าปิน
luindaauvluoqc	ลุยด๊าวหลัวะ
simon	ซีโมน
tomatv	โทมัด
sunggunguaaz	ซูงกู้งว์า
naataanaaen	นาทานาเอน
sembendi	เสเบดี
aanaanie	อานาเนีย
sapcfilaa	สับฟีลา
nzong	ฑง
nzepv	เฑ้บ
doz	โต์
saatefen	สะเทเฟน
jiubaang	จิวปาง
janx	จั๋น
ikoniyum	อีโคนียูม
baulo	เปาโล
mbaanaambatc	บานาบัด
silaa	ซีลา
amfimbuli	อัมฟีบุลี
aaborlonie	อาปอโลเนีย
tesaalonigaa	เทสะโลนิกา
aaten	อาเทน
aakuinlaa	อาควินลา
borntatv	ปอนทัด
bitcsinxlaa	ปิดสินลา
idaali	อิตาลี
kaalaaundiatc	คาลาวดิอัด
timotai	ทิโมไท
maasindonie	มาซีโดเนีย
guv	กู๊
hiaang	ฮยาง
tetulatv	เททูลัด
sisaaliyaa	ซีซาลียา
zungx	หฒูง
fesaatatv	เฟสะทัด
atclaamitvtiyum	อัดลามิดทิยุม
esie	เอเซีย
silisie	ซีลีเซีย
bamfilie	ปัมฟีเลีย
lisie	ลีเซีย
mbienx	เบี๋ยน
koivnzou	ค้อยโฑว
morndaa	มอนตา
juangv	จวั๊ง
gorngv	ก๊อง
daaix	ต๋าย
luonx	หลวน
horngc	ห่อง
maux	เหมา
liouc	เหลี่ยว
donv	ต๊น
filipvpoi	ฟีลิบพอย
mbiorngz	บย์อง
younzauh	โยวเฑ่า
beic	เป่ย
nangh	นั่ง
aamen	อาเมน
jiuv	จิ๊ว
tidatc	ทิตัด
nzauh	เฑ่า
saaix	สาย
longc	หล่ง
janxgikc	จั๋นกีก
gauv	เก๊า
dorngcmeih	ต่อง
ndaam	ดาม
mbiaangx	บย๋าง
cou	โธว
kolosi	โคโลสี
siev	เซี้ย
mauv	เม้า
kuanv	ควั้น
tien	เทียน
waaczaanc	หว่าหฒ่าน
waaccou	หว่าโธว
pali	พะลี
palaaix	พะหลาย
weic	เหว่ย
miucfangx	หมิ่วฝัง
kungxwaac	ขูงหว่า
nouhyie	โน่วเยีย
wuonv	ว้วน
tov	โท้
yuondie	ยูโอเดีย
sinxtike	สินทิเค
kenmen	เคนเมน
guaax	กว๋า
jouh	โจ้ว
zanx	หฒัน
gongzohyie	กงโฒ่เยีย
laundisie	เลาดีเซีย
hnyouvzoih	เฮญี้ยวฒ่อย
gem	เกม
mbiaangc	บย่าง
gorxyouz	ก๋อ
hemx	เหม
lanyauv	หละเญ้า
ndouv	โด๊ว
longxlongx	หลงๆ
haah	ฮ่า
ki	คี
enzingh	เอนฒี่ง
zanv	ฒั้น
laangc	หล่าง
qangx	ฉัง
nyunc	หญุ่น
finsaeng	ฟินแซง
hlioux	เหฮลียว
gouvlaic	โก๊วไหล่
waachuv	หว่าฮู้
hengx	เหง
auvjaanx	เอ๊าจ๋าน
jienfouv	เจียนโฟ้ว
norh	น่อ
filemon	ฟีเลโมน
zuiz	ฒุ์ย
sianglungh	เซียงลู่ง
gingsou	กีงโซว
taux	นิ่น
leizlatc	เล์ย
latc	หลัด
lozhnoi	โล์ฮนอย
kaeqv	แคะ
jiembuozndoqvnzaeng	เจียมปั์วโด๊ะแฑง
luihouxhuv	ลุยโหวฮู้
jaax	จ๋า
kapvbaandosie	คับปาโดเซีย
mbitinie	บิทีเนีย
efeso	เอเฟโซ
jiemjaax	เจียมจ๋า
daaih	ต้าย
biorngh	ปย้อง
nzieqc	เหฑียะ
ndaamvnorm	ด๊ามนอม
biaavndorqc	ปย๊าเดาะ
biorngh	ปย้อง
mouh	โม่ว
siangnzung	เซียงฑูง
bunh	ปุ้น
lengh	เล่ง
jaic	ไจ่
faangdaauh	ฟางต้าว
faangnqaaix	ฟางหฆาย
im	อิม
dov	โต๊
camx	หธัม
qorng	ชอง
fong	ฟง
muonh	ม่วน
maah	ม่าะ
setc	เสด
baatc	ปาด
joih	จ้อย
miucbiauv	หมิ่วเปย๊า
nquaqv	ฆวะ
ndipc	ดิบ
gaengh	แก้ง
saaiv	ซ้าย
hiaamx	หฮยาม
heihorngc	เฮยห่อง
bungxsing	ปู๋งซีง
bungxqiex	ปู๋งเฉีย
saaivndui	ซ้ายดุย
hlutv	ฮลุด
buozndoqvnzaeng	ปั์วโด๊ะแฑง
zauxhlen	เหฒาเฮลน
aah	อ้า
meix	เหมย
buv	ปู๊
longh	ล่ง
koux	โขว
gaav	ก๊า
zaeqvziouv	แฒะเฒี้ยว
kungxmorngh	ขูงม่อง
mbouv	โบ๊ว
huaaxnyinz	หฮวาญิ์น
beuv	เป๊ว
ndaunqaai	เดาฆาย
torngv	ท้อง
deicbunghaanz	เต่ยปูงฮ์าน
hnoihnoi	ฮนอยๆ
ziemx	เหฒียม
nzangh	ฑั่ง
cenghlo	เธงโฮล
saah	ซ่าะ
beih	เป้ย
nie	เนีย
aandam	อา​ดัม
haawaa	ฮา​วา
kaain	คา​อิน
aambaen	อา​แบน
toi	ทอย
caa	ธา
niaa	นีอา
morngx	หมอง
naqv	นะ
njouh	โฌ่ว
huaax	หฮวา
enden	เอ​เดน
enokv	เอ​โน้ก
laamekv	ลา​เม้ก
aandaa	อา​ดา
siang	เซียง
div	ตี๊
zuangv	ฒวั้ง
enotv	เอ​โน้ด
kenan	เค​นัน
maahaalaalen	มา​หะ​ลา​เลน
yaaletv	ยา​เล้ด
metuselaa	เม​ทู​เส​ลา
noyaa	โน​ยา
yaafetv	ยา​เฟ้ด
aa	อา
haapv	ฮ้าบ
nqo	โฆ
kaanaaan	คา​นา​อัน
gome	โก​เม
maagokc	มา​โกก
maandai	มา​ได
yaawaan	ยา​วาน
tumban	ทู​บัน
mesekv	เม​เซ้ก
tilaatv	ทิ​ล้าด
atckenatv	อัด​เค​นัด
lifaatv	ลี​ฟ้าด
togaanmaa	โท​กาน​มา
eliseaa	เอ​ลี​เซ​อา
taansitv	ทาน​ซิด
kitvtim	คิด​ทิม
londaanim	โล​ดา​นิม
iyipv	อี​ยิบ
putv	พู้ด
sembaa	เส​บา
haawilaa	ฮา​วิ​ลา
sapctaa	สับ​ทา
laaaamaa	ลา​อา​มา
sapctekaa	สับ​เท​คา
qembaa	เช​บา
ndendaan	เด​ดาน
nimlotv	นิม​โล้ด
daamv	ต๊าม
ninaawe	นิ​นะ​เว
lundim	ลู​ดิม
aanaamim	อา​นา​มิม
lehaambim	เล​หะ​บิม
napvtuhim	นับ​ทู​ฮิม
hiwai	ฮี​ไว
aankaa	อาน​คา
sini	สี​นี
elaam	เอ​ลาม
atcsu	อัด​ซู
aanfaasatv	อาน​ฟา​ซัด
lunde	ลู​เด
aalam	อา​ลัม
utc	อูด
hun	ฮูน
gete	เก​เท
qelaa	เช​ลา
embe	เอ​เบ
yokvtaan	โย้ก​ทาน
anmondatc	อัน​โม​ดัด
qelepv	เช​เล้บ
haasaanmaawetv	ฮา​ซาน​มา​เว้ด
yelaa	เย​ลา
haandolam	ฮา​โด​ลัม
usaan	อุ​ซาน
ndikclaa	ดิก​ลา
aambimaaen	อา​บี​มา​เอน
ofi	โอ​ฟี
yombapc	โย​บับ
fanh	ฟั่น
mbaamben	บา​เบน
belekv	เป​เล้ก
leu	เล​อู
selukv	เส​ลุก
naaho	นา​โฮ
telaa	เท​ลา
apclaam	อับ​ลาม
haalaan	ฮา​ลาน
saalaai	ซา​ลาย
minkaa	มิน​คา
negepc	เน​เกบ
faalo	ฟา​โล
mbetcen	เบด​เอน
sondom	โส​โดม
gomolaa	โก​โม​ลา
atcmaa	อัด​มา
semboyim	เส​โบ​ยิม
mbelaa	เบ​ลา
naaiv	น้าย
soaa	โส​อา
zingh	ฒี่ง
taamaa	ทา​มา
aamaalekv	อา​มา​เล้ก
aamolai	อา​โม​ไล
sitcndim	สิด​ดิม
ndaamatvgatc	ดา​มัด​กัด
kendolaaome	เค​โด​ลา​โอ​เม
aengx	แอ๋ง
aane	อา​เน
etcko	เอด​โค
mamle	มัม​เล
torngvbaaih	ท้องป้าย
eliyese	เอ​ลี​เย​เซ
apclaaham	อับ​ลา​ฮัม
gopv	ก๊บ
nyuonh	ญ่วน
hitvtai	ฮิด​ไท
belitvsi	เป​ลิด​ซี
lefaaim	เล​ฟา​อิม
haagaa	ฮา​กา
isaamaaen	อิ​สะ​มา​เอน
saalaa	ซา​ลา
ni	นี
zaamc	หฒ่าม
lov	โล้
ziouc	เหฒี่ยว
fongv	ฟ้ง
baan	ปาน
gelaaaa	เก​ลา​อา
aambimelekv	อา​บี​เม​เล้ก
isakc	อี​สัก
houc	โห่ว
nzitv	ฑิด
mbeeqembaa	เบ​เอ​เช​บา
lomh	ล่ม
ndoqc	โดะ
haaso	ฮา​โซ
mbetuen	เบ​ทู​เอน
lembekaa	เล​เบ​คา
hembolon	เฮ​โบ​โลน
sohaax	โส​หา
efolon	เอ​โฟ​โลน
zaangh	ฒ่าง
ko	โค
lo	โล
ong	อง
gux	กู๋
laambaan	ลา​บาน
kangv	คั้ง
zorv	ฒ้อ
ketulaa	เค​ทู​ลา
yokvsaan	โย้ก​ซาน
mitvmaa	มิด​มา
ndumaa	ดู​มา
haandatc	ฮา​ดัด
temaa	เท​มา
yetu	เย​ทู
naafitv	นา​ฟิด
kendemaa	เค​เด​มา
esaau	เอ​ซาว
yaakopv	ยา​โค้บ
dopc	ตบ
filisaadie	ฟี​ลิ​สะ​เตีย
mbeeli	เบ​เอ​ลี
elon	เอ​โลน
mbaasematv	บา​เส​มัด
hluo	ฮลัว
nzomz	ฑ์ม
laasen	ลา​เซน
siangx	เสียง
nauz	เน์า
bietv	เปี๊ยด
laambaan	ลา​บาน
pienx	เผียน
mbinhaa	บิน​ฮา
leaa	เล​อา
lewi	เล​วี
napvtaali	นับ​ทา​ลี
sinxbaa	สิน​ปา
witv	วิด
saau	ซาว
ndundaaim	ดู​ดา​อิม
jieh	เจี้ย
ndinaa	ดี​นา
diemv	เตี๊ยม
pui	พุย
piatv	พยัด
isaalaaen	อิ​สะ​ลา​เอน
yosepv	โย​เซ้บ
sei	เส​อี
haamo	ฮา​โม
sekem	เซ​เคม
simeon	สิ​เม​โอน
buix	ปุ๋ย
efaalaataa	เอ​ฟา​ลา​ทา
mbenyaamin	เบน​ยา​มิน
aase	อา​เซ
se	เซ
elifatv	เอ​ลี​ฟัด
leuen	เล​อู​เอน
temaan	เท​มาน
omaa	โอ​มา
sefo	เส​โฟ
naahatc	นา​หัด
zelaa	เฒ​ลา
aanaa	อา​นา
yeutc	เย​อูด
yaalaam	ยา​ลาม
kolaa	โค​ลา
oholimbaamaa	โอ​โฮ​ลี​บา​มา
dongh	ต้ง
endom	เอ​โดม
holi	โฮ​ลี
homam	โฮ​มัม
lotaan	โล​ทาน
timnaa	ทิม​นา
sombaan	โซ​บาน
maanaahaatv	มา​นา​ฮ้าด
embaan	เอ​บาน
onam	โอ​นัม
ndison	ดี​โซน
etcmbaan	เอด​บาน
itclaan	อิด​ลาน
kelaan	เค​ลาน
ese	เอ​เซ
ndisaan	ดี​ซาน
aalan	อา​ลัน
simbeon	สิ​เบ​โอน
endom	เอ​โดม
ndinhaambaa	ดิน​ฮา​บา
mbosaalaa	โบ​ซา​ลา
husaam	หุ​ซาม
mbendatc	เบ​ดัด
moapc	โม​อับ
mindien	มี​เดียน
aawitv	อา​วี้ด
samxlaa	สัม​ลา
lehoxmbotc	เล​โห​โบด
saaun	ซา​อุน
akcmbo	อัก​โบ
anwaa	อัน​วา
yetetv	เย​เท้ด
elaa	เอ​ลา
binon	ปี​โนน
kenatv	เค​นัด
mipvsaa	มิบ​ซา
ndotaan	โด​ทาน
lumben	ลู​เบน
yundaa	ยู​ดา
quaa	ชู​อา
eaa	เอ​อา
onan	โอ​นัน
hipvlu	ฮิบ​ลู
jei	เจย
naiaa	ไน​อา
dorv	ต๊อ
nyaux	เหญา
laeh	แล่
sing	ซีง
fingv	ฟี้ง
haanokv	ฮา​โน้ก
banlu	ปัน​ลู
hetvlon	เฮ้ด​โลน
kaanmi	คาน​มี
yemuen	เย​มู​เอน
yaamin	ยา​มีน
ohaatc	โอ​หาด
yaakin	ยา​คีน
geson	เก​โซน
kohaatv	โค​ฮ้าด
melaali	เม​ลา​ลี
itcsaaxkaa	อิด​สา​คา
tolaa	โท​ลา
simlon	ซิม​โลน
sembulun	เส​บู​ลุน
seletv	เส​เล้ด
yaaleen	ยา​เล​เอน
hakvgi	ฮัก​กี
suni	ซู​นี
etcmbon	เอด​โบน
elei	เอ​เล​อี
aaleli	อา​เล​ลี
imnaa	อิม​นา
itcwaa	อิด​วา
itcwi	อิด​วี
mbeliyaa	เบ​ลี​ยา
selaaaa	เซ​ลา​อา
hembe	เฮ​เบ
mbeke	เบ​เค
atcmben	อัด​เบน
gelaa	เก​ลา
naaaamaan	นา​อา​มาน
aatc	อาด
husim	หุ​ซิม
yaasien	ยา​ซี​เอน
guni	กุ​นี
yese	เย​เซ
sinlem	ซิน​เลม
gosen	โก​เซน
nyim	ญิม
maanatvse	มะ​นัด​เส
efaaim	เอ​ฟา​อิม
nyaah	ญ่า
cei	เธย
jorndaen	จอ​แดน
maaki	มา​คี
mose	โม​เซ
aalon	อา​โลน
ziang	เฒียง
lueic	เหลว่ย
lipvni	ลิบ​นี
simei	ซิ​เม​อี
maazli	มา​ลี
musi	มู​ซี
itchaa	อิด​ฮา
nefekv	เน​เฟ้ก
sikcli	สิก​ลี
utcsien	อุด​ซี​เอน
misaaen	มิ​ซา​เอน
ensaafaan	เอน​ซา​ฟาน
naason	นา​โซน
naandapc	นา​ดับ
itaamaa	อิ​ทา​มา
atcsi	อัด​สี
enkaanaa	เอน​คา​นา
eleaasaa	เอ​เล​อา​ซา
finehatc	ฟี​เน​หัด
yaamh	ย่าม
ziqv	ฒิ
caix	ไหธ
biauvhlen	เปย๊าเฮลน
faanv	ฟ้าน
douznzauc	โต์วเหฑ่า
borqc	เปาะ
mbaali	บา​ลี
mapv	มับ
ziouv	เฒี้ยว
ndaamv	ด๊าม
zouc	โหฒ่ว
sukckotv	สุก​โค้ด
cih	ธี่
aambipc	อา​บีบ
zietc	เหฒียด
miliem	มิ​เลียม
orqv	เอ้าะ
morqv	เมาะ
lefindim	เล​ฟี​ดิม
huaa	ฮู​อา
yosuwaa	โย​ซู​วา
zutc	หฒุด
yeto	เย​โท
jaangv	จ๊าง
sinaai	ซี​นาย
mbongningv	บง
mbongnqenx	บงเหฆน
hanh	ฮั่น
lungz	ลู์ง
buih	ปุ้ย
leic	เหล่ย
waengc	แหว่ง
aambihu	อา​บี​ฮู
kuing	ควีง
kelumbim	เค​ลู​บิม
waengh	แว่ง
lunh	ลุ่น
nekv	เน้ก
kou	โคว
wuonc	หว่วน
efotv	เอ​โฟ้ด
paanx	ผาน
ndingh	ดี้ง
ndaamdorng	ดามตอง
nqanx	หฆัน
hiuang	ฮยวัง
ging	กีง
peux	เผว
uli	อุ​ลี
mbesaalen	เบ​ซา​เลน
mbuonv	บ๊วน
sortv	ซ้อด
siousetv	เซียวเซ้ด
yembutc	เย​บุด
aengv	แอ๊ง
oholiapc	โอ​โฮ​ลี​อับ
gungh	กู้ง
gangc	กั่ง
nyatv	ญัด
caeqvjaangh	แธะจ้าง
caan	ธาน
gorqc	เกาะ
kuei	เควย
juix	จุ๋ย
caeng	แธง
naatv	น้าด
ulim	อุ​ลิม
tummim	ทุม​มิม
buoqv	ปั๊วะ
omx	อ๋ม
sietv	เซี้ยด
buozzaangv	ปั์วฒ้าง
maeng	แมง
guaaih	กว้าย
laauz	ล์าว
molekv	โม​เล้ก
siouh	เซี่ยว
nziepv	เฑี้ยบ
hlaau	ฮลาว
selomitv	เซ​โล​มิด
buonvfingx	ป๊วนฝีง
suxlisatvndai	สู​ลิ​ซัด​ได
selumien	เซ​ลู​มิ​เอน
amminaandapc	อัม​มี​นา​ดับ
zuaa	ฒู​อา
netanen	เน​ทัน​เอน
helon	เฮ​โลน
eliapc	เอ​ลี​อับ
ammihutv	อัม​มี​ฮู้ด
elisaamaa	เอ​ลี​ซา​มา
bendaasu	เป​ดา​ซู
gaamaalien	กา​มา​ลิ​เอน
gindeoni	กิ​เด​โอ​นี
aambindan	อา​บี​ดัน
aahiyese	อา​หิ​เย​เซ
okaan	โอ​คาน
baagien	ปา​กี​เอน
ndeuen	เด​อู​เอน
eliyaasaapc	เอ​ลี​ยา​สาบ
enan	เอ​นัน
aahilaa	อา​หิ​ลา
amlaam	อัม​ลาม
elisaafaan	เอ​ลี​ซา​ฟาน
mborng	บอง
maanaa	มา​นา
mueix	เหมวย
zepv	เฒ้บ
sakcge	สัก​เก
sammuwaa	ซัม​มุ​วา
saafatv	ซา​ฟัด
yefunne	เย​ฟุน​เน
kaalepv	คา​เล้บ
igaan	อิ​กาน
hoseyaa	โฮ​เซ​ยา
mikaaen	มี​คา​เอน
yaauc	หย่าว
hec	เห่
nzie	เฑีย
zitc	หฒิด
homaa	โฮ​มา
doixdekc	ต๋อยเตก
ndaataan	ดา​ทาน
aambilam	อา​บี​ลัม
siangsic	เซียงสี่
yiemh	เยี่ยม
loh	โล่ะ
zorngh	ฒ่อง
melimbaa	เม​ลี​บา
kaandetc	คา​เดด
hoaa	โฮ​อา
aalaatv	อา​ล้าด
naangdoqc	นางโตะ
zeletv	เฒ​เล้ด
sihonx	สิ​โหน
hetvmbon	เฮ้ด​โบน
kemotv	เค​โม้ด
mbiec	เบี่ย
sipcbo	สิบ​โป
mbaalaakv	บา​ล้าก
mbaalaaam	บา​ลา​อัม
laaic	หล่าย
mbaaan	บา​อัน
zengx	เหฒง
mbeo	เบ​โอ
kenai	เค​ไน
beo	เป​โอ
simxli	สิม​ลี
kotvmbi	โค้ด​บี
suxaa	สู​อา
otcni	โอด​นี
yaasupv	ยา​ซู้บ
atclien	อัด​ลี​เอน
semindaa	เซ​มิ​ดา
hefe	เฮ​เฟ
selofehatc	เส​โล​เฟ​หัด
maahaalaa	มา​ฮา​ลา
hokvlaa	โฮ้ก​ลา
tilaasaa	ที​ละ​ซา
suham	ซู​ฮัม
gileaatc	กิ​เล​อาด
maakile	มา​คี​เล
aambaalim	อา​บา​ลิม
ewi	เอ​วี
lekem	เล​เคม
lembaa	เล​บา
jungz	จู์ง
mikvndon	มิก​โดน
lipvnaa	ลิบ​นา
taahatc	ทา​หัด
yotvmbaataa	โย้ด​บา​ทา
ombotc	โอ​โบด
nembo	เน​โบ
atcmon	อัด​โมน
mendidelenien	เม​ดิ​เต​เล​เนียน
haamatv	ฮา​มัด
sendatc	เส​ดัด
mbukcki	บุก​คี
hannien	ฮัน​นี​เอน
kemuen	เค​มู​เอน
bantien	ปัน​ที​เอน
aahihutv	อา​หิ​ฮู้ด
endeni	เอ​เดน​อี
atctaalotv	อัด​ทา​โล้ด
mbaasaan	บา​ซาน
holepv	โฮ​เล้บ
zinh	ฒิ่น
aanaakv	อา​น้าก
yaahaatv	ยา​ฮ้าด
aangopc	อาน​โกบ
sorn	ซอน
hemon	เฮ​โมน
saindorn	ไซ​ดอน
seni	เส​นี
mou	โมว
benv	เป๊น
aalaambaa	อา​ลา​บา
bitcgaa	ปิด​กา
juoqv	จั๊วะ
jienh	เจี้ยน
nqaeqv	แฆะ
maqc	หมะ
jamv	จั๊ม
caaiv	ธ้าย
long	ลง
weic	เหว่ย
kungxbuoz	ขูงปั์ว
jiemx	เจี๋ยม
fin	ฟิน
ammon	อัม​โมน
ngaih	ไง่
linc	หลิ่น
dou	โตว
baengx	แป๋ง
tutv	ทุด
gelisim	เก​ลิ​ซิม
tongx	ถง
aamen	อา​เมน
buoqc	ปัวะ
nqaatv	ฆ้าด
yang	ยัง
laahapc	ลา​หับ
gingaan	กิน​กาน
yeliko	เย​ลี​โค
sapcndi	สับ​ดี
aakaan	อา​คาน
ndapv	ดั๊บ
gimbeon	กิ​เบ​โอน
mbeelotv	เบ​เอ​โล้ด
yelusaalem	เย​ลู​ซา​เลม
yaanmutv	ยาน​มู้ด
laakitv	ลา​คี้ด
yaafie	ยา​เฟีย
ekclon	เอก​โลน
ndembi	เด​บี
aasekaa	อา​เซ​คา
makvkendaa	มัก​เค​ดา
aiyaalon	ไอ​ยา​โลน
gese	เก​เซ
yaambin	ยา​บิน
maandon	มา​โดน
akcsaapv	อัก​ซ้าบ
mitvbaa	มิด​ปา
tauv	เท้า
aandunlam	อา​ดุน​ลัม
tapvbuwaa	ทับ​ปู​วา
aafekv	อา​เฟ้ก
megitcndo	เม​กิด​โด
kendetc	เค​เดด
kaanmen	คาน​เมน
yokvneam	โย้ก​เน​อัม
goyim	โก​ยิม
gesu	เก​ซู
maaaakaa	มา​อา​คา
saaxlekaa	สา​เล​คา
kendemotv	เค​เด​โม้ด
mefaaaatc	เม​ฟา​อาด
mbaaaalaa	บา​อา​ลา
timnaahaa	ทิม​นา​ฮา
akcsaax	อัก​สา
otcnien	โอด​นี​เอน
daanz	ต์าน
sipcaa	สิบ​อา
telem	เท​เลม
mbeaalotv	เบ​อา​โล้ด
semaa	เซ​มา
molaandaa	โม​ลา​ดา
esem	เอ​เซม
entolatv	เอน​โท​ลัด
sikclaakv	สิก​ล้าก
matvmannaa	มัด​มัน​นา
soko	โส​โค
mbotckaatv	โบด​ค้าด
ete	เอ​เท
aaqan	อา​ชัน
atcnaa	อัด​นา
aanaapv	อา​น้าบ
etctemoaa	เอด​เท​โม​อา
aalapc	อา​หลับ
maaon	มา​โอน
yitvleen	ยิด​เล​เอน
gendo	เก​โด
aataalotv	อา​ทา​โล้ด
naaaalaa	นา​อา​ลา
silo	ซี​โล
apcwim	อับ​วิม
ofaalaa	โอ​ฟา​ลา
laamaa	ลา​มา
mosaa	โม​ซา
kision	คี​ซิ​โอน
embetc	เอ​เบด
hammatv	ฮัม​มัด
kinneletv	คิน​เน​เล้ด
solaa	โส​ลา
etctaaon	เอด​ทา​โอน
ekolon	เอ​โค​โลน
enteke	เอน​เท​เค
gipcmbeton	กิบ​เบ​โทน
mbaaaalatv	บา​อา​ลัด
mbesekv	เบ​เซ้ก
sesai	เซ​ไซ
aahimaan	อา​หิ​มาน
tanmai	ทัน​ไม
akcsipv	อัก​ซี้บ
lehopc	เล​โหบ
ehutv	เอ​ฮู้ด
mbienc	เบี่ยน
aanaatv	อา​น้าด
samgaa	ซัม​กา
ndembolaa	เด​โบ​ลา
aambinoam	อา​บี​โน​อัม
taambo	ทา​โบ
siselaa	สิ​เส​ลา
dimc	ติ่ม
nyomc	หญ่ม
congx	หธง
gindeon	กิ​เด​โอน
yoaatc	โย​อาด
wuomhlen	ววมเฮลน
mbietc	เบียด
aambiyese	อา​บี​เย​เซ
zembaa	เฒ​บา
sanxmunnaa	สัน​มุน​นา
benuen	เป​นู​เอน
heletv	เฮ​เล้ด
gaam	กาม
yotaam	โย​ทาม
mbee	เบ​เอ
sembun	เส​บุน
gaaan	กา​อัน
king	คีง
nzauv	เฑ้า
haaz	ฮ์า
tembetc	เท​เบด
saami	ซา​มี
jaai	จา​อี
yepvtaa	เย้บ​ทา
aaloe	อา​โล​เอ
mbetclehem	เบด​เล​เฮม
bilaaton	ปิ​ลา​โทน
apcndon	อับ​โดน
maanoaa	มา​โน​อา
saemsanx	แซม​สัน
guaengx	แกว๋ง
gaasaa	กา​ซา
ndelilaa	เด​ลิ​ลา
nqamv	ฆั้ม
mikaa	มี​คา
laaitc	ลา​อิด
gimbeaa	กิ​เบ​อา
wuov	วั้ว
naaomi	นา​โอ​มี
elimelekv	เอ​ลี​เม​เล้ก
lute	ลู​เท
maalon	มา​โลน
kilion	คิ​ลิ​โอน
nyaam	ญาม
juoh	จั้ว
hnievhniev	เฮนี้ยๆ
maalaa	มา​ลา
mboaatc	โบ​อาด
ongx	อ๋ง
camvcamv	ธั้มๆ
nzien	เฑียน
tongv	ท้ง
laam	ลาม
sanxmon	สัน​โมน
ombetc	โอ​เบด
jetcsi	เจียด​ซี
ndaawitv	ดา​วิด
buonvzingh	ป๊วนฒี่ง
eli	เอ​ลี
hopvni	โฮ้บ​นี
beninnaa	เป​นิน​นา
hannaa	ฮัน​นา
saengyungz	แซงยู์ง
saamuen	ซา​มู​เอน
atcndotc	อัด​โดด
lozdorngx	โล์ต๋อง
aambinaandapc	อา​บี​นา​ดับ
ndamv	ดั๊ม
saulo	เซา​โล
zouh	โฒ่ว
fuix	ฝุย
yaambetc	ยา​เบด
naahaatc	นา​หาด
mikvmaatv	มิก​ม้าด
suan	ซู​อัน
yonaataan	โย​นา​ทาน
aahiyaa	อา​หิ​ยา
apcne	อับ​เน
ne	เน
aambien	อา​บี​เอน
suwaa	ซู​วา
aagakc	อา​กัก
sammaa	ซัม​มา
hmienfangx	เฮมียนฝัง
goliatc	โก​ลิ​อัด
naamx	หนาม
saaaalaaim	ซา​อา​ลา​อิม
sieqvhlo	เซียะโฮล
melaapv	เม​ล้าบ
mikaan	มี​คาน
naayotv	นา​โย้ด
aahimelekv	อา​หิ​เม​เล้ก
aakitv	อา​คิด
ndoekc	โด​เอก
aahitupv	อา​หิ​ทู้บ
aambiyaataa	อา​บี​ยา​ทา
keilaa	เค​อี​ลา
naambaan	นา​บาน
aambigaayin	อา​บี​กา​ยิน
aahinoam	อา​หิ​โน​อัม
seluyaa	เส​ลุ​ยา
yoaapc	โย​อาบ
aambiqai	อา​บี​ไช
sunem	ซู​เนม
ginmboaa	กิน​โบ​อา
box	โป๋
dien	เตียน
keleti	เค​เล​ที
yieqv	เยียะ
laamotv	ลา​โม้ด
yaatvti	ย้าด​ที
yelaameen	เย​ลา​เม​เอน
orpv	อ๊อบ
jiemh	เจี้ยม
yaasaa	ยา​ซา
itcmbosetv	อิด​โบ​เซ้ด
maahaanaaim	มา​หะ​นา​อิม
njaangh	ฌ่าง
aasaaxhen	อา​สา​เฮน
amnon	อัม​โนน
aandoniyaa	อา​โด​นี​ยา
hakvgitc	ฮัก​กีด
sefaatiyaa	เซ​ฟา​ทิ​ยา
gitctaaim	กิด​ทา​อิม
limmon	ลิม​โมน
lekaapv	เล​ค้าบ
mbaaaanaa	บา​อา​นา
minlo	มิน​โล
naatan	นา​ทัน
saalomorn	ซา​โล​มอน
ipchaa	อิบ​ฮา
elisuwaa	เอ​ลี​ซู​วา
eliyaandaa	เอ​ลี​ยา​ดา
elifeletv	เอ​ลี​เฟ​เล้ด
gembaa	เก​บา
utcsaa	อุด​ซา
wingc	หวี่ง
laamx	หลาม
sindaa	สี​ดา
sombaa	โส​บา
haandatcese	ฮา​ดัด​เอ​เซ
yufeditc	ยู​เฟ​ติด
silie	ซี​เลีย
yehoyaandaa	เย​โฮ​ยา​ดา
mbenaiyaa	เบ​ไน​ยา
peletv	เพ​เล้ด
simbaa	ซิ​บา
mefimbosetv	เม​ฟี​โบ​เซ้ด
haanun	ฮา​นูน
mbatcqembaa	บัด​เช​บา
uliaa	อุ​ลี​อา
lapvmbaa	ลับ​บา
apcsaalom	อับ​ซา​โลม
yonaandapc	โย​นา​ดับ
tekoaa	เท​โค​อา
itctai	อิด​ไท
saaxndokc	สา​โดก
aahimaaatc	อา​หิ​มา​อัด
aahitofen	อา​หิ​โท​เฟน
husai	หุ​ไซ
mbaasinlai	บา​ซิน​ไล
aamaasaax	อา​มา​สา
mbikcli	บีก​ลี
ilaa	อิ​ละ
aiaa	ไอ​อา
litvbaa	ลิด​ปา
simehaa	ซี​เม​ฮา
nzenc	เหฑ่น
nqaengc	แหฆ่ง
dauh	เต้า
aahoxhai	อา​โห​ไฮ
ndondo	โด​โด
haalaa	ฮา​ลา
enhaanan	เอน​ฮา​นัน
haalotv	ฮา​โล้ด
heletvte	เฮ​เล้ด​เท
ikcketc	อิก​เขด
aanaatotv	อา​นา​โท้ด
husaa	หุ​ซา
netofaa	เน​โท​ฟา
maahaalai	มา​หะ​ไล
limbai	ลี​ไบ
gaaatc	กา​อัด
mbaahulim	บา​ฮู​ลิม
atcmaawetv	อัด​มา​เว้ด
aahiyam	อา​หิ​ยัม
gilon	กิ​โลน
hetvlo	เฮ้ด​โล
mbaani	บา​นี
selekv	เส​เล้ก
naahaalai	นา​หะ​ไล
itclai	อิด​ไล
gaalepv	กา​เล้บ
uliyaa	อุ​ลี​ยา
yaase	ยา​เซ
aalaaunaa	อา​ลาว​นา
ninh	นิ่น
aambiqaakv	อา​บี​ช้าก
aasaaliyaa	อา​ซา​ลิ​ยา
aahilutv	อา​หิ​ลู้ด
itcndo	อิด​โด
yehosaafatv	เย​โฮ​ซา​ฟัด
jai	ไจ
hilaam	ฮี​ลาม
lembaanorn	เล​บา​นอน
aandonilam	อา​โด​นี​ลัม
lorngx	หลอง
tei	เทย
ndiangxbenv	เดี๋ยงเป๊น
daau	ตาว
nzipv	ฑิบ
yuonh	ย่วน
tailaqv	ไท​ละ
longz	ล์ง
sengh	เซ่ง
nzormc	หฑ่อม
sion	สิ​โอน
gaalili	กา​ลิ​ลี
taabenetv	ทา​เป​เน้ด
yelomboam	เย​โล​โบ​อัม
lehoxmboam	เล​โห​โบ​อัม
lozziouv	โล์เฒี้ยว
aambiyaa	อา​บี​ยา
jaandaangc	จาด่าง
sisakv	ซิ​ซัก
nembatc	เน​บัด
aambiyam	อา​บี​ยัม
aambiqaalom	อา​บี​ชา​โลม
aasaax	อา​สา
mbaaaaqaa	บา​อา​ชา
omli	โอม​ลี
saamaalie	สะ​มา​เลีย
aahapc	อา​หับ
aaselaa	อา​เซ​ลา
eliyaa	เอ​ลี​ยา
ombaandi	โอ​บา​ดี
yesemben	เย​เซ​เบน
kison	คี​โซน
yehu	เย​ฮู
elisaa	เอ​ลี​ซา
haasaaen	ฮา​ซา​เอน
naambotc	นา​โบด
imlaa	อิม​ลา
mikaayaa	มี​คา​ยา
aahatcyaa	อา​หัด​ยา
sinhi	ซิน​หิ
aasumbaa	อา​ซุ​บา
yolam	โย​ลัม
yeholam	เย​โฮ​ลัม
saidiex	ไซเตี๋ย
ov	โอ๊
gehaasi	เก​หะ​ซี
donc	ต่น
fai	ไฟ
sih	ซี่
aannon	อาน​โนน
yehoaahaatc	เย​โฮ​อา​หาด
aataaliyaa	อา​ทา​ลิ​ยา
luonh	ล่วน
mbaix	ไบ๋
njapv	ฌับ
njiuv	ฌิ้ว
yehoaatc	เย​โฮ​อาด
aamaasiyaa	อา​มา​ซิ​ยา
ndaau	ดาว
sekaaliyaa	เส​คา​ลิ​ยา
sanlum	ซัน​ลูม
utcsiyaa	อุด​ซี​ยา
gaandi	กา​ดี
menaahem	เม​นา​เฮม
atcsilie	อัด​ซี​เลีย
bekaahiyaa	เป​คา​หิ​ยา
lemaaliyaa	เล​มา​ลิ​ยา
bekaa	เป​คา
aahatc	อา​หัด
lesin	เล​ซิน
kiaa	คี​อา
mindie	มี​เดีย
mbaambilon	บา​บี​โลน
sefaanwaaim	เส​ฟาน​วา​อิม
hesekiyaa	เฮ​เซ​คี​ยา
sennaakelipv	เซน​นา​เค​ลิบ
isaayaa	อิ​สะ​ยา
aanbatc	อาน​ปัด
henaa	เฮ​นา
ipcwaa	อิบ​วา
opv	อ๊บ
aamon	อา​โมน
yosiyaa	โย​สิ​ยา
aandaayaa	อา​ดา​ยา
mesunlaam	เม​ซุน​ลาม
aasaalaiyaa	อา​ซา​ไล​ยา
saafaan	ซา​ฟาน
hinkiyaa	ฮิน​คี​ยา
aahikam	อา​หิ​คัม
aasaaxyaa	อา​สา​ยา
hunndaa	ฮุน​ดา
kitclon	ขิด​โลน
buonvsin	ป๊วนซิน
haamutaan	ฮา​มุ​ทาน
yelemi	เย​เล​มี
lipvlaa	ลิบ​ลา
yehoyaakim	เย​โฮ​ยา​คิม
bendaayaa	เป​ดา​ยา
yehoyaakin	เย​โฮ​ยา​คีน
ennaatan	เอน​นา​ทัน
sendekiyaa	เส​เด​คี​ยา
aanwatv	อาน​วัด
matvsaax	มัด​สา
gaataam	กา​ทาม
mitvsaa	มิด​ซา
anwaan	อัน​วาน
mbinhaan	บิน​ฮาน
saaxwaan	สา​วาน
matvlekaa	มัด​เล​คา
makvndien	มัก​ดี​เอน
ilaam	อิ​ลาม
beletv	เป​เล้ด
haamun	ฮา​มูน
etaan	เอ​ทาน
hemaan	เฮ​มาน
kaanko	คาน​โค
ndaanndaa	ดาน​ดา
yete	เย​เท
segupc	เส​กุบ
sammai	ซัม​ไม
aambihaain	อา​บี​ฮา​อิน
itci	อิด​อี
sesan	เซ​ซัน
akclai	อัก​ไล
saaxmbaatc	สา​บาด
eleaasaax	เอ​เล​อา​สา
yekaamiyaa	เย​คา​มิ​ยา
beletc	เป​เหลด
efaa	เอ​ฟา
saaapc	ซา​อับ
qewaa	เช​วา
simeaa	ซิ​เม​อา
nogaa	โน​กา
selupvmbaamben	เส​ลุบ​บา​เบน
haananyaa	ฮา​นัน​ยา
mbelekiyaa	เบ​เล​คิ​ยา
belaatiyaa	เป​ลา​ที​ยา
yesaayaa	เย​ซา​ยา
lefaiyaa	เล​ไฟ​ยา
sekaaniyaa	เซ​คา​นิ​ยา
semaiaa	เซ​ไม​อา
hatvtatv	ฮัด​ทัด
neaaliyaa	เน​อา​ลี​ยา
elionai	เอ​ลี​โอ​ไน
atclikam	อัด​ลี​คัม
hondaawiyaa	โฮ​ดา​วิ​ยา
eliyaasipv	เอ​ลี​ยา​ซี้บ
belaiyaa	เป​ไล​ยา
akckupc	อัก​ขูบ
yohaanan	โย​ฮา​นัน
ndelaiyaa	เด​ไล​ยา
leaayaa	เล​อา​ยา
yaahaatc	ยา​หาด
edaam	เอ​ตาม
itcmaa	อิด​มา
helaa	เฮ​ลา
baaseaa	ปา​เส​อา
selaiaa	เส​ไล​อา
etclaa	เอด​ลา
meletv	เม​เล้ด
efe	เอ​เฟ
kenan	เค​นัน
maahaalaalen	มา​หะ​ลา​เลน
enokv	เอ​โน้ก
metuselaa	เม​ทู​เส​ลา
noyaa	โน​ยา
aalam	อา​ลัม
qelaa	เช​ลา
isakc	อี​สัก
lotaan	โล​ทาน
ndison	ดี​โซน
haandatc	ฮา​ดัด
yundaa	ยู​ดา
amminaandapc	อัม​มี​นา​ดับ
naason	นา​โซน
sanxmon	สัน​โมน
ombetc	โอ​เบด
jaai	จา​อี
sesan	เซ​ซัน
naatan	นา​ทัน
yehu	เย​ฮู
ndaawitv	ดา​วิด
lehoxmboam	เล​โห​โบ​อัม
aambiyaa	อา​บี​ยา
aasaax	อา​สา
aamaasiyaa	อา​มา​ซิ​ยา
aasaaliyaa	อา​ซา​ลิ​ยา
aahatc	อา​หัด
hesekiyaa	เฮ​เซ​คี​ยา
ammon	อัม​โมน
yehoyaakin	เย​โฮ​ยา​คีน
selupvmbaamben	เส​ลุบ​บา​เบน
yesaayaa	เย​ซา​ยา
lefaiyaa	เล​ไฟ​ยา
ombaandi	โอ​บา​ดี
semaiaa	เซ​ไม​อา
yaahaatc	ยา​หาด
maalesaa	มา​เล​ซา
gendelaa	เก​เด​ลา
nemuen	เน​มู​เอน
yaalipv	ยา​ลี้บ
sanlum	ซัน​ลูม
mipvsamx	มิบ​สัม
sakcge	สัก​เก
aayin	อา​ยิน
yoen	โย​เอน
aasien	อา​สิ​เอน
aandien	อา​ดี​เอน
zizaa	ฒี​ฒา
yendaayaa	เย​ดา​ยา
simli	ซิม​ลี
mikaa	มี​คา
gileaatc	กิ​เล​อาด
mikaaen	มี​คา​เอน
mbutc	บุด
aahi	อา​หิ
elien	เอ​ลี​เอน
finehatc	ฟี​เน​หัด
aambiquwaa	อา​บี​ชู​วา
mbukcki	บุก​คี
utcsi	อุด​ซี
selaahiyaa	เส​ลา​หิ​ยา
selaahiyaa	เส​ลา​หิ​ยา
melaayotv	เม​ลา​โย้ด
aamaaliyaa	อา​มา​ลิ​ยา
aamaaliyaa	อา​มา​ลิ​ยา
saaxndokc	สา​โดก
hinkiyaa	ฮิน​คี​ยา
yehosaandakc	เย​โฮ​ซา​ดัก
nembukatvnetvsaa	เน​บู​คัด​เน้ด​ซา
simxmaa	สิม​มา
yoaa	โย​อา
zelaa	เฒ​ลา
enkaanaa	เอน​คา​นา
embiyaasaapc	เอ​บี​ยา​สาบ
embiyaasaapc	เอ​บี​ยา​สาบ
taahatc	ทา​หัด
ulien	อุ​ลี​เอน
utcsiyaa	อุด​ซี​ยา
eliapc	เอ​ลี​อับ
yeloham	เย​โล​ฮัม
yeloham	เย​โล​ฮัม
simeaa	ซิ​เม​อา
maahaatv	มา​ฮ้าด
aamaasaix	อา​มา​ไส
yoen	โย​เอน
sefanyaa	เส​ฟัน​ยา
atcsi	อัด​สี
itchaa	อิด​ฮา
kohaatv	โค​ฮ้าด
lewi	เล​วี
aasaapc	อา​สาบ
aasaapc	อา​สาบ
mbelekiyaa	เบ​เล​คิ​ยา
mankiyaa	มัน​คิ​ยา
simxmaa	สิม​มา
geson	เก​โซน
apcndi	อับ​ดี
manlukv	มัน​ลุก
haasaabiyaa	ฮา​ซา​ปิ​ยา
haasaabiyaa	ฮา​ซา​ปิ​ยา
amsi	อัม​ซี
amsi	อัม​ซี
mbaani	บา​นี
qeme	เช​เม
maazli	มา​ลี
melaali	เม​ลา​ลี
utcsi	อุด​ซี
melaayotv	เม​ลา​โย้ด
ndaambelatv	ดา​เบ​ลัด
puaa	พู​อา
yendiyaaen	เย​ดี​ยา​เอน
yelimotv	เย​ลี​โม้ด
yelemotv	เย​เล​โม้ด
aalemetv	อา​เล​เม้ด
kenaaaanaa	เค​นา​อะ​นา
hupcbim	หุบ​ปิม
supvbim	ซุบ​ปิม
belaetv	เป​แล้ด
ulaam	อุ​ลาม
telaa	เท​ลา
taahan	ทา​ฮัน
laandaan	ลา​ดาน
laandaan	ลา​ดาน
mankien	มัน​คี​เอน
yaafeletv	ยา​เฟ​เล้ด
some	โซ​เม
hotaam	โฮ​ทาม
sofaa	โส​ฟา
mbese	เบ​เซ
aalaa	อา​ลา
atcndaa	อัด​ดา
mesaa	เม​ซา
enbaaan	เอน​ปา​อัน
aahiyo	อา​หิ​โย
saasakv	ซา​ซัก
sembaandiyaa	เส​บา​ดิ​ยา
ende	เอ​เด
yohaa	โย​ฮา
yaakim	ยา​คิม
sinxletai	สิน​เล​ไท
haanan	ฮา​นัน
yeien	เย​อี​เอน
saulo	เซา​โล
biton	ปิ​โทน
melekv	เม​เล้ก
taalie	ทา​เลีย
simxli	สิม​ลี
mbineaa	บิ​เน​อา
mbineaa	บิ​เน​อา
eleaasaax	เอ​เล​อา​สา
aasen	อา​เซน
mbokelu	โบ​เค​ลู
seaaliyaa	เซ​อา​ลิ​ยา
isaalaaen	อิ​สะ​ลา​เอน
yeuen	เย​อู​เอน
sanxlu	สัน​ลู
hatcsenuaa	หัด​เส​นู​อา
elaa	เอ​ลา
mesunlaam	เม​ซุน​ลาม
sefaatiyaa	เซ​ฟา​ทิ​ยา
leuen	เล​อู​เอน
aandaayaa	อา​ดา​ยา
baatche	ปาด​เฮ
baatche	ปาด​เฮ
mankiyaa	มัน​คิ​ยา
imme	อิม​เม
gaalaan	กา​ลาน
matvtaaniyaa	มัด​ทา​นิ​ยา
sikcli	สิก​ลี
yendutun	เย​ดู​ทูน
yendutun	เย​ดู​ทูน
mikvlotv	มิก​โล้ด
yembutc	เย​บุด
belon	เป​โลน
sipcmbekai	สิบ​เบ​ไค
saaanmbon	ซา​อัน​โบน
eliyaambaa	เอ​ลี​ยา​บา
gimso	กิม​โซ
haasem	ฮา​เซม
uaa	อู​อา
itclai	อิด​ไล
yaaaasien	ยา​อา​ซี​เอน
semaaliyaa	เซ​มา​ลิ​ยา
itcsiyaa	อิด​ซี​ยา
aasaalen	อา​ซา​เลน
yaasombeam	ยา​โซ​เบ​อัม
kaav	ค้า
kuatv	ควัด
nzuonx	หฑวน
aambiqai	อา​บี​ไช
silie	ซี​เลีย
saadaan	ซา​ตาน
namx	หนัม
selomotv	เซ​โล​โม้ด
gesom	เก​โซม
haalim	ฮา​ลิม
miyaamin	มิ​ยา​มิน
hakvkotc	ฮัก​โขด
yesuaa	เย​ซู​อา
mbingaa	บิน​กา
hesi	เฮ​ซี
betaahiyaa	เป​ทา​หิ​ยา
maaaasiyaa	มา​อา​ซิ​ยา
yaaaasiyaa	ยา​อา​ซี​ยา
gendaaliyaa	เก​ดา​ลิ​ยา
matvtitiyaa	มัด​ที​ทิ​ยา
sembuen	เซ​บู​เอน
haanaani	ฮา​นา​นี
yehohaanan	เย​โฮ​ฮา​นัน
hosaax	โฮ​สา
guanh	กวั้น
hnyangx	หฮญัง
henndai	เฮน​ได
elihu	เอ​ลี​ฮู
itcmaiaa	อิด​ไม​อา
aanki	อาน​คี
saalomorn	ซา​โล​มอน
lungz	ลู์ง
tailaqv	ไท​ละ
yapvfaa	ยับ​ฟา
kelumbim	เค​ลู​บิม
yietc	เหยียด
bung	ปูง
longz	ล์ง
bunh	ปุ้น
isaalaaen	อิ​สะ​ลา​เอน
saalomorn	ซา​โล​มอน
sekem	เซ​เคม
yelomboam	เย​โล​โบ​อัม
maahaalatv	มา​หะ​ลัด
yelusaalem	เย​ลู​ซา​เลม
yundaa	ยู​ดา
ondetc	โอ​เดด
buangv	ปวั๊ง
die	เตีย
mbaaaaqaa	บา​อา​ชา
yehosaafatv	เย​โฮ​ซา​ฟัด
netaaniyaa	เน​ทา​นิ​ยา
tombiyaa	โท​บี​ยา
yehosaambaatc	เย​โฮ​ซา​บาด
aahapc	อา​หับ
baeqc	แปะ
’	’
yaahaasien	ยา​ฮา​ซี​เอน
sekaaliyaa	เส​คา​ลิ​ยา
mbenaiyaa	เบ​ไน​ยา
dungx	ตู๋ง
aahatcyaa	อา​หัด​ยา
yeholam	เย​โฮ​ลัม
yehien	เย​ฮี​เอน
etiobie	เอ​ที​โอ​เปีย
yolam	โย​ลัม
yehu	เย​ฮู
gouv	โก๊ว
yehoyaandaa	เย​โฮ​ยา​ดา
hungh	ฮู่ง
simeatc	ซิ​เม​อัด
yehoaatc	เย​โฮ​อาด
yekoliyaa	เย​โค​ลี​ยา
zingh	ฒี่ง
filisaadie	ฟี​ลิ​สะ​เตีย
aamortv	อา​ม้อด
ofen	โอ​เฟน
yotaam	โย​ทาม
maaaaseaa	มา​อา​เส​อา
mesinlemotv	เม​ซิน​เล​โม้ด
baaux	ป๋าว
diex	เตี๋ย
camv	ธั้ม
hmz	ฮม์
maanatvse	มะ​นัด​เส
aamon	อา​โมน
zorc	หฒ่อ
dorngx	ต๋อง
yosaambaatc	โย​ซา​บาด
yungh	ยู่ง
yoaahaatc	โย​อา​หาด
yelemi	เย​เล​มี
besie	เป​เซีย
sailatv	ไซ​ลัด
lotc	โหลด
haanditc	ฮา​ดิด
ono	โอ​โน
senaaaa	เส​นา​อา
aantaasesitv	อาน​ทา​เซ​ซี้ด
mitvlendaatc	มิด​เล​ดาด
ndaaliatc	ดา​ลิ​อัด
hakvgai	ฮัก​ไก
yiutai	ยิว​ไท
aahitupv	อา​หิ​ทู้บ
aambiquwaa	อา​บี​ชู​วา
eleaasaa	เอ​เล​อา​ซา
esaalaa	เอ​สะ​ลา
aahaawaa	อา​หะ​วา
heng	เฮง
esaalaa	เอ​สะ​ลา
sapvmbetai	ซับ​เบ​ไท
kelitaa	เค​ลิ​ทา
melemotv	เม​เล​โม้ด
matvtenai	มัด​เท​ไน
selemiyaa	เซ​เล​มิ​ยา
haakaaliyaa	ฮา​คา​ลิ​ยา
nehaami	เน​หะ​มี
susaax	สุ​สา
hnamv	ฮนั้ม
sanxmbaanlatv	สัน​บาน​ลัด
tombiaa	โท​บี​อา
gesem	เก​เซม
imli	อิม​ลี
mesesaamben	เม​เซ​ซา​เบน
yoyaandaa	โย​ยา​ดา
haasapvneyaa	ฮา​ซับ​เน​ยา
hatcsupv	หัด​ซู้บ
hanlohetc	ฮัน​โล​เหด
lehum	เล​ฮูม
sapcmbai	สับ​ไบ
mbaalukv	บา​ลุก
hatcsupv	หัด​ซู้บ
henaandatc	เฮ​นา​ดัด
mbinnui	บิน​นุย
baalaan	ปา​ลาน
baalotv	ปา​โล้ด
laanh	ล่าน
tombiaa	โท​บี​อา
youc	โหย่ว
mondekai	โม​เด​ไค
mbinsaan	บิน​ซาน
mbikcwai	บิก​ไว
joih	จ้อย
katcmien	ขัด​มี​เอน
qembaaniyaa	เช​บา​นี​ยา
mbunni	บุน​นี
selebiyaa	เซ​เล​ปี​ยา
hondiyaa	โฮ​ดี​ยา
gen	เกน
koiv	ค้อย
ndaanien	ดา​นี​เอน
ginneton	กิน​เน​โทน
batclotv	ปัด​โล้ด
satctu	สัด​ทู
atcgaatc	อัด​กาด
mbembai	เบ​ไบ
aandin	อา​ดีน
aate	อา​เท
haasum	ฮา​ซูม
mbesai	เบ​ไซ
haalipv	ฮา​ลิบ
yaatvnduwaa	ย้าด​ดู​วา
aanaayaa	อา​นา​ยา
sanxlai	สัน​ไล
yoyaalipv	โย​ยา​ลิบ
atclikam	อัด​ลี​คัม
sihaqc	สี​หะ
seantien	เซ​อัน​ทิ​เอน
yoyaakim	โย​ยา​คิม
yonaataan	โย​นา​ทาน
minyaamin	มิน​ยา​มิน
aamokv	อา​โม้ก
tanmon	ทัน​โมน
hosaayaa	โฮ​ซา​ยา
matvtaaniyaa	มัด​ทา​นิ​ยา
mikaayaa	มี​คา​ยา
eliyaakim	เอ​ลี​ยา​คิม
aahaasuelatv	อา​หะ​สุ​เอ​ลัด
inndie	อิน​เดีย
yinh	ยิ่น
watvqaati	วัด​ชา​ที
haac	ห่า
yekoniyaa	เย​โค​นี​ยา
mondekai	โม​เด​ไค
esete	เอ​เซ​เท
esete	เอ​เซ​เท
esete	เอ​เซ​เท
ndiux	ดิ๋ว
haamaan	ฮา​มาน
haamaan	ฮา​มาน
lamz	ลั์ม
haataakv	ฮา​ท้าก
haataakv	ฮา​ท้าก
kenndie	เคน​เดีย
mapv	มับ
zioux	เหฒียว
lewiaataan	เล​วี​อา​ทาน
henh	เฮ่น
sienh	เซี่ยน
huaax	หฮวา
nqapc	หฆับ
hlienx	เหฮลียน
mitc	หมิด
yie’	เยีย’
nzuiz	ฑุ์ย
hlaax	หฮลา
muonz	ม์วน
goh	โก้
quwaa	ชู​วา
mbinndatc	บิน​ดัด
luangh	ลวั่ง
louc	โหล่ว
zimh	ฒิ่ม
naaaame	นา​อา​เม
toux	โถว
sung	ซูง
sux	สู
haangh	ฮ่าง
bioh	โปย้
sienc	เสี่ยน
wuotv	ว้วด
guaeqv	แกว๊ะ
nzunc	หฑุ่น
cien	เธียน
hoic	ห่อย
fapv	ฟับ
naanh	น่าน
maqc	หมะ
mbieqv	เบี๊ยะ
wangc	หวั่ง
guenx	เกว๋น
hlorv	ฮล้อ
nyaah	ญ่า
mbeu	เบว
mbeu	เบว
nqorqv	เฆาะ
yie	เยีย
gox	โก๋
elihu	เอ​ลี​ฮู
zueih	เฒว่ย
waac’	หว่า’
soqv	โซะ
yiemh	เยี่ยม
aaux	อ๋าว
ndanc	ดั่น
hmatv	ฮมัด
hlopv	ฮลบ
baamz	ป์าม
yienz	เยี์ยน
doc	โต่
horpc’	หอบ’
guinh	กวิ้น
guinh	กวิ้น
gingx	กี๋ง
muangh	มวั่ง
lamz	ลั์ม
komv	ค้ม
ndauc	เด่า
caaiv	ธ้าย
nyaaiv	ญ้าย
mbehemotv	เบ​เฮ​โม้ด
diux	ติ๋ว
cutv	ธุด
selaa	เซ​ลา
selaa	เซ​ลา
dorziec	ตอเหฒี่ย
cienh	เธี่ยน
doh	โต้
waac	หว่า
louh	โล่ว
zaaux	หฒาว
taanx	ถาน
zuoqv	ฒัวะ
liuz	ลิ์ว
huangx	หฮวัง
goux	โก๋ว
ziangh	เฒี่ยง
zuizmienh	ฒุ์ยเมี่ยน
corngh	ธ่อง
wuotv	ว้วด
lembaanorn	เล​บา​นอน
finx	ฝิน
orqv	เอ๊าะ
dangxdonx	ตั๋งต๋น
haav	ฮ้า
haav	ฮ้า
mienz	เมี์ยน
batv	ปั๊ด
dunx	ตุ๋น
jiex	เจี๋ย
laic	ไหล่
nyiemz	เญี์ยม
niouv	เนี้ยว
nzioux	เหฑียว
sinx	สิน
nyiex	เหญีย
hlopv	ฮลบ
nyuotv	ญ้วด
mbiaauz	บย์าว
maaz	ม์า
mbeux	เบ๋ว
gembaan	เก​บาน
buonx	ป๋วน
tih	ที่
aamen	อา​เมน
mbeix	เบ๋ย
wuomlaangc	ววมหล่าง
biopc	ปยบ
zienh	เฒี่ยน
nqaatv	ฆ้าด
laih	ไล่
menkisendekc	เมน​คี​เซ​เดก
jorndaen	จอ​แดน
gaatv	ก๊าด
yaakopv	ยา​โค้บ
efaataa	เอ​ฟา​ทา
singqiex	ซีงเฉีย
mbong	บง
mun	มุน
yaapv	ย้าบ
heiv	เฮ้ย
gorngvnjaaux	ก๊องหฌาว
youh	โย่ว
qopv	ชบ
nuqv	นุ
nyaangc	หญ่าง
lorz	ล์อ
ndiepv	เดี๊ยบ
njoux	เหฌียว
lom	ลม
div	ตี๊
fitv	ฟิด
taaih	ท่าย
nyaanh	ญ่าน
hngongx	หฮงง
koi	คอย
korqv	เคาะ
itien	อิ​ที​เอน
itien	อิ​ที​เอน
muangx	หมวัง
nyei	เญย
saaux	สาว
laengz	แล์ง
saalon	ซา​โลน
janxmuangz	จั๋น
horqc	เหาะ
horqc	เหาะ
jiuc	จิ่ว
jiuc	จิ่ว
mbaiv	ไบ๊
anman	อัน​มัน
nyueiz	เญว์ย
sicdorngh	สี่ต้อง
bingxciouv	ปี๋งเธี้ยว
biauvhuaang	เปย๊าฮวาง
wuomdomh	ววมต้ม
zuonx	หฒวน
ndaamatvgatc	ดา​มัด​กัด
fiuv	ฟิ้ว
efaaim	เอ​ฟา​อิม
baengcngaaiz	แป่งง์าย
ndiangxndonx	เดี๋ยงด๋น
mbaambilon	บา​บี​โลน
moapc	โม​อับ
aan	อาน
dorv	ต๊อ
naiaa	ไน​อา
mbatc	บัด
iyipv	อี​ยิบ
atcsilie	อัด​ซี​เลีย
maaic	หม่าย
doix	ต๋อย
sepvnaa	เซ้บ​นา
laihnaangx	ไลหฮนาง
aalien	อา​ลี​เอน
aalien	อา​ลี​เอน
zipv	ฒิบ
mborngx	บ๋อง
sou	โซว
nziaauxjieqv	หฑยาวเจี๊ยะ
sion	สิ​โอน
kuh	คู่
guoqv	กั๊วะ
isaayaa	อิ​สะ​ยา
saibatc	ไซ​ปัด
huox	หัว
nyim	ญิม
faangensen	ฟาน​เกน​เซน
biouvjoih	เปี๊ยวจ้อย
pitv	พิด
aqv’	อ๊ะ’
lozgaeng	โล์แกง
hienx	เหฮยียน
liemh	เลี่ยม
zunx	หฒุน
nin	นิน
nie	เนีย
mbaaan	บา​อัน
buozzaux	ปั์วเหฒา
mankiaa	มัน​คี​อา
yosiyaa	โย​สิ​ยา
sindaa	สี​ดา
guaatv	กว๊าด
atckelon	อัด​เค​โลน
zuangx	หฒวัง
uliaa	อุ​ลี​อา
gemaaliyaa	เก​มา​ลิ​ยา
kolaayaa	โค​ลา​ยา
nehelaam	เน​เฮ​ลาม
sefanyaa	เส​ฟัน​ยา
bungxzuoqc	ปู๋งหฒัวะ
njaaux	หฌาว
sendekiyaa	เส​เด​คี​ยา
kenndie	เคน​เดีย
qongx	ฉง
neliyaa	เน​ลิ​ยา
mbaalukv	บา​ลุก
gorqvmienh	เก๊าะเมี่ยน
koniyaa	โค​นิ​ยา
yehukan	เย​ฮู​คัน
mbenyaamin	เบน​ยา​มิน
matvtaan	มัด​ทาน
buov	ปั๊ว
kaaleaa	คา​เล​อา
tanhumetv	ทัน​หุ​เม้ด
kaaleaa	คา​เล​อา
gendaaliyaa	เก​ดา​ลิ​ยา
binc	ปิ่น
taabaanhetc	ทา​ปาน​เหด
memfitv	เมม​ฟิด
hliouv	เฮลี้ยว
kiliyaataaim	คี​ลิ​ยา​ทา​อิม
ndimbon	ดี​โบน
njangx	หฌัง
endom	เอ​โดม
endom	เอ​โดม
ndui	ดุย
ndin	ดิน
forngcang	ฟองธัง
ndongc	ด่ง
fungx	ฝูง
mbaambilon	บา​บี​โลน
zemh	เฒ่ม
mbiouh	เบี้ยว
hlengx	เหฮลง
nembukatvnetvsaa	เน​บู​คัด​เน้ด​ซา
zunc	หฒุ่น
ziex	เหฒีย
meuz	เม์ว
njapc	หฌับ
buonvguoqv	ป๊วนกั๊วะ
ziqv	ฒิ
hopv	ฮบ
saenghmz	แซงฮม์
yiem	เยียม
kembaa	เค​บา
yaaaasanyaa	ยา​อา​ซัน​ยา
caeng	แธง
luijuoqv	ลุยจั๊วะ
diev	เตี๊ย
hungh	ฮู่ง
kuv	คู้
paiv	ไพ้
tapv	ทับ
oholaa	โอ​โฮ​ลา
oholimbaa	โอ​โฮ​ลี​บา
baaic	ป่าย
etiobie	เอ​ที​โอ​เปีย
on	โอน
saengcietv	แซงเธี้ยด
njoqc	โหฌะ
mbengx	เบ๋ง
mievciangv	เมี้ยเธี้ยง
yangh	ยั่ง
gokc	โกก
gokc	โกก
zaangh	ฒ่าง
singx	สีง
home	โฮ​เม
horc	ห่อ
ndaanien	ดา​นี​เอน
lai	ไล
mbeix	เบ๋ย
mbentesatvsaa	เบน​เท​ซัด​ซา
satvlakv	ซัด​ลัก
mesaakv	เม​ซ้าก
aambetcnego	อา​เบด​เน​โก
aambetcnego	อา​เบด​เน​โก
hnyouv	เฮญี้ยว
mbensatvsaa	เบน​ซัด​ซา
daix	ไต๋
mene	เม​เน
teken	เท​เคน
baasin	ปา​ซิน
dauh	เต้า
gaambelien	กา​เบ​เลียน
tiux	ถิว
hoseyaa	โฮ​เซ​ยา
limh	ลิ่ม
aamotv	อา​โม้ด
aamotv	อา​โม้ด
keliotc	เค​ลิ​โอด
civ	ธี้
liv	ลี้
gingaan	กิน​กาน
muangv	มวั้ง
finisie	ฟี​นี​เซีย
saaxlefatv	สา​เล​ฟัด
yonaa	โย​นา
yonaa	โย​นา
ninaawe	นิ​นะ​เว
ngorngz	ง์อง
nqanx	หฆัน
ndunh	ดุ้น
bieivzeiv	เปย๊ยเฒ้ย
naahum	นา​ฮูม
limbie	ลิ​เบีย
nyorx	หญอ
haambaagukc	ฮา​บา​กุก
puotv	พ้วด
kusi	คู​ซี
ziangv	เฒี้ยง
minkom	มิน​โคม
jaaihorngc	จายห่อง
njanglaangc	ฌังหล่าง
yosuwaa	โย​ซู​วา
nqaaix	หฆาย
fingx	ฝีง
seix	เสย
caidoix	ไธต๋อย
duqv	ตุ๊
beletv	เป​เล้ด
hetvlon	เฮ้ด​โลน
laam	ลาม
mboaatc	โบ​อาด
jetcsi	เจียด​ซี
eliyaakim	เอ​ลี​ยา​คิม
yosepv	โย​เซ้บ
maaliyaa	มา​ลี​ยา
maaliyaa	มา​ลี​ยา
yesu	เย​ซู
yesu	เย​ซู
giduc	กี​ตู่
yesu	เย​ซู
imaanuen	อี​มา​นู​เอน
eix	เอ๋ย
helotv	เฮ​โล้ด
yundie	ยู​เดีย
naasaaletv	นา​ซา​เล้ด
naasaaletv	นา​ซา​เล้ด
yohan	โย​ฮัน
yohan	โย​ฮัน
yohan	โย​ฮัน
nzopc	หฑบ
dornhnamv	ตอน
sembendi	เส​เบ​ดี
yaagorpc	ยา​กอบ
totvmbuli	โท้ด​บุ​ลี
nqopv	ฆบ
baaih	ป้าย
nyuoqc	หญัวะ
gilo	กี​โล
bou	โปว
hlaau	ฮลาว
ngaengv	แง้ง
ngaengv	แง้ง
dungz	ตู์ง
dungz	ตู์ง
dungz	ตู์ง
kamx	ขัม
filipv	ฟี​ลิบ
mbaatolomiu	บา​โท​โล​มิว
tomatv	โท​มัด
matvtaai	มัด​ทาย
anfeatc	อัน​เฟ​อัด
tatvndeatc	ทัด​เด​อัด
simon	ซี​โมน
yundaatc	ยู​ดาด
isaakaaliotc	อิ​สะ​คา​ลิ​โอด
nyeic	เหญ่ย
ciouh	เธี่ยว
dunc	ตุ่น
doqc	โตะ
heng	เฮง
faalisi	ฟา​ลิ​สี
faalisi	ฟา​ลิ​สี
mienv	เมี้ยน
mbeensembun	เบ​เอน​เซ​บูน
saadaan	ซา​ตาน
laengc	แหล่ง
helondietc	เฮ​โล​เดียด
yesu	เย​ซู
mbiauzdorn	เบย์าตอน
saandusi	สะ​ดู​สี
saandusi	สะ​ดู​สี
bide	ปี​เต
bide	ปี​เต
saigorx	ไซ
juov	จั๊ว
saa	ซา
mbetaani	เบ​ทา​นี
sisaa	ซี​ซา
dauh’	เต้า’
giduc	กี​ตู่
haaz	ฮ์า
kaayaafaatv	คา​ยา​ฟ้าด
aex	แอ๋
bide	ปี​เต
lomaa	โล​มา
bilaatv	ปี​ล้าด
yundaatc	ยู​ดาด
bilaatv	ปี​ล้าด
bilaatv	ปี​ล้าด
mbaalapvmbatc	บา​ลับ​บัด
mbaalapvmbatc	บา​ลับ​บัด
guatc	กวัด
sailin	ไซ​ลีน
simon	ซี​โมน
eli	เอ​ลี
laamaasaambakctaani	ลา​มา​ซา​บัก​ทา​นี
makvndaalaa	มัก​ดา​ลา
anndaalu	อัน​ดา​ลู
kaabenaaum	คา​เป​นา​อุม
yesu	เย​ซู
guaiv	ไกว๊
nqomz	ฆ์ม
laangz	ล์าง
helotv	เฮ​โล้ด
mbomz	บ์ม
mbetcsaindaa	เบด​ไซ​ดา
mose	โม​เซ
hosaanaa	โฮ​ซา​นา
lomaa	โล​มา
aalekvsaannde	อา​เล้ก​ซาน​เด
lufatv	ลู​ฟัด
elisaambetc	เอ​ลี​ซา​เบด
matvtatv	มัด​ทัด
matvtatv	มัด​ทัด
menki	เมน​คี
menki	เมน​คี
matvtaatiatc	มัด​ทา​ที​อัด
matvtaatiatc	มัด​ทา​ที​อัด
eaa	เอ​อา
simeon	สิ​เม​โอน
apclaaham	อับ​ลา​ฮัม
naaho	นา​โฮ
selukv	เส​ลุก
leu	เล​อู
belekv	เป​เล้ก
embe	เอ​เบ
aanfaasatv	อาน​ฟา​ซัด
laamekv	ลา​เม้ก
yaaletv	ยา​เล้ด
enotv	เอ​โน้ด
aandam	อา​ดัม
gelaasaa	เก​ลา​ซา
yailatv	ไย​ลัด
ciou	เธียว
saamaalie	สะ​มา​เลีย
biauvziouv	เปย๊าเฒี้ยว
maataa	มา​ทา
ndaangh	ด้าง
gaalili	กา​ลิ​ลี
siloam	สี​โล​อัม
bungx	ปู๋ง
waanc	หว่าน
houc	โห่ว
cuqv	ธุ
zaeqvdaan	แฒะตาน
laasaalatv	ลา​ซา​ลัด
sakckietv	สัก​เคี้ยด
’	’
siqc	สิ
nyomx	หญม
helotv	เฮ​โล้ด
kih	คี่
kaatv	ค้าด
ndanh	ดั้น
filipv	ฟี​ลิบ
naataanaaen	นา​ทา​นา​เอน
nikondematv	นี​โค​เด​มัด
lingh	ลี่ง
yiutai	ยิว​ไท
kaanaa	คา​นา
ngih	งี่
sungx	สูง
sapv	ซับ
mbor	บอ
laasaalatv	ลา​ซา​ลัด
laasaalatv	ลา​ซา​ลัด
maataa	มา​ทา
paaiv	พ้าย
yundaatc	ยู​ดาด
sienx	เสียน
laanh	ล่าน
hiuv	ฮิ้ว
annaatv	อัน​น้าด
aanaanie	อา​นา​เนีย
aanaanie	อา​นา​เนีย
tim	ทิม
saatefen	สะ​เท​เฟน
antiokc	อัน​ที​โอก
nikolau	นี​โค​เลา
dapc	ตับ
saulo	เซา​โล
aineatc	ไอ​เน​อัด
litvndaa	ลิด​ดา
samh	ซั่ม
koneliatc	โค​เน​ลิ​อัด
koneliatc	โค​เน​ลิ​อัด
sisaaliyaa	ซี​ซา​ลี​ยา
mbaanaambatc	บา​นา​บัด
mbaanaambatc	บา​นา​บัด
taasatv	ทา​ซัด
ziuh	ฒิ่ว
maako	มา​โค
baulo	เปา​โล
baulo	เปา​โล
ikoniyum	อี​โค​นี​ยูม
hemetv	เฮ​เม้ด
begaa	เป​กา
silaa	ซี​ลา
maasindonie	มา​ซี​โด​เนีย
baulo	เปา​โล
silaa	ซี​ลา
tesaalonigaa	เท​สะ​โล​นิ​กา
yaasonx	ยา​โสน
aaten	อา​เทน
timotai	ทิ​โม​ไท
fiou	เฟียว
kolinto	โค​ลิน​โท
kaalitvbatc	คะ​ลิด​ปัด
ganlio	กัน​ลิ​โอ
aakaayaa	อา​คา​ยา
efeso	เอ​เฟ​โซ
bitcsinxlaa	ปิด​สิน​ลา
aakuinlaa	อา​ควิน​ลา
aaborlo	อา​ปอ​โล
aantemitv	อาน​เท​มิด
esie	เอ​เซีย
ndemetvliatc	เด​เม้ด​ลิ​อัด
mbeloaa	เบ​โล​อา
aalitvtaakatv	อา​ลิด​ทา​คัด
gaaiatc	กาย​อัด
tikigatc	ที​คิ​กัด
dofimatv	โต​ฟี​มัด
doatc	โต​อัด
silisie	ซี​ลี​เซีย
felikv	เฟ​ลิก
felikv	เฟ​ลิก
kaalaaundiatc	คา​ลาว​ดิ​อัด
lisietv	ลี​เซี้ยด
fesaatatv	เฟ​สะ​ทัด
fesaatatv	เฟ​สะ​ทัด
aanqipaa	อา​ฆี​พา
aanqipaa	อา​ฆี​พา
congh	ธ่ง
apclaaham	อับ​ลา​ฮัม
giduc	กี​ตู่
aa	อา
saaben	สะ​เปน
lusiatc	ลู​สิ​อัด
saatefaanatv	สะ​เท​ฟา​นัด
aaborlo	อา​ปอ​โล
zaanc	หฒ่าน
nouh	โน่ว
hnomv	ฮน้ม
maasindonie	มา​ซี​โด​เนีย
giduc	กี​ตู่
tidatc	ทิ​ตัด
tidatc	ทิ​ตัด
zoqc	โหฒะ
tengx	เถง
ceng	เธง
fuqv	ฟุ
hnamv	ฮนั้ม
ebaafaa	เอ​ปา​ฟา
laundisie	เลา​ดี​เซีย
sin	ซิน
zoux	โหฒว
naanh	น่าน
mbuo	บัว
himeneatc	ฮี​เม​เน​อัด
lorx	หลอ
fiem	เฟียม
nzaeng	แฑง
ndemaatv	เด​ม้าด
gaalaatie	กา​ลา​เทีย
lugaa	ลู​กา
onesifolatv	โอ​เน​สิ​โฟ​ลัด
elatvtatv	เอ​ลัด​ทัด
miletatv	มิ​เล​ทัด
suonc	ส่วน
filemon	ฟี​เล​โมน
onesimatv	โอ​เน​สิ​มัด
saalem	ซา​เลม
nziaamv	ฑย้าม
mose	โม​เซ
nyei	เญย
ganh	กั้น
laamh	ล่าม
mbaalaaam	บา​ลา​อัม
kaain	คา​อิน
kolaa	โค​ลา
mauv	เม้า
gouv	โก๊ว
mbopv	บ๊บ
caax	หธา
ndiangxnormh	เดี๋ยงน่อม
haawaa	ฮา​วา
maiv	ไม
liangxndeic	เหลียงเด่ย
ilaatv	อิ​ล้าด
mehuxyaaen	เม​หู​ยา​เอน
metusaaen	เม​ทู​ซา​เอน
yaambaan	ยา​บาน
yaambaan	ยา​บาน
ongtaaixngaeqv	องถายแงะ
yumbaan	ยู​บาน
yumbaan	ยู​บาน
ongtaaixngaeqv	องถายแงะ
zuangv	ฒวั้ง
faambaeqv	ฟามแป๊ะ
faambaeqv	ฟามแป๊ะ
gongbou	กงโปว
dozmienh	โต์เมี่ยน
hnamvnzuonx	ฮนั้มหฑวน
auvjueiv	เอ๊าเจว๊ย
dornmbuangz	ตอนบวั์ง
mbiouh	เบี้ยว
wuomminc	ววมหมิ่น
haapv	ฮ้าบ
aalaalatv	อา​ลา​ลัด
haapv	ฮ้าบ
nqo	โฆ
nzangvliuh	ฑั้งลิ่ว
dornmbuangz	ตอนบวั์ง
mbuonx	บ๋วน
kaanaaan	คา​นา​อัน
elekv	เอ​เล้ก
akckatv	อัก​คัด
sinaa	ซี​นา
lehoxmbotci	เล​โห​โบด​อี
batclusimx	ปัด​ลุ​สิม
katvluhim	คัด​ลู​ฮิม
kapvtolim	คับ​โท​ลิม
hetv	เฮ้ด
camvfingx	ธั้มฝีง
gegaasi	เก​กา​ซี
laasaa	ลา​ซา
sefaa	เส​ฟา
fanh	ฟั่น
telaa	เท​ลา
haalaan	ฮา​ลาน
apclaam	อับ​ลาม
haalaan	ฮา​ลาน
apclaam	อับ​ลาม
apclaam	อับ​ลาม
wuomsuiv	ววมซุ้ย
baeqvfun	แป๊ะฟุน
sondom	โส​โดม
saauv	ซ้าว
amlaafen	อัม​ลา​เฟน
enlaasaax	เอน​ลา​สา
aaliokc	อา​ลี​โอก
tindaan	ทิ​ดาน
dorngx	ต๋อง
enbaalaan	เอน​ปา​ลาน
tindaan	ทิ​ดาน
amlaafen	อัม​ลา​เฟน
enlaasaax	เอน​ลา​สา
aaleokc	อา​เล​โอก
katcmonai	ขัด​โม​ไน
haagaa	ฮา​กา
saalaai	ซา​ลาย
haagaa	ฮา​กา
haagaa	ฮา​กา
isaamaaen	อิ​สะ​มา​เอน
camvfingx	ธั้มฝีง
saalaa	ซา​ลา
ndiangxgorn	เดี๋ยงกอน
ni	นี
fiuvmungv	ฟิ้วมู้ง
gomolaa	โก​โม​ลา
douzsiouxdon	โต์วเสียวตน
cutvcutv	ธุดๆ
sieqvhlo	เซียะโฮล
mbenammi	เบน​อัม​มี
mbenammi	เบน​อัม​มี
aambimelekv	อา​บี​เม​เล้ก
mbenc	เบ่น
dornmaac	ตอนหม่า
fiko	ฟี​โค
fiko	ฟี​โค
saaziou	ซาเฒียว
mbeeqembaa	เบ​เอ​เช​บา
mbetuen	เบ​ทู​เอน
auvdorn	เอ๊าตอน
leumaa	เล​อู​มา
tembaa	เท​บา
gaaham	กา​ฮัม
taahaatc	ทา​หาด
hitvtai	ฮิด​ไท
efolon	เอ​โฟ​โลน
hnievdaauh	เฮนี้ยต้าว
makvbelaa	มัก​เป​ลา
lozdeicbung	โล์เต่ยปูง
cinmaanc	ธินหม่าน
laambaan	ลา​บาน
sieqvfun	เซียะฟุน
lembekaa	เล​เบ​คา
lembekaa	เล​เบ​คา
ketulaa	เค​ทู​ลา
simxlaan	สิม​ลาน
mendaan	เม​ดาน
itcmbaakc	อิด​บาก
ndendaan	เด​ดาน
aambindaa	อา​บี​ดา
enndaaaa	เอน​ดา​อา
nembaayotv	เน​บา​โย้ด
kendaa	เค​ดา
atcmbeen	อัด​เบ​เอน
suqvsuqv	ซุๆ
ndopvlui	ด๊บลุย
esaau	เอ​ซาว
sunggouv	ซูงโก๊ว
sunggouv	ซูงโก๊ว
korvfiqv	ค้อฟิ
sunggouv	ซูงโก๊ว
isakc	อี​สัก
esekc	เอ​เสก
sitcnaa	สิด​นา
aahutcsatv	อา​หุด​ซัด
isakc	อี​สัก
qimbaa	ชี​บา
yaakopv	ยา​โค้บ
yaakopv	ยา​โค้บ
camvnorm	ธั้มนอม
jangjang	จังๆ
esaau	เอ​ซาว
mbiungcsuiv	บยู่งซุ้ย
yaakopv	ยา​โค้บ
auvfaam	เอ๊าฟาม
laasen	ลา​เซน
laasen	ลา​เซน
laasen	ลา​เซน
cingjaahnaangx	ธีงจาหฮนาง
leaa	เล​อา
laasen	ลา​เซน
leaa	เล​อา
mbinhaa	บิน​ฮา
jieh	เจี้ย
jieh	เจี้ย
diemv	เตี๊ยม
diemv	เตี๊ยม
oeix	โอ๋ย
diemv	เตี๊ยม
buonvdeicbung	ป๊วนเต่ยปูง
zienz	เฒี์ยน
borngz	ป์อง
borngz	ป์อง
hmien	เฮมียน
benien	เป​นี​เอน
ndinaa	ดี​นา
nguaazgorn	งว์ากอน
haamo	ฮา​โม
efaalaataa	เอ​ฟา​ลา​ทา
lumben	ลู​เบน
sei	เส​อี
timnaa	ทิม​นา
oholimbaamaa	โอ​โฮ​ลี​บา​มา
aiyaa	ไอ​ยา
aanaa	อา​นา
wuomjorm	ววมจอม
yombapc	โย​บับ
husaam	หุ​ซาม
samxlaa	สัม​ลา
luimueiz	ลุยเมว์ย
yosepv	โย​เซ้บ
ndotaan	โด​ทาน
luimueizndaauv	ลุยเมว์ยด๊าว
ndiangxzung	เดี๋ยงฒูง
ndiendaang	เดียดาง
muyorc	มู​หย่อ
yosepv	โย​เซ้บ
luimueizndaauv	ลุยเมว์ยด๊าว
botifaa	โป​ทิ​ฟา
hilaa	ฮี​ลา
taamaa	ทา​มา
biauvziouv	เปย๊าเฒี้ยว
faalo	ฟา​โล
haiz	ไฮ์
faalo	ฟา​โล
hnyangxzingh	หฮญังฒี่ง
botifelaa	โป​ทิ​เฟ​ลา
aasenatv	อา​เส​นัด
ngorngh	ง่อง
muozdorn	มั์วตอน
ndaamvjauv	ด๊ามเจ๊า
muozdorn	มั์วตอน
ndaamdaauh	ดามต้าว
mbaih	ไบ้
winx	หวิน
mouh	โม่ว
dornfun	ตอนฟุน
saaun	ซา​อุน
sifiyon	สิ​ฟิ​โยน
luoqc	หลัวะ
gosen	โก​เซน
youh	โย่ว
wuomseix	ววมเสย
ndiesai	เดียไซ
ndiewuom	เดียววม
sei	เซย
ndiesai	เดียไซ
zouvmouh	โฒ้วโม่ว
ndiewuom	เดียววม
sipcbolaa	สิบ​โป​ลา
sipcbolaa	สิบ​โป​ลา
kouvzingh	โค้วฒี่ง
ndiangxdornfomv	เดี๋ยงตอนฟ้ม
ndiangxdornfomv	เดี๋ยงตอนฟ้ม
gongboubieiv	กงโปวเปย๊ย
kouvlatc	โค้วหลัด
kouvlatc	โค้วหลัด
jauvdingh	เจ๊าตี้ง
guaengx	แกว๋ง
naangdueiv	นางเตว๊ย
naangdueiv	นางเตว๊ย
luigem	ลุยเกม
luigem	ลุยเกม
luigem	ลุยเกม
luigem	ลุยเกม
yeto	เย​โท
aalon	อา​โลน
aalon	อา​โลน
gongboubieiv	กงโปวเปย๊ย
gongboubieiv	กงโปวเปย๊ย
amlaam	อัม​ลาม
yokembetc	โย​เค​เบด
yokembetc	โย​เค​เบด
amlaam	อัม​ลาม
eliqembaa	เอ​ลี​เช​บา
iyipv	อี​ยิบ
guaigorqv	ไกวเก๊าะ
gaengvdaic	แก๊งไต่
nduindui	ดุยๆ
gaengmbung	แกงบูง
gaengmbung	แกงบูง
gaengmbung	แกงบูง
gaengmbung	แกงบูง
gaengmbung	แกงบูง
niembungmuonc	เนียบูงหม่วน
mbung	บูง
gunx	กุ๋น
nongc	หน่ง
borqc	เปาะ
nziaaux	หฑยาว
koivsiqv	ค้อยซิ
sianghnyangx	เซียงหฮญัง
laiim	ไลอิม
caix	ไหธ
njuovnyiemz	ฌั้วเญี์ยม
mbuonxndiouh	บ๋วนเดี้ยว
douzndiouh	โต์วเดี้ยว
jauvnqaai	เจ๊าฆาย
jauvnqaai	เจ๊าฆาย
elim	เอ​ลิม
ngopv	งบ
mbunh	บุ้น
zouv	โฒ้ว
kang	คัง
lefindim	เล​ฟี​ดิม
weic	เหว่ย
faixfiuv	ไฝฟิ้ว
faixfiuv	ไฝฟิ้ว
kuatv	ควัด
mbongnqenx	บงเหฆน
daansin	ตานซิน
daansin	ตานซิน
auvhlo	เอ๊าโฮล
auvhlo	เอ๊าโฮล
baacbaac	ป่าๆ
hanh	ฮั่น
kuotv	ค้วด
kuotvziouv	ค้วดเฒี้ยว
janxzaqc	จั๋นหฒะ
lanh	ลั่น
njimvmbiorqc	ฌิ้มเบยาะ
lanh	ลั่น
winjaa	วินจา
mueiznjeiv	เมว์ยเฌ้ย
isaalaaen	อิ​สะ​ลา​เอน
jiemkuing	เจียมควีง
faangzaux	ฟางเหฒา
jiemkuing	เจียมควีง
zaengx	แหฒง
dangjaax	ตังจ๋า
dangsin	ตังซิน
dangsin	ตังซิน
caax	หธา
dangsin	ตังซิน
nyueiz	เญว์ย
caaxcaax	หธาๆ
dangjaax	ตังจ๋า
dangsin	ตังซิน
njiuv	ฌิ้ว
dang	ตัง
kuaaivkuaaiv	คว้ายๆ
njietv	เฌี้ยด
lunh	ลุ่น
ndiembuov	เดียบั๊ว
ndiehlen	เดียเฮลน
nekv	เน้ก
kuaaivkuaaiv	คว้ายๆ
njietv	เฌี้ยด
ndiehlen	เดียเฮลน
fuoqv	ฟัวะ
jiem	เจียม
njongclaan	หฌ่งลาน
njongclaan	หฌ่งลาน
mborng	บอง
jiemlingh	เจียมลี่ง
zaix	ไหฒ
aalon	อา​โลน
buozzaux	ปั์วเหฒา
jiexlouh	เจี๋ยโล่ว
ndiangxndopv	เดี๋ยงด๊บ
dieh	เตี้ย
jiemdang	เจียมตัง
jiemdang	เจียมตัง
siangmbiauh	เซียงเบย้า
hnyangxdueiv	หฮญังเตว๊ย
gaengzuangx	แกงหฒวัง
paaivpoux	พ้ายโผว
dangzaanv	ตังฒ้าน
dongc	ต่ง
corng	ธอง
mbesaalen	เบ​ซา​เลน
gangc	กั่ง
wuomndaang	ววมดาง
hnievdaauh	เฮนี้ยต้าว
taapv	ท้าบ
taapv	ท้าบ
jiemdangjaax	เจียมตังจ๋า
jiemdieh	เจียมเตี้ย
siqv	ซิ
ziecdorngh	เหฒี่ยต้อง
nyutc	หญุด
nyutc	หญุด
zorpc	หฒอบ
zauxzuih	เหฒาฒุ่ย
hmei	เฮมย
youzdiex	โย์วเตี๋ย
baeqvmuozdoic	แป๊ะมั์วต่อย
jaangvngongh	จ๊างง่ง
jaangvmbuov	จ๊างบั๊ว
jaangvdueivndaauv	จ๊างเตว๊ยด๊าว
jaangvjieqv	จ๊างเจี๊ยะ
jaangvnorqc	จ๊างเหนาะ
jaangvyangh	จ๊างยั่ง
gaengtiux	แกงถิว
jopvdorn	จ๊บตอน
zauxbenv	เหฒาเป๊น
saengkuvdaic	แซงคู้ไต่
omx	อ๋ม
orvsiqv	อ๊อซิ
orvlunx	อ๊อหลุน
orvlunx	อ๊อหลุน
orvlunx	อ๊อหลุน
orvlunx	อ๊อหลุน
mboux	โบ๋ว
baengc	แป่ง
sieqv	เซียะ
goumaac	โกวหม่า
muocmaac	หมั่วหม่า
nziezmaac	เฑี์ยหม่า
baeqvdiex	แป๊ะเตี๋ย
nziezmaac	เฑี์ยหม่า
auvnzaengbuang	เอ๊าแฑงปวัง
lov	โล้
ndeichlen	เด่ยเฮลน
buonvsin	ป๊วนซิน
muozmaac	มั์วหม่า
nyei	เญย
nyei	เญย
buih	ปุ้ย
gorqvmienh	เก๊าะเมี่ยน
hnyangxsoux	หฮญังโสว
ndaauvdaauh	ด๊าวต้าว
baeqvmuoz	แป๊ะมั์ว
hnyangxsoux	หฮญังโสว
hnyangxsoux	หฮญังโสว
hnyangxsoux	หฮญังโสว
hnyangxsoux	หฮญังโสว
hnyangxsoux	หฮญังโสว
biouvndeic	เปี๊ยวเด่ย
lozmbiauh	โล์เบย้า
faamzinh	ฟามฒิ่น
buonvzinh	ป๊วนฒิ่น
buonvzinh	ป๊วนฒิ่น
buonvzinh	ป๊วนฒิ่น
buonvzinh	ป๊วนฒิ่น
itcsaaxkaa	อิด​สา​คา
sembulun	เส​บู​ลุน
aase	อา​เซ
napvtaali	นับ​ทา​ลี
suxlien	สู​ลิ​เอน
ndiesiqv	เดียซิ
ndiembuov	เดียบั๊ว
ndieluoqc	เดียหลัวะ
geson	เก​โซน
zauxmbiec	เหฒาเบี่ย
niebaengh	เนียแป้ง
wuomim	ววมอิม
naasi	นา​สี
guaawuom	กวาววม
guaadomx	กวาต๋ม
janxkaeqv	จั๋นแคะ
cong	ธง
maanaa	มา​นา
si	ซี
ndaam	ดาม
enndaatc	เอน​ดาด
mendaatc	เม​ดาด
waacmeiv	หว่าเม้ย
mose	โม​เซ
henv	เฮ้น
yaauc	หย่าว
hembolon	เฮ​โบ​โลน
soan	โส​อัน
aamaalekv	อา​มา​เล้ก
nqingh	ฆี่ง
nqou	โฆว
luigorqv	ลุยเก๊าะ
nqingh	ฆี่ง
nqou	โฆว
on	อน
on	อน
aambilam	อา​บี​ลัม
kuaaiv	คว้าย
finkouv	ฟินโค้ว
hoaa	โฮ​อา
hoaa	โฮ​อา
aannon	อาน​โนน
sufaa	สุ​ฟา
waahepv	วา​เฮ้บ
mbee	เบ​เอ
long	ลง
matvtaanaa	มัด​ทา​นา
naahaalien	นา​หะ​ลี​เอน
mbaamotv	บา​โม้ด
hetvmbon	เฮ้ด​โบน
sihonx	สิ​โหน
hetvmbon	เฮ้ด​โบน
douzmbietc	โต์วเบียด
mbaasaan	บา​ซาน
beto	เป​โท
mbaalaaam	บา​ลา​อัม
mbaalaaam	บา​ลา​อัม
njaapc	หฌาบ
mbaalaaam	บา​ลา​อัม
mbaalaaam	บา​ลา​อัม
zengx	เหฒง
mbaengxningv	แบ๋งนี้ง
sofim	โส​ฟิม
aalo	อา​โล
mievndaang	เมี้ยดาง
buozzaangvtaatv	ปั์วฒ้างท้าด
saaxlu	สา​ลู
beo	เป​โอ
haanokv	ฮา​โน้ก
banlu	ปัน​ลู
kaanmi	คาน​มี
nemuen	เน​มู​เอน
yaamin	ยา​มีน
yaakin	ยา​คีน
sefon	เส​โฟน
sefon	เส​โฟน
hakvgi	ฮัก​กี
suni	ซู​นี
otcni	โอด​นี
elei	เอ​เล​อี
aalotv	อา​โล้ด
aaleli	อา​เล​ลี
haamun	ฮา​มูน
tolaa	โท​ลา
puaa	พู​อา
yaasupv	ยา​ซู้บ
simlon	ซิม​โลน
seletv	เส​เล้ด
elon	เอ​โลน
yaaleen	ยา​เล​เอน
maakile	มา​คี​เล
maakile	มา​คี​เล
gileaatc	กิ​เล​อาด
iyese	อี​เย​เซ
iyese	อี​เย​เซ
helekv	เฮ​เล้ก
helekv	เฮ​เล้ก
atclien	อัด​ลี​เอน
semindaa	เซ​มิ​ดา
hefe	เฮ​เฟ
sutelaa	ซู​เท​ลา
sutelaa	ซู​เท​ลา
mbeke	เบ​เค
taahan	ทา​ฮัน
sutelaa	ซู​เท​ลา
elaan	เอ​ลาน
elaan	เอ​ลาน
mbelaa	เบ​ลา
atcmben	อัด​เบน
aahilam	อา​หิ​ลัม
aahilam	อา​หิ​ลัม
sefufaam	เซ​ฟู​ฟาม
hufaam	หุ​ฟาม
aatc	อาด
naaaamaan	นา​อา​มาน
suham	ซู​ฮัม
imnaa	อิม​นา
itcwi	อิด​วี
mbeliyaa	เบ​ลี​ยา
hembe	เฮ​เบ
mankien	มัน​คี​เอน
yaaseen	ยา​เซ​เอน
yaaseen	ยา​เซ​เอน
guni	กุ​นี
yese	เย​เซ
sinlem	ซิน​เลม
siangmbiauh	เซียงเบย้า
eleaasaa	เอ​เล​อา​ซา
bieiv	เปย๊ย
kang	คัง
elim	เอ​ลิม
koivsiqv	ค้อยซิ
ndofaakaa	โด​ฟะ​คา
aalutv	อา​ลู้ด
litvsaax	ลิด​สา
kehelaataa	เค​เฮ​ลา​ทา
sefe	เซ​เฟ
haalaandaa	ฮา​ลา​ดา
makvhelotv	มัก​เฮ​โล้ด
mitvkaa	มิด​คา
hatvmonaa	ฮัด​โม​นา
sanxmonaa	สัน​โม​นา
bunon	ปู​โนน
yeliko	เย​ลี​โค
koivdaic	ค้อยไต่
mendidelenien	เม​ดิ​เต​เล​เนียน
haasaalenan	ฮา​ซา​เล​นัน
sefaam	เซ​ฟาม
koivdaic	ค้อยไต่
mievciangv	เมี้ยเธี้ยง
mievciangv	เมี้ยเธี้ยง
zingh	ฒี่ง
ndiangxjaasic	เดี๋ยงจาสี่
buozjuonh	ปั์วจ้วน
tim	ทิม
holepv	โฮ​เล้บ
yie	เย
ziouc	ีย
camvhnoi	ธั้มฮนอย
zeletv	เฒ​เล้ด
aan	อาน
hemon	เฮ​โมน
zengc	เหฒ่ง
mbaasaan	บา​ซาน
douzsioux	โต์วเสียว
gorn	กอน
gauh	เก้า
golaan	โก​ลาน
dozleiz	โต์เล์ย
wuommbeux	ววมเบ๋ว
youc	โหย่ว
aanaakv	อา​น้าก
yaaaakan	ยา​อา​คัน
moselaa	โม​เส​ลา
gutcgondaa	กุด​โก​ดา
ndaubeih	เดาเป้ย
uix	หวุย
aambipc	อา​บีบ
zorngzengx	ฒองเหฒง
ceu	เธว
mbouv	โบ๊ว
siangbiauv	เซียงเปย๊า
ndaamdorng	ดามตอง
luisiaamjieqv	ลุยซยามเจี๊ยะ
auv	เอ๊า
mesobodemie	เม​โส​โป​เต​เมีย
siangauv	เซียงเอ๊า
nziangdorh	เฑียงต้อ
sekvsekv	เซ้กๆ
ndaudeic	เดาเต่ย
gapvnqenx	กั๊บเหฆน
maadiev	มาเตี๊ย
hmeivndaan	เฮม้ยดาน
hmeivndaan	เฮม้ยดาน
hmienmueic	เฮมียนเหมว่ย
baaix	ป๋าย
mbiungcmbuonv	บยู่งบ๊วน
mievlunx	เมี้ยหลุน
mbiungcgorng	บยู่งกอง
mievnyiemz	เมี้ยเญี์ยม
duqveix	ตุ๊เอ๋ย
hluqv	ฮลุ
yesulun	เย​ซู​ลุน
jorng	จอง
yesulun	เย​ซู​ลุน
daaulomc	ตาวหล่ม
daamv	ต๊าม
jauvbouc	เจ๊าโป่ว
hlaangsiqv	ฮลางซิ
laahapc	ลา​หับ
hlaangsiqv	ฮลางซิ
aalaambaa	อา​ลา​บา
yosuwaa	โย​ซู​วา
jorndaen	จอ​แดน
mbeih	เบ้ย
bungh	ปู้ง
yietc	เหยียด
aakaan	อา​คาน
douzsioux	โต์วเสียว
mbiev	เบี๊ย
lozheh	โล์เฮ่
lozluihoux	โล์ลุยโหว
gimbeon	กิ​เบ​โอน
baengmaanh	แปงม่าน
makvkendaa	มัก​เค​ดา
lipvnaa	ลิบ​นา
ekclon	เอก​โลน
haaso	ฮา​โซ
haalakv	ฮา​ลัก
mbaaan	บา​อัน​กาด
horngzhlen	ฮ์อง
yapvmborkc	ยับ​บอก
sihox	ซิ​โห
meaalaa	เม​อา​ลา
mendembaa	เม​เด​บา
mendembaa	เม​เด​บา
maaki	มา​คี
hembolon	เฮ​โบ​โลน
aakclapvmbim	อาก​ลับ​บิม
kaankaa	คาน​คา
mbonghlen	บงเฮลน
sikvkelon	ซิก​เค​โลน
yapvneen	ยับ​เน​เอน
otcnien	โอด​นี​เอน
kaalepv	คา​เล้บ
wuomzingv	ววมฒี้ง
kapcseen	ขับ​เซ​เอน
yaagun	ยา​กูน
lembaaotc	เล​บา​โอด
sinhim	ซิน​ฮิม
aanditaaim	อา​ดี​ทา​อิม
gendelotaaim	เก​เด​โล​ทา​อิม
zingh	ฒี่ง
holon	โฮ​โลน
mbetcen	เบด​เอน
zaqv	ฒะ
zaqv	ฒะ
hlieqvcie	เฮลียะเธีย
maalean	มา​เล​อัน
ndapcmbesetv	ดับ​เบ​เซ้ด
katcdaatc	ขัด​ตาด
naahaalaan	นา​หะ​ลาน
indaalaa	อิ​ดา​ลา
kesunxlotv	เค​สุน​โล้ด
henkatc	เฮน​ขัด
haali	ฮา​ลี
mbeten	เบ​เทน
embon	เอ​โบน
hammon	ฮัม​โมน
maahaalaapv	มา​หะ​ล้าบ
ummaa	อุม​มา
anmon	อัน​โมน
misaan	มิ​ซาน
kaantaa	คาน​ทา
ndimnaa	ดิม​นา
sefatv	เส​ฟัด
aamolai	อา​โม​ไล
seelaa	เซ​เอ​ลา
mbokim	โบ​คิม
ehutv	เอ​ฮู้ด
ehutv	เอ​ฮู้ด
ehutv	เอ​ฮู้ด
seilaa	เส​อี​ลา
ehutv	เอ​ฮู้ด
hlieqvmaazcie	เฮลียะม์าเธีย
ndembolaa	เด​โบ​ลา
ndembolaa	เด​โบ​ลา
siselaa	สิ​เส​ลา
siselaa	สิ​เส​ลา
yaaen	ยา​เอน
yaaen	ยา​เอน
siselaa	สิ​เส​ลา
yaaen	ยา​เอน
yaaen	ยา​เอน
yaaen	ยา​เอน
yaaen	ยา​เอน
nyorxmbuoqc	หญอบัวะ
siselaa	สิ​เส​ลา
yaaen	ยา​เอน
jauvdorn	เจ๊าตอน
jauvnjuotv	เจ๊าฌ้วด
kison	คี​โซน
melotv	เม​โล้ด
melotv	เม​โล้ด
nyorxnjietc	หญอเหฌียด
cieyienh	เธียเยี่ยน
juangnyouz	จวังโญ์ว
mindien	มี​เดียน
mindien	มี​เดียน
buozndiev	ปั์วเดี๊ย
junzeiv	จุนเฒ้ย
gindeon	กิ​เด​โอน
gindeon	กิ​เด​โอน
zaah	ฒ่า
gindeon	กิ​เด​โอน
gindeon	กิ​เด​โอน
puangv	พวั้ง
mbitv	บิ๊ด
douzbaav	โต์วป๊า
mbetcmbaalaaaa	เบด​บา​ลา​อา
wuombouc	ววมโป่ว
mbetcmbaalaaaa	เบด​บา​ลา​อา
sanxmunnaa	สัน​มุน​นา
njimvcou	ฌิ้มโธว
njimvmuonc	ฌิ้มหม่วน
junbaeng	จุนแปง
nombaa	โน​บา
yokvmbehaa	โย้ก​เบ​ฮา
sukckotv	สุก​โค้ด
sanxmunnaa	สัน​มุน​นา
njimvcou	ฌิ้มโธว
njimvmuonc	ฌิ้มหม่วน
ndiangxfomv	เดี๋ยงฟ้ม
aalumaa	อา​ลู​มา
gaaan	กา​อัน
sembun	เส​บุน
waacmaux	หว่าเหมา
gaaan	กา​อัน
aalumaa	อา​ลู​มา
topv	โท้บ
yepvtaa	เย้บ​ทา
yepvtaa	เย้บ​ทา
yepvtaa	เย้บ​ทา
yepvtaa	เย้บ​ทา
mitvbaa	มิด​ปา
yepvtaa	เย้บ​ทา
yepvtaa	เย้บ​ทา
sieqvdorndoic	เซียะตอนต่อย
mbongaivdorngx	บงไอ๊ต๋อง
yepvtaa	เย้บ​ทา
sieqvdorndoic	เซียะตอนต่อย
qipvmboletv	ชิบ​โบ​เล้ด
sipcmboletv	สิบ​โบ​เล้ด
faah	ฟ่า
apcndon	อับ​โดน
maanoaa	มา​โน​อา
maanoaa	มา​โน​อา
maanoaa	มา​โน​อา
timnaahaa	ทิม​นา​ฮา
saemsanx	แซม​สัน
saemsanx	แซม​สัน
saemsanx	แซม​สัน
waacormv	หว่าอ๊อม
waacormv	หว่าอ๊อม
edaam	เอ​ตาม
sianghlaang	เซียงฮลาง
mbiencbuoz	เบี่ยนปั์ว
ndelilaa	เด​ลิ​ลา
ceuvfaanh	เธ้วฟ่าน
ndaagon	ดา​โกน
biauvdungz	เปย๊าตู์ง
biauvdungz	เปย๊าตู์ง
mbetclehem	เบด​เล​เฮม
faamlungz	ฟามลู์ง
mikaa	มี​คา
etctaaon	เอด​ทา​โอน
maanz	ม์าน
nziouvnziouv	เฑี้ยวๆ
gimbeaa	กิ​เบ​อา
gimbeaa	กิ​เบ​อา
nqen	เฆน
caa	ธา
mbenyaamin	เบน​ยา​มิน
naaomi	นา​โอ​มี
mbuangzmaac	บวั์งหม่า
naaomi	นา​โอ​มี
maa	มา
nyaam	ญาม
juoh	จั้ว
naaomi	นา​โอ​มี
maabuoc	มาปั่ว
maabuoc	มาปั่ว
maabuoc	มาปั่ว
enzingh	เอนฒี่ง
mboaatc	โบ​อาด
tutv	ทุด
mboaatc	โบ​อาด
laamaataaim	ลา​มา​ทา​อิม
tohu	โท​หุ
tohu	โท​หุ
beninnaa	เป​นิน​นา
hannaa	ฮัน​นา
hannaa	ฮัน​นา
hannaa	ฮัน​นา
hannaa	ฮัน​นา
siangluindaauv	เซียงลุยด๊าว
saamuen	ซา​มู​เอน
saamuen	ซา​มู​เอน
saamuen	ซา​มู​เอน
saamuen	ซา​มู​เอน
saamuen	ซา​มู​เอน
saamuen	ซา​มู​เอน
saamuen	ซา​มู​เอน
saamuen	ซา​มู​เอน
saamuen	ซา​มู​เอน
silo	ซี​โล
embenese	เอ​เบน​เอ​เซ
filisaadie	ฟี​ลิ​สะ​เตีย
junzeiv	จุนเฒ้ย
ikaambotc	อี​คา​โบด
ongbuoc	องปั่ว
ndaagon	ดา​โกน
mbaeqv	แบ๊ะ
jiemnaauz	เจียมน์าว
jiemzueih	เจียมเฒว่ย
hlapv	ฮลับ
selo	เส​โล
mbekolatv	เบ​โค​ลัด
mbekolatv	เบ​โค​ลัด
aafiyaa	อา​ฟี​ยา
lengx	เหลง
lozhnoi	โล์ฮนอย
jangjang	จังๆ
siangmienh	เซียงเมี่ยน
deicbung	เต่ยปูง
hipvlu	ฮิบ​ลู
hlieqvzaangc	เฮลียะหฒั่ง
porng	พอง
mbongqangx	บงฉัง
mbaengxcitv	แบ๋งธิด
mbosetv	โบ​เซ้ด
sene	เส​เน
mbaengxcitv	แบ๋งธิด
aahiyaa	อา​หิ​ยา
yonaataan	โย​นา​ทาน
ne	เน
kenai	เค​ไน
hmiensetv	เฮมียนเซ้ด
saulo	เซา​โล
cangbaengx	ธังแป๋ง
dornlaai	ตอนลาย
caauv	ธ้าว
ndaawitv	ดา​วิด
dornlunx	ตอนหลุน
nyiuv	ญิ้ว
nyiuv	ญิ้ว
hlieqvlui	เฮลียะลุย
nzanc	หฑั่น
ndaawitv	ดา​วิด
jaixzueiv	ไจ๋เฒว้ย
nzomzdauh	ฑ์มเต้า
mikaan	มี​คาน
naayotv	นา​โย้ด
naayotv	นา​โย้ด
aahimelekv	อา​หิ​เม​เล้ก
aahimelekv	อา​หิ​เม​เล้ก
aakitv	อา​คิด
butvndin	ปุ๊ดดิน
heletvti	เฮ​เล้ด​ที
aambiyaataa	อา​บี​ยา​ทา
keilaa	เค​อี​ลา
keilaa	เค​อี​ลา
holetv	โฮ​เล้ด
holetv	โฮ​เล้ด
holetv	โฮ​เล้ด
holetv	โฮ​เล้ด
haakilaa	ฮา​คี​ลา
yesimon	เย​ซิ​โมน
biaux	เปย๋า
juvdaic	จู๊ไต่
juvmuo	จู๊มัว
naambaan	นา​บาน
naambaan	นา​บาน
naambaan	นา​บาน
fiemfingx	เฟียมฝีง
aambigaayin	อา​บี​กา​ยิน
naambaan	นา​บาน
naambaan	นา​บาน
aambigaayin	อา​บี​กา​ยิน
apcne	อับ​เน
apcne	อับ​เน
sinhlen	ซินเฮลน
waancwaanc’	หว่านๆ’
ndaunjang	เดาฌัง
gunv	กุ๊น
itcmbosetv	อิด​โบ​เซ้ด
yoaapc	โย​อาบ
aasaaxhen	อา​สา​เฮน
aasaaxhen	อา​สา​เฮน
yoaapc	โย​อาบ
mbeelotv	เบ​เอ​โล้ด
hnyangxbienx	หฮญังเปี๋ยน
siangngongh	เซียงง่ง
siangcie	เซียงเธีย
naakon	นา​โคน
ngongh	ง่ง
haandatcese	ฮา​ดัด​เอ​เซ
haandatcese	ฮา​ดัด​เอ​เซ
toi	โท​อี
nzauvhorngz	เฑ้าฮ์อง
simbaa	ซิ​บา
simbaa	ซิ​บา
mefimbosetv	เม​ฟี​โบ​เซ้ด
haanun	ฮา​นูน
ndaamvguh	ด๊ามกู้
kuotvnorm	ค้วดนอม
silie	ซี​เลีย
helaam	เฮ​ลาม
sombakc	โซ​บัก
uliaa	อุ​ลี​อา
uliaa	อุ​ลี​อา
auv	เอ๊า
yendindiyaa	เย​ดี​ดิ​ยา
gingzingh	กีงฒี่ง
lapvmbaa	ลับ​บา
amnon	อัม​โนน
amnon	อัม​โนน
amnon	อัม​โนน
apcsaalom	อับ​ซา​โลม
apcsaalom	อับ​ซา​โลม
gilon	กิ​โลน
sianghungh	เซียงฮู่ง
aahitofen	อา​หิ​โท​เฟน
husai	หุ​ไซ
fuix	ฝุย
jiepvnyeiz	เจี๊ยบเญ์ย
aamaasaax	อา​มา​สา
itctaalaa	อิด​ทา​ลา
itctaalaa	อิด​ทา​ลา
suangxdimc	สวังติ่ม
dopc	ตบ
baengbieiv	แปงเปย๊ย
hengheng	เฮงๆ
aahimaaatc	อา​หิ​มา​อัด
aahimaaatc	อา​หิ​มา​อัด
mefimbosetv	เม​ฟี​โบ​เซ้ด
mbaasinlai	บา​ซิน​ไล
mbaasinlai	บา​ซิน​ไล
kimhaam	คิม​ฮาม
mbikcli	บีก​ลี
gopc	โกบ
sapcbe	สับ​เป
wuomlaangc	ววมหล่าง
wuomndo	ววมโด
ndamc	ดั่ม
wuombamc	ววมปั่ม
ndorngh	ด้อง
haalotv	ฮา​โล้ด
yaasen	ยา​เซน
aalaaunaa	อา​ลาว​นา
aalaaunaa	อา​ลาว​นา
yaang	ยาง
sieqvnzueic	เซียะเหฑว่ย
aandoniyaa	อา​โด​นี​ยา
mbatcqembaa	บัด​เช​บา
mbatcqembaa	บัด​เช​บา
mbatcqembaa	บัด​เช​บา
gihon	กี​โฮน
gihon	กี​โฮน
aandoniyaa	อา​โด​นี​ยา
aambiqaakv	อา​บี​ช้าก
mbenaiyaa	เบ​ไน​ยา
simei	ซิ​เม​อี
simei	ซิ​เม​อี
qiqaa	ชี​ชา
eliholepv	เอ​ลี​โฮ​เล้บ
saaxmbutc	สา​บุด
aahiqaa	อา​หิ​ชา
gembe	เก​เบ
korxzinh	ขอฒิ่น
tipvsaax	ทิบ​สา
maazlaanh	ม์าล่าน
maazsiepv	ม์าเซี้ยบ
guai	ไกว
maaho	มา​โฮ
hilaam	ฮี​ลาม
zongh	ฒ่ง
zongh	ฒ่ง
nzipv	ฑิบ
muonh	ม่วน
muonh	ม่วน
gaengmau	แกงเมา
hnyouv	เฮญี้ยว
zuiz	ฒุ์ย
douzlouh	โต์วโล่ว
nzangvnouh	ฑั้งโน่ว
nzangvnouh	ฑั้งโน่ว
lozbenv	โล์เป๊น
aalaambie	อา​ละ​เบีย
zaangznyaah	ฒ์างญ่า
zaangznyaah	ฒ์างญ่า
mbing	บีง
mbingjieqv	บีงเจี๊ยะ
cin	ธิน
kue	คู​เอ
kue	คู​เอ
saalomorn	ซา​โล​มอน
baalaan	ปา​ลาน
taabenetv	ทา​เป​เน้ด
genumbatc	เก​นู​บัด
leson	เล​โซน
leson	เล​โซน
leson	เล​โซน
leson	เล​โซน
leson	เล​โซน
selendaa	เส​เล​ดา
seluwaa	เส​ลุ​วา
sianglui	เซียงลุย
sianglui	เซียงลุย
dozleiz	โต์เล์ย
yelomboam	เย​โล​โบ​อัม
buozndoqvdorn	ปั์วโด๊ะตอน
jiemngongh	เจียมง่ง
jiemngongh	เจียมง่ง
ziecdorngc	เหฒี่ยต่อง
hiou	โฮยว
hiou	โฮยว
ndiangxfangx	เดี๋ยงฝัง
aambiyam	อา​บี​ยัม
aambiyam	อา​บี​ยัม
mbaaaaqaa	บา​อา​ชา
qeme	เช​เม
hien	ฮี​เอน
titvmbi	ทิด​บี
titvmbi	ทิด​บี
saaxlefatv	สา​เล​ฟัด
ongx	อ๋ง
eliyaa	เอ​ลี​ยา
eliyaa	เอ​ลี​ยา
eliyaa	เอ​ลี​ยา
cangnangv	ธังนั้ง
guetv	เกว๊ด
yesemben	เย​เซ​เบน
haasaaen	ฮา​ซา​เอน
elisaa	เอ​ลี​ซา
elisaa	เอ​ลี​ซา
mienvmienv	เมี้ยนๆ
naambotc	นา​โบด
maengx	แหมง
ndopvhlaang	ด๊บฮลาง
maengx	แหมง
siangnzormc	เซียงหฑ่อม
gehaasi	เก​หะ​ซี
ndiedoqc	เดียโตะ
hlieqvbouv	เฮลียะโป๊ว
morqv	เมาะ
nuqvnuqv	นุๆ
yesemben	เย​เซ​เบน
yehu	เย​ฮู
aataaliyaa	อา​ทา​ลิ​ยา
luonh	ล่วน
dinc	ติ่น
yoaatc	โย​อาด
yosaakaa	โย​ซา​คา
yehoaahaatc	เย​โฮ​อา​หาด
yehoaahaatc	เย​โฮ​อา​หาด
cungen	ธุนเกน
yehoatcndin	เย​โฮ​อัด​ดิน
yokvteen	โย้ก​เท​เอน
bulaa	ปู​ลา
bekaahiyaa	เป​คา​หิ​ยา
bekaa	เป​คา
bekaa	เป​คา
yelusaa	เย​ลู​ซา
elatv	เอ​ลัด
ndaamatvgatc	ดา​มัด​กัด
saamaalie	สะ​มา​เลีย
lozleiz	โล์เล์ย
atcsilie	อัด​ซี​เลีย
guaengvmbaaix	แกว๊งบ๋าย
guoqv	กั๊วะ
waacnziaaux	หว่าหฑยาว
tilaahaakaa	ที​ละ​หะ​คา
hungh	ฮู่ง
mievyaang	เมี้ยยาง
zaangc	หฒั่ง
mesunlemetv	เม​ซุน​เล​เม้ด
yotvmbaa	โย้ด​บา
haalutv	ฮา​ลุด
saafaan	ซา​ฟาน
saafaan	ซา​ฟาน
nembukatvnetvsaa	เน​บู​คัด​เน้ด​ซา
nembusaalaandaan	เน​บู​ซา​ละ​ดาน
sinhlen	ซินเฮลน
nembusaalaandaan	เน​บู​ซา​ละ​ดาน
nembusaalaandaan	เน​บู​ซา​ละ​ดาน
lipvlaa	ลิบ​ลา
yaafetv	ยา​เฟ้ด
kapvto	คับ​โท
yokvtaan	โย้ก​ทาน
mbatcsuwaa	บัด​ซู​วา
huaa	ฮู​อา
mbunaa	บุ​นา
olen	โอ​เลน
maaatc	มา​อัด
eke	เอ​เค
aambiqu	อา​บี​ชู
saaxsaa	สา​ซา
yaalaahaa	ยา​ละ​ฮา
atctai	อัด​ไท
saaxmbaatc	สา​บาด
semaa	เซ​มา
kaasetv	คา​เซ้ด
kaasetv	คา​เซ้ด
sembe	เซ​เบ
tilaahaanaa	ที​ละ​หะ​นา
tilaatai	ทิ​ลา​ไท
sukaa	สุ​คา
haananyaa	ฮา​นัน​ยา
neaaliyaa	เน​อา​ลี​ยา
sombaan	โซ​บาน
huwaa	ฮู​วา
naaaalaa	นา​อา​ลา
aahutcsaam	อา​หุด​ซาม
temeni	เท​เม​นี
haaaahatctaali	ฮา​อา​หัด​ทา​ลี
kotc	โขด
kotc	โขด
aanupv	อา​นู้บ
sombembaa	โส​เบ​บา
haalum	ฮา​ลูม
aahaanxhen	อา​หาน​เฮน
yaambetc	ยา​เบด
naaham	นา​ฮัม
gelem	เก​เลม
maaaakatv	มา​อา​คัด
kosembaa	โค​เซ​บา
yokim	โย​คิม
mitvmaa	มิด​มา
meunim	เม​อู​นิม
yolai	โย​ไล
yaakaan	ยา​คาน
ziaa	ฒี​อา
yohaanan	โย​ฮา​นัน
lipvni	ลิบ​นี
atcsi	อัด​สี
aahimotv	อา​หิ​โม้ด
naahatc	นา​หัด
lipvni	ลิบ​นี
hemaan	เฮ​มาน
toaa	โท​อา
aamaasaix	อา​มา​ไส
manlukv	มัน​ลุก
mbileam	บิ​เล​อัม
aanem	อา​เนม
hugorkc	หุ​กอก
limmono	ลิม​โม​โน
yelien	เย​ลี​เอน
yaamai	ยา​ไม
ipcsamx	อิบ​สัม
isaalaahiyaa	อิ​สะ​ลา​หิ​ยา
isaalaahiyaa	อิ​สะ​ลา​หิ​ยา
ilaqv	อี​ละ
aahe	อา​เฮ
mbendaan	เบ​ดาน
mbeletv	เบ​เล้ด
mbeletv	เบ​เล้ด
eleaandaa	เอ​เล​อา​ดา
eleaandaa	เอ​เล​อา​ดา
eleatc	เอ​เล​อัด
gatc	กัด
elisaamaa	เอ​ลี​ซา​มา
naaaalan	นา​อา​ลัน
aiyaa	ไอ​ยา
enbaaan	เอน​ปา​อัน
mitvam	มิด​อัม
semetv	เซ​เม้ด
semetv	เซ​เม้ด
mikvlotv	มิก​โล้ด
mosaa	โม​ซา
aasen	อา​เซน
utai	อุ​ไท
omli	โอม​ลี
imli	อิม​ลี
aasaaxyaa	อา​สา​ยา
hatcsenuaa	หัด​เส​นู​อา
kole	โค​เล
ndaangc	ด่าง
meselemiyaa	เม​เซ​เล​มิ​ยา
qongxqongx	ฉงๆ
hakvmoni	ฮัก​โม​นี
deix	เต๋ย
junzeiv	จุนเฒ้ย
ndoqvhlen	โด๊ะเฮลน
yosaambaatc	โย​ซา​บาด
baengguanh	แปงกวั้น
enpeletv	เอน​เพ​เล้ด
nyic	หญี่
gaeng	แกง
kusaayaa	คู​ซา​ยา
unni	อุน​นี
aalaamotv	อา​ลา​โม้ด
mungv	มู้ง
tou	โท​อู
saawaasaa	ซา​วะ​ซา
naahaatc	นา​หาด
sofaakv	โซ​ฟ้าก
sipcbai	สิบ​ไป
laami	ลา​มี
zauxndoqv	เหฒาโด๊ะ
hlieqvnjapv	เฮลียะฌับ
gesom	เก​โซม
gongbuonc	กงป่วน
sembuen	เซ​บู​เอน
yendeyaa	เย​เด​ยา
selomotv	เซ​โล​โม้ด
itcsiyaa	อิด​ซี​ยา
mbeno	เบ​โน
soham	โซ​ฮัม
ipcli	อิบ​ลี
aaqaalelaa	อา​ชา​เล​ลา
betv	เป๊ด
sumbaaen	ซู​บา​เอน
lefaaen	เล​ฟา​เอน
semaakiyaa	เส​มา​คิ​ยา
lehapcyaa	เล​หับ​ยา
lehapcyaa	เล​หับ​ยา
ammisaambaatc	อัม​มี​ซะ​บาด
aasaasiyaa	อา​ซา​ซิ​ยา
sitvlai	ซิด​ไล
atclai	อัด​ไล
jiemjaadorngx	เจียมจาต๋อง
jiemcie	เจียมเธีย
gongmienh	กงเมี่ยน
moliyaa	โม​ลิ​ยา
ciqvcunx	ธิหธุน
ciqvcunx	ธิหธุน
jiemding	เจียมตีง
douztaanx	โต์วถาน
jiemgaengh	เจียมแก้ง
bieivzeiv	เปย๊ยเฒ้ย
goiv	ก๊อย
gongbouhniev	กงโปวเฮนี้ย
nzangvjien	ฑั้งเจียน
nzangvjien	ฑั้งเจียน
jiemzinh	เจียมฒิ่น
sukiim	สุ​คี​อิม
aambiyaa	อา​บี​ยา
fiuvtorngvbaaih	ฟิ้วท้องป้าย
aamatvyaa	อา​มัด​ยา
mikaayaa	มี​คา​ยา
sitc	สิด
yeluen	เย​ลู​เอน
horngzkuv	ฮ์องคู้
junbaengbieiv	จุนแปงเปย๊ย
aahatcyaa	อา​หัด​ยา
yehoyaandaa	เย​โฮ​ยา​ดา
maazgaengh	ม์าแก้ง
horngzgaengh	ฮ์องแก้ง
aahatc	อา​หัด
yehuen	เย​ฮู​เอน
yelusaalem	เย​ลู​ซา​เลม
aasaasiyaa	อา​ซา​ซิ​ยา
itcsaamaakiyaa	อิด​สะ​มา​คิ​ยา
ndoqvdorn	โด๊ะตอน
camvnyungc	ธั้มหญู่ง
fiuvbaengbieiv	ฟิ้วแปงเปย๊ย
yosiyaa	โย​สิ​ยา
yoaahaatc	โย​อา​หาด
sailatv	ไซ​ลัด
sailatv	ไซ​ลัด
mitvlendaatc	มิด​เล​ดาด
setvmbatcsaa	เซ้ด​บัด​ซา
jiembunh	เจียมปุ้น
jiemnzormc	เจียมหฑ่อม
setvmbatcsaa	เซ้ด​บัด​ซา
leelaiyaa	เล​เอ​ไล​ยา
sakckai	สัก​ไค
aandonikam	อา​โด​นี​คัม
zeivfun	เฒ้ยฟุน
yolaa	โย​ลา
gipcmbaa	กิบ​บา
doic	ต่อย
zeivfun	เฒ้ยฟุน
haatitaa	ฮา​ทิ​ทา
sombai	โซ​ไบ
haasuxfaa	ฮา​สู​ฟา
tapvmbaaotc	ทับ​บา​โอด
kelotv	เค​โล้ด
siaahaa	สี​อา​ฮา
paandon	พา​โดน
lembaanaa	เล​บา​นา
haagaambaa	ฮา​กา​บา
haagaapc	ฮา​กาบ
sanmai	ซัน​ไม
gitcnden	กิด​เดน
gaahaa	กา​ฮา
nekondaa	เน​โค​ดา
gatcsaam	กัด​ซาม
mbesaix	เบ​ไส
nefisimx	เน​ฟิ​สิม
mbakcmbukc	บัก​บูก
haakufaa	ฮา​คู​ฟา
haanhu	ฮาน​ฮู
mbatclutv	บัด​ลู้ด
mehindaa	เม​หิ​ดา
haansaa	ฮาน​ซา
mbaakotc	บา​โขด
nesiyaa	เน​ซิ​ยา
haatifaa	ฮา​ทิ​ฟา
sotai	โส​ไท
hatcsofeletv	หัด​โส​เฟ​เล้ด
belundaa	เป​ลุ​ดา
yaaaalaa	ยา​อา​ลา
ndaankon	ดาน​โคน
gitcnden	กิด​เดน
nekondaa	เน​โค​ดา
esaanxhatvndon	เอ​สาน​ฮัด​โดน
simsai	ซิม​ไซ
doicdoic	ต่อยๆ
simsai	ซิม​ไซ
yosaandakc	โย​ซา​ดัก
toux	โถว
kaasifie	คา​สิ​เฟีย
maaaaseaa	มา​อา​เส​อา
elaasaax	เอ​ลา​สา
laamiyaa	ลา​มี​ยา
aasisaa	อา​ซี​ซา
sean	เซ​อัน
itcsijaa	อิด​ซี​จา
qimeon	ชี​เม​โอน
matvtatvdaa	มัด​ทัด​ตา
yelemai	เย​เล​ไม
maaaandai	มา​อา​ได
uen	อู​เอน
sembinaa	เส​บิ​นา
yaatvndai	ย้าด​ได
lozjauv	โล์เจ๊า
haanhaayaa	ฮาน​ฮา​ยา
jiemzaangc	เจียมหฒั่ง
mbinnui	บิน​นุย
wuomgaengh	ววมแก้ง
jiemzaangc	เจียมหฒั่ง
haamibaakatv	ฮา​มี​ปา​คัด
ndaubuonc	เดาป่วน
gaengh	แก้ง
nzuncnzunc	หฑุ่นๆ
nzuncnzunc	หฑุ่นๆ
elun	เอ​ลูน
tombiaa	โท​บี​อา
hesekiyaa	เฮ​เซ​คี​ยา
hondaawiyaa	โฮ​ดา​วิ​ยา
zeivfun	ยฟุน
siaa	สี​อา
nefusesimx	เน​ฟู​เซ​สิม
mbatclitv	บัด​ลี้ด
sofeletv	โส​เฟ​เล้ด
belindaa	เป​ลี​ดา
ndiangxpaangh	เดี๋ยงพ่าง
hatvmbatcndaanaa	ฮัด​บัด​ดา​นา
douc	โต่ว
saengnyeic	แซงเหญ่ย
douzndiouh	โต์วเดี้ยว
aasanyaa	อา​ซัน​ยา
hondiyaa	โฮ​ดี​ยา
aataayaa	อา​ทา​ยา
yoetc	โย​เอด
yoetc	โย​เอด
bendaayaa	เป​ดา​ยา
kolaayaa	โค​ลา​ยา
belaaliyaa	เป​ลา​ลิ​ยา
belaaliyaa	เป​ลา​ลิ​ยา
aamaatvsaix	อา​ม้าด​ไส
akcsai	อัก​ไซ
akcsai	อัก​ไซ
mesinlemotv	เม​ซิน​เล​โม้ด
hakcgendolim	หัก​เก​โด​ลิม
mekonaa	เม​โค​นา
yesuaa	เย​ซู​อา
unno	อุน​โน
saax	สา
milaalai	มิ​ลา​ไล
gilaalai	กิ​ลา​ไล
maaai	มา​ไอ
haandaasaa	ฮา​ดา​ซา
hammendaataa	ฮัม​เม​ดา​ทา
jienmengh	เจียนเม่ง
hammendaataa	ฮัม​เม​ดา​ทา
haanmbonaa	ฮาน​โบ​นา
siwan	สิ​วัน
maazsiepv	ม์าเซี้ยบ
fiuvjien	ฟิ้วเจียน
mbenc	เบ่น
mbuonxhoz	บ๋วนโฮ์
qiexndoqc	เฉียโดะ
sinbiei	ซินเปยย
yieqc	เหยียะ
tinbaengh	ทินแป้ง
nziangx	เหฑียง
forngcang	ฟองธัง
ndoqvzuonx	โด๊ะหฒวน
buozndiev’	ปั์วเดี๊ย’
daaih’	ต้าย’
nzaeqv	แฑะ
buon	ปวน
wuomnzuih	ววมฑุ่ย
gaengnyorc	แกงหญ่อ
ngaengc	แหง่ง
nyorxhmeingaengc	หญอเฮมยแหง่ง
siangjunbaeng	เซียงจุนแปง
camvbung	ธั้มปูง
mbaqc	บะ
waacpuix	หว่าผุย
hlaaxsoux	หฮลาโสว
ndiangxlunx	เดี๋ยงหลุน
orvjunc	อ๊อจุ่น
buvjaa	ปู๊จา
buvjaa	ปู๊จา
zauxnqo	เหฒาโฆ
naeqc	แหนะ
zauxnqo	เหฒาโฆ
hmeivnauv	เฮม้ยเน้า
sorqv	เซาะ
fuqvloqc	ฟุโหละ
hlieqvjaasic	เฮลียะจาสี่
mbungvfim	บู๊งฟิม
tinbaeng	ทินแปง
naangnzung	นางฑูง
hlorv	ฮล้อ
haavhaav	ฮ้าๆ
mbiungcsuiv	บยู่งซุ้ย
qaqvleqc	ชะเหละ
mievnzungh	เมี้ยฑู่ง
ndiangxnzungh	เดี๋ยงฑู่ง
ndaukuotv	เดาค้วด
tuiv	ทุ้ย
hlam	ฮลัม
nziuvnziuv	ฑิ้วๆ
luijaang	ลุยจาง
faanfei	ฟานเฟย
ndauzuonx	เดาหฒวน
lozndauziouv	โล์เดาเฒี้ยว
mievzueix	เมี้ยเหฒวย
mbusi	บุ​ซี
mbaalaaken	บา​ลา​เคน
dau	เตา
wuomndiepv	ววมเดี๊ยบ
wuomtaan	ววมทาน
zongczongc	หฒ่งๆ
lomh	ล่ม
koivndoqv	ค้อยโด๊ะ
mievmaeng	เมี้ยแมง
faamcing	ฟามธีง
wuomongx	ววมอ๋ง
niendunh	เนียดุ้น
gonghniev	กงเฮนี้ย
ciouvciouv	เธี้ยวๆ
hlieqvbiaav	เฮลียะปย๊า
ndiangxnjimv	เดี๋ยงฌิ้ม
suivliemh	ซุ้ยเลี่ยม
douzfing	โต์วฟีง
orvnziu	อ๊อฑิว
ndiangxlatv	เดี๋ยงลัด
lozgaeng	โล์แกง
zong	ฒง
kamxbui	ขัมปุย
jaanghoh	จางโฮ่
sinsei	ซินเซย
nziaauxjorm	หฑยาวจอม
faambung	ฟามปูง
fiuvnzaeng	ฟิ้วแฑง
jauvbaengh	เจ๊าแป้ง
singqiex	ซีงเฉีย
gingdongz	กีงต์ง
zongc	หฒ่ง
doixdekc	ต๋อยเตก
paanpaan	พานๆ
puoqvpuoqv	พัวะๆ
paanpaan	พานๆ
puoqvpuoqv	พัวะๆ
huaanghuaang	ฮวางๆ
zaangzaang	ฒางๆ
ndaatvndiev	ด๊าดเดี๊ย
feifangv	เฟยฟั้ง
siousengh	เซียวเซ่ง
jaangndiev	จางเดี๊ย
fiuvmbong	ฟิ้วบง
mbietv	เบี๊ยด
puonx	ผวน
jiemlimc	เจียมหลิ่ม
gueix	เกว๋ย
dorziec	ตอเหฒี่ย
waacmaux	หว่าเหมา
waacgaam	หว่ากาม
cuqvmaux	ธุเหมา
mbaakaa	บา​คา
faangbuangh	ฟางปวั้ง
zienzien	เฒียนๆ
muonzzanc	ม์วนหฒั่น
pou	โพว
siangyouh	เซียงโย่ว
zozzoz	โฒ์ๆ
ndaamvseix	ด๊ามเสย
buix	ปุ๋ย
winjaa	วินจา
aamen	อา​เมน
jauvzaqc	เจ๊าหฒะ
yiemyiem	เยียมๆ
hlieqvgaengh	เฮลียะแก้ง
ndaujunc	เดาจุ่น
torngvbaaih	ท้องป้าย
njimvlomc	ฌิ้มหล่ม
dorziec	ตอเหฒี่ย
mbetc	เบด
feifangv	เฟยฟั้ง
feifangv	เฟยฟั้ง
zaayin	ฒา​ยิน
hetc	เหด
diucdiuc	ติ่วๆ
tetc	เถด
yotv	ยด
kapv	คับ
saamekv	ซา​เม้ก
hlieqvnqaiv	เฮลียะไฆ้
zaande	ฒา​เด
ndoqvnzuonx	โด๊ะหฑวน
laic	ไหล่
cenv	เธ้น
biauvgorqv	เปย๊าเก๊าะ
hlieqvlimc	เฮลียะหลิ่ม
qomqaau	ชมชาว
meiv	เม้ย
jaaidaauh	จายต้าว
gorngvnjaaux	ก๊องหฌาว
heiv	เฮ้ย
zimh	ฒิ่ม
ndutv	ดุ๊ด
jauvcaax	เจ๊าหธา
hlaaxjunh	หฮลาจุ้น
jaapvmaaz	จ๊าบม์า
koivminc	ค้อยหมิ่น
njienyouh	เฌียนโย่ว
dangvdorh	ตั๊งต้อ
nziangxdorh	เหฑียงต้อ
gorngvbaeqc	ก๊องแปะ
zuiz	ฒุ์ย
waaclongx	หว่าหลง
mueizdorngh	เมว์ยต้อง
wuomnamx	ววมหนัม
wuomnyuonh	ววมญ่วน
mievnqaai	เมี้ยฆาย
buozzaangvor	ปั์วฒ้างออ
wuombiom	ววมปยม
jaigorngx	ไจก๋อง
luisiouv	ลุยเซี้ยว
wuomnjaangh	ววมฌ่าง
saaux	สาว
buangh	ปวั้ง
wuonh	ว่วน
hlaangsietv	ฮลางเซี้ยด
njimvnyang	ฌิ้มญัง
waacfaix	หว่าไฝ
hnyangxjeiv	หฮญัง
wuomkuotvnzuih	ววมค้วดฑุ่ย
camvdiuh	ธั้มติ้ว
dungzhaengh	ตู์งแฮ่ง
saengh	แซ่ง
mbongcitv	บงธิด
wuomnyuonh	ววมญ่วน
suangsuiv	ซวังซุ้ย
muyorc	มู​หย่อ
gaengsorn	แกงซอน
baetvbaetv	แป๊ดๆ
gorqvjang	เก๊าะจัง
sungdorn	ซูงตอน
daau	ตาว
muocfaix	หมั่วไฝ
diuvkuv	ติ๊วคู้
mbonghlang	บงฮลัง
pouxpoux	โผวๆ
torngv	ท้อง
mbae	แบ
selaafim	เส​ลา​ฟิม
douztaanx	โต์วถาน
douztaanx	โต์วถาน
yembelekiyaa	เย​เบ​เล​คี​ยา
waacnjomc	หว่าหฌ่ม
laengclaengc	แหล่งๆ
deixdeix	เต๋ยๆ
lomcndiev	หล่มเดี๊ย
lom	ลม
bouv	โป๊ว
ndiangxndonx	เดี๋ยงด๋น
mbongnjang	บงฌัง
juvben	จู๊เปน
goix	ก๋อย
lomcmbiorqc	หล่มเบยาะ
gogo	โกๆ
mbieqvcou	เบี๊ยะโธว
gorxyouz	ก๋อโย์ว
wuomzuonx	ววมหฒวน
saagorn	ซา​กอน
aalaambie	อา​ละ​เบีย
forvzeih	ฟ้อเฒ่ย
ndiangxding	เดี๋ยงตีง
fiuvjaadorngx	ฟิ้วจาต๋อง
diuvgorngc	ติ๊วก่อง
taansitv	ทาน​ซิด
nyaux	เหญา
hlang	ฮลัง
zauxcaaiv	เหฒาธ้าย
horngzdaauh	ฮ์องต้าว
dien	เตียน
belaasim	เป​ลา​ซิม
nganx	หงัน
tongh	ท่ง
hau	เฮา
nganx	หงัน
tongh	ท่ง
hau	เฮา
morc	หม่อ
nganx	หงัน
zaang	ฒาง
ndaujunc	เดาจุ่น
haanetv	ฮา​เน้ด
ndaulongx	เดาหลง
ndaulongx	เดาหลง
ndaulongx	เดาหลง
ndauyouh	เดาโย่ว
caux	ปูงฮวาง
caeqv	แธะ
hlanghlang	ฮลังๆ
aivaiv	ไอ๊ๆ
buoznaamx	ปั์วหนาม
tinbaengh	ทินแป้ง
latv	ลัด
hleixguanh	เหฮลยกวั้น
hornc	ห่อน
hornc	ห่อน
ding	ตีง
nyei’	เญย’
kungxnziaaux	ขูงหฑยาว
hlieqvzueih	เฮลียะเฒว่ย
sungsung	ซูงๆ
jaandaangc	จาด่าง
sinim	ซี​นิม
junghungh	จูงฮู่ง
camvguoqv	ธั้มกั๊วะ
jauv	เจ๊า
ndiangxkounqaai	เดี๋ยงโควฆาย
fingv	ฟี้ง
siangceix	เซียงเหธย
hlieqvjaapv	เฮลียะจ๊าบ
hlieqvmuoc	เฮลียะหมั่ว
nzangvguanh	ฑั้งกวั้น
siangmbuox	เซียงบั๋ว
hongc	ห่ง
dauh	เต้า
siangndau	เซียงเดา
hlieqvndiouh	เฮลียะเดี้ยว
saibatckoivnzou	ไซ​ปัดค้อยโฑว
siangzoux	เซียงโหฒว
saanx	สาน
deicbung’	เต่ยปูง’
zeqc	เหฒะ
kungxkungx	ขูงๆ
mbongdorn	บงตอน
fiouxzoih	เฝียวฒ่อย
siangziouv	เซียงเฒี้ยว
wuomdoqc	ววมโตะ
maaznyienh	ม์าเญี่ยน
ufaatv	อุ​ฟ้าด
setv	เซ้ด
hlieqvlouh	เฮลียะโล่ว
jaaihorngc	จายห่อง
aanaatotv	อา​นา​โท้ด
camvnzunc	ธั้มหฑุ่น
zuqc	หฒ
nyiemv	เญี้ยม
nzaaih	ฑ่าย
laaix	หลาย
sianggaengh	เซียงแก้ง
mbaambilon	บา​บี​โลน
hlieqvgaaz	เฮลียะก์า
lozmbong	โล์บง
nunz	นุ์น
nunz	นุ์น
siangngaengc	เซียงแหง่ง
haananen	ฮา​นัน​เอน
gorqvgaengh	เก๊าะแก้ง
haanamen	ฮา​นัม​เอน
annaatotv	อัน​นา​โท้ด
haanamen	ฮา​นัม​เอน
ndausou	เดาโซว
ndausou	เดาโซว
ndausou	เดาโซว
nieongx	เนียอ๋ง
ndausou	เดาโซว
haambaasinyaa	ฮา​บา​ซิน​ยา
gemaaliyaa	เก​มา​ลิ​ยา
yehundi	เย​ฮู​ดี
yehoyaakim	เย​โฮ​ยา​คิม
kenndie	เคน​เดีย
netaaniyaa	เน​ทา​นิ​ยา
taatv	ท้าด
mbaaaasaa	บา​อา​ซา
netaaniyaa	เน​ทา​นิ​ยา
heliombuli	เฮ​ลี​โอ​บุ​ลี
lindie	ลิ​เดีย
diuvzaa	ติ๊วฒา
baeng’	แปง’
moapc	โม​อับ
kendaa	เค​ดา
elaam	เอ​ลาม
melaataaim	เม​ลา​ทา​อิม
bekotc	เป​โขด
nyomx	หญม
juangzinx	จวังหฒิน
ndielaangh	เดียล่าง
saengvziouv	แซ้งเฒี้ยว
mietc	เหมียด
sendekiyaa	เส​เด​คี​ยา
nzormcfaix	หฑ่อมไฝ
huaanghuaang	ฮวางๆ
niendui	เนียดุย
jiepvdaamv	เจี๊ยบต๊าม
niemor	เนียมอ
douzmiec	โต์วเหมี่ย
youcyouc	โหย่วๆ
mou	โมว
siouv	เซี้ยว
yienvbienx	เยี้ยนเปี๋ยน
huibaeqc	ฮวุยแปะ
huibaeqc	ฮวุยแปะ
orn	ออน
buozkou	ปั์วโคว
buozkou	ปั์วโคว
douzganx	โต์วกั๋น
neuz	เน์ว
nziaamvndorngh	ฑย้ามด้อง
tinx	ถิน
deicbung	เต่ยปูง
ndaamdorng	ดามตอง
kuv	คู้
sianghnyouv	เซียงเฮญี้ยว
sianglingh	เซียงลี่ง
hmeimaac	เฮมยหม่า
naamh	น่าม
maazgouv	ม์าโก๊ว
qoaa	โช​อา
koaa	โค​อา
buozzuih	ปั์วฒุ่ย
maazbaeng	ม์าแปง
ndiembuangh	เดียบวั้ง
nyei	ฑั้งเฒ่ย
saibatc	ค้อยโฑว
nzangvpaangh	ฑั้งพ่าง
helekc	เฮ​เหลก
gaamatv	กา​มัด
ndiangxjieqv	เดี๋ยงเจี๊ยะ
maazgeh	ม์าเก้
kaanne	คาน​เน
kinmaatv	คิน​ม้าด
siene	สิ​เอ​เน
wuomnzang	ววมฑัง
fiuvmbong	ฟิ้วบง
mbungvnqaai	บู๊งฆาย
tauv	เท้า
zouv	โฒ้ว
zeivfaqv	เฒ้ยฟะ
jiex	เจี๋ย
haamon	ฮา​โมน
haamonaa	ฮา​โม​นา
kungxdorngx	ขูงต๋อง
zauxmueic	เหฒาเหมว่ย
ndoqvhlen	โด๊ะเฮลน
wuomnzaaih	ววมฑ่าย
wuomzaamv	ววมฒ้าม
melimbatc	เม​ลิ​บัด​คา​เดด
wuov	โลน
enon	ฮา​ซา​เอ​โนน
haamatv	ฮา​มัด
wuombaeqc	ววมแปะ
sounzaangc	โซวหฑั่ง
guaiqaauv	ไกวช้าว
guaiqaauv	ไกวช้าว
guaiqaauv	ไกวช้าว
guaiqaauv	ไกวช้าว
guaiqaauv	ไกวช้าว
guaiqaauv	ไกวช้าว
guaiqaauv	ไกวช้าว
guaiqaauv	ไกวช้าว
ndulaa	ดู​ลา
jaamh	จ้าม
mbentesatvsaa	เบน​เท​ซัด​ซา
kuotvndoqv	ค้วดโด๊ะ
ndaamvcaamx	ด๊ามหธาม
gaambelien	กา​เบ​เลียน
yitvleen	ยิด​เล​เอน
efaaim	เอ​ฟา​อิม
ciougen	เธียวเกน
njuov	ฌั้ว
ndiangxpeixzaa	เดี๋ยงเผยฒา
kou	โคว
betuen	เป​ทุ​เอน
nyaah	ญ่า
donggen	ตงเกน
hleix	เหฮลย
sakckutv	สัก​คุด
kaiwan	ไค​วัน
biauvdorn	เปย๊าตอน
mietv	เมี้ยด
mietv	เมี้ยด
kelitv	เค​ลี้ด
mbaengxqangx	แบ๋งฉัง
molesetv	โม​เล​เซ้ด
lungv	ลู้ง
njimvmbiorngz	ฌิ้มบย์อง
tembetc	เท​เบด
kuqan	คู​ชัน
ndenzndenz	เด์นๆ
nzauvkuotv	เฑ้าค้วด
yehosaandakc	เย​โฮ​ซา​ดัก
nqamv	ฆั้ม
nzormc	หฑ่อม
dangzaanv	ตังฒ้าน
danggunv	ตังกุ๊น
maazjieqv	ม์าเจี๊ยะ
maazbaeqc	ม์าแปะ
jieqvbaeqc	เจี๊ยะแปะ
zueiz	เฒว์ย
hatclaakv	หัด​ล้าก
wuomkuotvnqaai	ววมค้วดฆาย
en	เอน
horngz	ฮ์อง
ndaudongz	เดาต์ง
zeqc	เหฒะ
maalaaki	มา​ลา​คี
korvlienh	ค้อเลี่ยน
fusux	ฟูสู
dungzndin	ตู์งดิน
baengcmbai	แป่งไบ
waeqc	แหวะ
weqv	เว่ะ
gaandaalaa	กา​ดา​ลา
baengcmbai	แป่งไบ
matvtaai	มัด​ทาย
butvbaengc	ปุ๊ดแป่ง
siangndie	เซียงเดีย
lozlui	โล์ลุย
siangndie	เซียงเดีย
ndeicziouv	เด่ยเฒี้ยว
ndeicziouv	เด่ยเฒี้ยว
ndeicziouv	เด่ยเฒี้ยว
laijaaix	ไลจ๋าย
laengc	แหล่ง
helondietc	เฮ​โล​เดียด
ndungc	ดู่ง
njoiz	ฌ์อย
waizwaiz	ไว์ๆ
wuomminc	ววมหมิ่น
gennesaaletv	เกน​เน​ซา​เล้ด
eidouh	เอยโต้ว
eidouh	เอยโต้ว
eidouh	เอยโต้ว
saidiex	ไซเตี๋ย
nzauz	หฮนางเฮม้ย
maagaandaan	มา​กา​ดาน
biaa	ปยา
filipvpoi	ฟี​ลิบ​พอย
yaagorpc	ยา​กอบ
camvdiuc	ธั้มติ่ว
simmbiuic	ซิมบยุ่ย
gonghnoi	กงฮนอย
ndiangxnormh	เดี๋ยงน่อม
cingjaahnaangx	ธีงจาหฮนาง
hliangv	เฮลี้ยง
saidiex’	ไซเตี๋ย’
doqc	โตะ
zuqv	ฒุ
getcsemaani	เกด​เส​มา​นี
luindaauvsiqv	ลุยด๊าวซิ
luindaauvsiqv	ลุยด๊าวซิ
aalimaatie	อา​ลิ​มา​เทีย
zouvgaengh	โฒ้วแก้ง
naucnauc	เหน่าๆ
siangnjaaux	เซียงหฌาว
lozndie	โล์เดีย
nietv	เนี้ยด
couxndiev	โหธวเดี๊ย
laijaaix	ไลจ๋าย
jorngx	จ๋อง
nyietvhnoi	เญี้ยดฮนอย
torqvsienx	เทาะเสียน
ndeicliuh	เด่ยลิ่ว
mbomz	บ์ม
ndeicliuh	เด่ยลิ่ว
faalisi	ฟา​ลิ​สี
caengyienv	แธงเยี้ยน
mbiangxnziaaux	เบี๋ยงหฑยาว
ndaanmaanutaa	ดาน​มา​นู​ทา
nyaiv	ไญ้
njangx	หฌัง
gaengmau	แกงเมา
lozauv	โล์เอ๊า
siangnqox	เซียงโหฆ
lomaa	โล​มา
auvguaavjomc	เอ๊ากว๊าจ่ม
ndielaengc	เดียแหล่ง
teofilatv	เท​โอ
aac	ฟี​ลัด
orgatcdatc	ออ​กัด​ตัด
zioudingh	เฒียวตี้ง
guaav	กว๊า
yuonh	ย่วน
kamxmbaang	ขัมบาง
nomv	น้ม
zuizmienh	ฒุ์ยเมี่ยน
njimvlomc	ฌิ้มหล่ม
gelaasaa	เก​ลา​ซา
sieqvndoqc	เซียะโดะ
yailatv	ไย​ลัด
nqemh	เฆ่ม
dorn	ตอน
wingc	หวี่ง
lozbiuv	โล์ปิ๊ว
mbeensembun	เบ​เอน​เซ​บูน
lozbiauv	โล์เปย๊า
lozbiauv	โล์เปย๊า
ndaamv	ด๊าม
baengcfouh	แป่งโฟ่ว
fiuvjauv	ฟิ้วเจ๊า
ndaamvjung	ด๊ามจูง
niaa	นีอา
ziu	ฒิว
hnaangxhmeivndortv	หฮนางเฮม้ยด๊อด
sakckietv	สัก​เคี้ยด
mbienvmbeux	เบี๊ยนเบ๋ว
emmaautc	เอม​มา​อูด
gornnyuonh	กอนญ่วน
lapvmbi	ลับ​บี
lapvmbi	ลับ​บี
ndiangxgorn	เดี๋ยงกอน
faauxfaaux	ฝาวๆ
njiecnjiec	เหฌี่ยๆ
ndamv	ดั๊ม
ongxnzuih	อ๋งฑุ่ย
cingsuiv	ธีงซุ้ย
hlaangbin	ฮลางปิน
siangyungz	เซียงยู์ง
siangyungz	เซียงยู์ง
siangyungz	เซียงยู์ง
jiex’	เจี๋ย’
saigorx	ไซก๋อ
gornnyuonh	กอนญ่วน
timbelietv	ทิ​เบ​เลี้ยด
ndaamvdingh	ด๊ามตี้ง
janxgikc	จั๋นกีก
siloam	สี​โล​อัม
nqongh	ฆ่ง
isaayaa	อิ​สะ​ยา
ndeng	เดง
sianglingc	เซียงหลี่ง
hnengx	เหฮนง
lapvmboni	ลับ​โบ​นี
nzangvhlen	ฑั้งเฮลน
hiaangbung	ฮยางปูง
baantie	ปาน​เทีย
kapvbaandosie	คับ​ปา​โด​เซีย
borntatv	ปอน​ทัด
faalijie	ฟา​ลี​เจีย
bamfilie	ปัม​ฟี​เลีย
hiaangbung	ฮยางปูง
ndiedamh	เดียตั้ม
damh	ตั้ม
butvbaengc	ปุ๊ดแป่ง
siangmaengc	เซียงแหม่ง
lefaan	เล​ฟาน
ngaauvngaauv	ง้าวๆ
ndokatv	โด​คัด
idaali	อิ​ตา​ลี
ndopvzaangc	ด๊บหฒั่ง
koneliatc	โค​เน​ลิ​อัด
ndopvzaangc	ด๊บหฒั่ง
mienh	เมี่ยน
antiokc	อัน​ที​โอก
mbaalaasaatatv	บะ​ละ​สะ​ทัด
nige	นี​เก
maanaaen	มา​นา​เอน
maanaaen	มา​นา​เอน
selukie	เซ​ลู​เคีย
saalaamitv	ซา​ลา​มิด
baafotv	ปา​โฟ้ด
mbaayesu	บา​เย​ซู
mbaayesu	บา​เย​ซู
sejiatc	เส​จี​อัด
sejiatc	เส​จี​อัด
baafotv	ปา​โฟ้ด
bisindie	ปิ​สิ​เดีย
lisaadaa	ลิ​สะ​ตา
nzaengngaengc	แฑงแหง่ง
fiuvcongx	ฟิ้วหธง
timotai	ทิ​โม​ไท
misie	มิ​เซีย
filipvpoi	ฟี​ลิบ​พอย
ndapvornx	ดั๊บอ๋อน
siangleiz	เซียงเล์ย
aalekvsaanndelie	อา​เล้ก​ซาน​เด​เลีย
faatvsou	ฟ้าดโซว
aantemitv	อาน​เท​มิด
ceuvceuv	เธ้วๆ
torlemi	ทอ​เล​มี
maanaasanx	มะ​นา​สัน
maanaasanx	มะ​นา​สัน
teigorn	เทยกอน
teidaauh	เทยต้าว
baengbieiv	แปงเปย๊ย
antibaadi	อัน​ทิ​ปา​ตี
ndusinxlaa	ดู​สิน​ลา
yulietv	ยู​เลี้ยด
atclaamitvtiyum	อัด​ลา​มิด​ทิ​ยุม
sunx	สุน
lisie	ลี​เซีย
milaa	มิ​ลา
kaanindatc	คา​นี​ดัด
sunx	สุน
baaiz	ป์าย
sanxmone	สัน​โม​เน
kaaundaa	คาว​ดา
nzangvdorn	ฑั้งตอน
nzangvdorn	ฑั้งตอน
morndaa	มอน​ตา
apcbiatc	อับ​ปี​อัด
kaeqvbiauv	แคะเปย๊า
zingx	หฒีง
waacdoqc	หว่าโตะ
apclaaham	อับ​ลา​ฮัม
siangziangh	เซียงเฒี่ยง
lozhnyouv	โล์เฮญี้ยว
korvlienh	ค้อเลี่ยน
gingsou	กีง
ginx	กิ๋น
inlilikum	อิน​ลี​ลี​คุม
fembi	เฟ​บี
kenkelie	เคน​เค​เลีย
ebenetatv	เอ​เป​เน​ทัด
anndonikatv	อัน​โด​นิ​คัด
yuniatc	ยู​นี​อัด
ampaaliaatatv	อัม​พะ​ลี​อา​ทัด
umbaanatv	อู​บา​นัด
saataakitv	สะ​ทา​คิด
helondion	เฮ​โล​ดิ​โอน
naasitvsatc	นา​ซิด​สัด
aasinxkitatv	อา​สิน​คี​ทัด
faalegon	ฟะ​เล​โกน
batclombatc	ปัด​โล​บัด
hemaatv	เฮ​ม้าด
kaantatv	คาน​ทัด
sosaatenetv	โส​สะ​เท​เน้ด
kaaloe	คะ​โล​เอ
dornhnamv	ตอนฮนั้ม
lozbingv	โล์ปี๊ง
lozbingv	โล์ปี๊ง
finkouv	ฟินโค้ว
gitvgitv	กิ๊ดๆ
huv	ฮู้
danx	ตั๋น
danx	ตั๋น
siangngaengc	เซียงแหง่ง
siangzeix	เซียงเหฒย
hnamvnzuonx	ฮนั้มหฑวน
doixdangc	ต๋อยตั่ง
porx	ผอ
ganh	กั้น
gongzoh	กงโฒ่
waacmaux	หว่าเหมา
aaletatv	อา​เล​ทัด
kuei	เควย
zeivfun	เฒ้ยฟุน
hmienminc	เฮมียนหมิ่น
zeivfun	เฒ้ยฟุน
dingczinh	ตี่งฒิ่น
joux	โจ๋ว
hlang	ฮลัง
hlamx	หฮลัม
hlamx	หฮลัม
hmienbeih	เฮมียนเป้ย
lozmaengc	โล์แหม่ง
lozmaengc	โล์แหม่ง
lozmaengc	โล์แหม่ง
fienx	เฝียน
dangxdouh	ตั๋งโต้ว
kolosi	โค​โล​สี
qaqv	ชะ
wakc	หวัก
eih	เอ้ย
siangmaengc	เซียงแหม่ง
hielaambuli	ฮี​เอ​ลา​บุ​ลี
nimfaa	นิม​ฟา
laundisie	เลา​ดี​เซีย
zuotc	หฒวด
aakaayaa	อา​คา​ยา
janx	จั๋น
lueic	เหลว่ย
zeivzeiv	เฒ้ยๆ
nzaangcwaeqc	หฑั่งแหวะ
siangsienx	เซียงเสียน
kuinx	ขวิน
auvguaavlunx	เอ๊ากว๊าหลุน
cox	โหธ
loitc	โล​อิด
yunitv	ยู​นิด
onesifolatv	โอ​เน​สิ​โฟ​ลัด
doucdouc	โต่วๆ
dorng	ตอง
kaanbatc	คาน​ปัด
yumbulatv	ยู​บู​ลัด
bunden	ปู​เดน
linatv	ลี​นัด
kaalaaundie	คา​ลาว​เดีย
kelitv	เค​ลี้ด
aantemaatv	อาน​เท​ม้าด
nikombuli	นิ​โค​บุ​ลี
apcfie	อับ​เฟีย
aankipvbatc	อาน​คิบ​ปัด
filemon	ฟี​เล​โมน
loz	โล์
dorngx	ต๋อง
mbungvdaaux	บู๊งต๋าว
paanpei	พานเพย
mbiungcwuom	บยู่งววม
lozleizlatc	โล์เล์ยหลัด
nziaamv	ฑย้าม
siangjauv	เซียงเจ๊า
guangc	กวั่ง
hnaangxdonx	หฮนางต๋น
hlaangkouv	ฮลางโค้ว
nzangvmbietc	ฑั้งเบียด
mbitinie	บิ​ที​เนีย
jienfouv	เจียนโฟ้ว
hanc	หั่น
ginv	กิ๊น
mbiouz	เบี์ยว
taaixbaeqc	ถายแปะ
fing	ฟีง
hih	ฮี่
wuomzingvnqaai	ววมฒี้งฆาย
nyiemc	เหญี่ยม
wangc	หวั่ง
ndemetvliatc	เด​เม้ด​ลิ​อัด
saamenaa	สะ​เม​นา
begaamam	เป​กา​มัม
filaandenfie	ฟี​ลา​เดน​เฟีย
siangyelusaalem	เซียงเย​ลู​ซา​เลม
luihouxbaeqc	ลุย
jiemningv	เจียมนี้ง
maazsiqv	ม์าซิ
maenglunx	แมงหลุน
luindaauvbaeqc	ลุยด๊าวแปะ
ndaangh	ด้าง
aambatcndon	อา​บัด​โดน
aaborliyon	อา​ปอ​ลิ​โยน
caaiv	ธ้าย
junghungh	จูงฮู่ง
junghungh	จูงฮู่ง
limh	ลิ่ม
sienv	เซี้ยน
mouc	โหม่ว
mbiuic	บยุ่ย
zorngh	ฒ่อง
douzkoiv	โต์วค้อย
lozlungh	โล์ลู่ง
lozndau	โล์เดา
jiembiaavndorqc	เจียมปย๊าเดาะ
fin	ฟิน
ye	เย
su	ซู
yo	โย
han	ฮัน
i	อี
yipv	ยิบ
hipv	ฮิบ
lu	ลู
e	เอ
nden	เดน
ko	โค
lin	ลิน
to	โท
no	โน
yaa	ยา
apc	อับ
laam	ลาม
gaa	กา
laa	ลา
tie	เทีย
kaa	คา
naa	นา
an	อัน
mo	โม
le	เล
am	อัม
fen	เฟน
en	เอน
saax	สา
aa	อา
li	ลี
okc	โอก
ke	เค
ndo	โด
o	โอ
me	เม
ti	ทิ
ndaan	ดาน
ham	ฮัม
tu	ทู
simx	สิม
laan	ลาน
yokv	โย้ก
saan	ซาน
mi	มี
ndien	เดียน
itc	อิด
mbaakc	บาก
qe	เช
mbaa	บา
nde	เด
atc	อัด
lim	ลิม
sim	ซิม
um	อุม
mim	มิม
faa	ฟา
mbi	บี
ndaa	ดา
sakc	สัก
ge	เก
maa	มา
haa	หะ
im	อิม
se	เส
ndom	โดม
tai	ไท
ndi	ดี
mbetc	เบด
sepv	เซ้บ
yu	ยู
ndun	ดุน
lam	ลัม
qu	ชู
nai	ไน
i	อิ
saa	สะ
mben	เบน
si	สิ
on	โอน
wi	วี
mbu	บู
lun	ลุน
sai	ไซ
ndorn	ดอน
fingxi	ฝีงอิ
se	เซ
lon	โลน
fi	ฟี
ndim	ดิม
hu	ฮู
mbe	เบ
saa	ซา
len	เลน
lai	ไล
hitv	ฮิด
be	เป
litv	ลิด
si	ซี
mbutc	บุด
ndapc	ดับ
ken	เคน
si	สี
ndetc	เดด
jor	จอ
ndaen	แดน
sipc	สิบ
bo	โป
sitv	ซิด
tim	ทิม
matv	มัด
taai	ทาย
gi	กิ
aatc	อาด
setc	เสด
sukc	สุก
kotv	โค้ด
mbipc	บีบ
waa	วา
norn	นอน
mbin	บิน
ndon	โดน
mbapc	บับ
akc	อัก
saapv	ซ้าบ
li	ลิ
die	เตีย
taa	ทา
lotv	โล้ด
maa	มะ
natv	นัด
ki	คี
mi	มิ
lo	โล
fe	เฟ
hatc	หัด
haa	ฮา
hokv	โฮ้ก
ti	ที
laa	ละ
gin	กิน
gaan	กาน
hutv	ฮู้ด
mbo	โบ
lekv	เล้ก
saem	แซม
sanx	สัน
etc	เอด
hem	เฮม
ndie	เดีย
ki	คิ
hu	หุ
mu	มู
mitv	มิด
baadorh	ปาต้อ
min	มิน
latv	ลัด
mon	โมน
haatc	หาด
taan	ทาน
hi	หิ
siqv	ซิ
yitv	ยิด
he	เฮ
aapc	อาบ
mbaan	บาน
yin	ยิน
lom	โลม
ni	นี
hakv	ฮัก
gitc	กีด
tan	ทัน
ekc	เอก
ne	เน
lu	ลุ
te	เท
setv	เซ้ด
mbikc	บีก
jetc	เจียด
morn	มอน
lem	เลม
ndokc	โดก
ho	โฮ
lepv	เล้บ
lutv	ลู้ด
fatv	ฟัด
qaa	ชา
nim	นิม
hox	โห
mbatc	บัด
lie	เลีย
mbotc	โบด
hapc	หับ
maan	มาน
ndin	ดิน
kim	คิม
hepv	เฮ้บ
katv	คัด
netv	เน้ด
napv	นับ
hetv	เฮ้ด
so	โซ
mai	ไม
haatv	ฮ้าด
utc	อุด
mbukc	บุก
yotv	โย้ด
tupv	ทู้บ
nan	นัน
ndakc	ดัก
pu	พู
fai	ไฟ
ipc	อิบ
samx	สัม
mbon	โบน
motv	โม้ด
totv	โท้ด
metv	เม้ด
haan	ฮาน
utc	อูด
aa	อะ
supv	ซุบ
bim	ปิม
hupc	หุบ
fu	ฟู
faan	ฟาน
aa	อา
mbie	เบีย
sikc	สิก
laakv	ล้าก
sam	ซัม
mu	มุ
letv	เล้ด
u	อุ
so	โส
ndatc	ดัด
ditc	ติด
gatc	กัด
ndu	ดู
tun	ทูน
ni	นิ
bi	ปิ
tatv	ทัด
sen	เซน
lipv	ลิบ
lupv	ลุบ
kai	ไค
baa	ปา
mbikc	บิก
wai	ไว
hum	ฮูม
gai	ไก
aan	อาน
sitv	ซี้ด
hin	ฮิน
hatv	ฮัด
toi	ทอย
su	สุ
watv	วัด
yorc	หย่อ
bie	เปีย
fan	ฟัน
baatc	ปาด
mikv	มิก
baan	ปาน
hetc	เหด
satv	ซัด
sie	เซีย
tu	ทุ
naa	นะ
we	เว
gukc	กุก
kitv	คิด
gen	เกน
nie	เนีย
sapc	สับ
yum	ยูม
mbu	บุ
bor	ปอ
kuin	ควิน
bitc	ปิด
sinx	สิน
daa	ตา
laau	ลาว
ndi	ดิ
yum	ยุม
bam	ปัม
poi	พอย
lau	เลา
kapv	คับ
mbi	บิ
faatv	ฟ้าด
janx	จั๋น
taiv	ไท้
tin	ทิน
hungh	ฮู่ง
cing	ธีง
nzengc	เหฑ่ง
jauv	เจ๊า
louc	โหล่ว
ndau	เดา
ndiev	เดี๊ย
mbung	บูง
saeng	แซง
kuv	คู้
ndaamv	ด๊าม
lungh	ลู่ง
dorn	ตอน
jueiv	เจว๊ย
fun	ฟุน
faqv	ฟะ
beih	เป้ย
maeng	แมง
miev	เมี้ย
zeiv	เฒ้ย
mbiungc	บยู่ง
suiv	ซุ้ย
imx	อิ๋ม
waac	หว่า
eix	เอ๋ย
deic	เต่ย
bung	ปูง
gong	กง
zoh	โฒ่
ziec	เหฒี่ย
dorngh	ต้อง
hnyangx	หฮญัง
jeiv	เจ๊ย
ndiangx	เดี๋ยง
lomc	หล่ม
ndopv	ด๊บ
liuh	ลิ่ว
camv	ธั้ม
dauh	เต้า
jaa	จา
dingh	ตี้ง
wuom	ววม
kuotv	ค้วด
huaang	ฮวาง
fin	ฟิน
mienh	เมี่ยน
leiz	เล์ย
fingx	ฝีง
miuc	หมิ่ว
fangx	ฝัง
lui	ลุย
houx	โหว
muoz	มั์ว
doic	ต่อย
hlo	โฮล
baeng	แปง
bieiv	เปย๊ย
youz	โย์ว
laai	ลาย
mueic	เหมว่ย
win	วิน
wangv	วั้ง
ndaauv	ด๊าว
touv	โท้ว
koiv	ค้อย
hlen	เฮลน
nzangv	ฑั้ง
bouc	โป่ว
gapv	กั๊บ
jaaix	จ๋าย
jangx	จั๋ง
hoc	โห่
latc	หลัด
hunghyie	ฮู่งเยีย
ong	อง
hongc	ห่ง
muonc	หม่วน
labieiv	หละเปย๊ย
dorngx	ต๋อง
feix	เฝย
zaangc	หฒั่ง
buoz	ปั์ว
benv	เป๊น
sux	สู
jiem	เจียม
finx	ฝิน
yietv	เยี้ยด
mbuonv	บ๊วน
caqv	ธะ
nyeic	เหญ่ย
orv	อ๊อ
mbiorngz	บย์อง
gorqv	เก๊าะ
hung	ฮูง
louh	โล่ว
mor	มอ
sui	ซุย
hnoi	ฮนอย
nyieqc	เหญียะ
daic	ไต่
sic	สี่
nziemx	เหฑียม
yaangh	ย่าง
biaav	ปย๊า
mbiaac	บย่า
taaix	ถาย
nyeiz	เญ์ย
ndoqv	โด๊ะ
baengh	แป้ง
doix	ต๋อย
ngaanc	หง่าน
wuon	ววน
baengc	แป่ง
sieqv	เซียะ
baaix	ป๋าย
auv	เอ๊า
guaav	กว๊า
leih	เล่ย
maanz	ม์าน
hmuangx	หฮมวัง
maaz	ม์า
cie	เธีย
daaih	ต้าย
gorx	ก๋อ
cun	ธุน
gaeng	แกง
diuc	ติ่ว
borng	ปอง
mbong	บง
aiv	ไอ๊
juoqv	จั๊วะ
bienx	เปี๋ยน
nzauv	เฑ้า
dueiv	เตว๊ย
mueiz	เมว์ย
congx	หธง
zingv	ฒี้ง
mbaengx	แบ๋ง
ngaamh	ง่าม
daauh	ต้าว
jaav	จ๊า
zeih	เฒ่ย
laangh	ล่าง
cien	เธียน
ceqv	เธะ
ganaaiv	กะน้าย
cenv	เธ้น
faix	ไฝ
butv	ปุ๊ด
zoih	ฒ่อย
juang	จวัง
zinx	หฒิน
hlaang	ฮลาง
jun	จุน
njien	เฌียน
youh	โย่ว
nziaamv	ฑย้าม
fei	เฟย
cong	ธง
mengh	เม่ง
ningv	นี้ง
biouv	เปี๊ยว
nqaai	ฆาย
mbuoqc	บัวะ
sou	โซว
biuv	ปิ๊ว
daan	ตาน
saengv	แซ้ง
ziouv	เฒี้ยว
zaux	เหฒา
hnaangx	หฮนาง
dieh	เตี้ย
zorng	ฒอง
zuqv	ฒุ
diuv	ติ๊ว
zaanv	ฒ้าน
guanh	กวั้น
cou	โธว
ziepc	เหฒียบ
juov	จั๊ว
diex	เตี๋ย
buonv	ป๊วน
fiuv	ฟิ้ว
laangz	ล์าง
ciangv	เธี้ยง
torngv	ท้อง
baaih	ป้าย
daanh	ต้าน
mbuov	บั๊ว
mau	เมา
siang	เซียง
hlaax	หฮลา
njang	ฌัง
laangc	หล่าง
ceix	เหธย
beiv	เป๊ย
nzou	โฑว
zinh	ฒิ่น
dongc	ต่ง
mungv	มู้ง
orn	ออน
lorqc	เหลาะ
fujueiv	ฝุเจว๊ย
hlauv	เฮล้า
ndongh	ด้ง
gorn	กอน
baengx	แป๋ง
ndeic	เด่ย
nqenx	เหฆน
nziaaux	หฑยาว
zunc	หฒุ่น
nzaaih	ฑ่าย
jaax	จ๋า
cang	ธัง
fou	โฟว
sapv	ซับ
zuangx	หฒวัง
gorngv	ก๊อง
hemx	เหม
baeqc	แปะ
ciou	เธียว
mbuangz	บวั์ง
pengx	เผง
naang	นาง
jieqv	เจี๊ยะ
ndaangc	ด่าง
korv	ค้อ
lienh	เลี่ยน
jopv	จ๊บ
dang	ตัง
cov	โธ้
gunguaaz	กู้งว์า
fim	ฟิม
nquaah	ฆว่า
gaaz	ก์า
njunc	หฌุ่น
forng	ฟอง
zun	ฒุน
biangh	เปี้ยง
lunx	หลุน
hlopv	ฮลบ
zengx	เหฒง
zuiz	ฒุ์ย
nipc	หนิบ
zaqc	หฒะ
ndorm	ดอม
nziouv	เฑี้ยว
mbuonx	บ๋วน
pou	โพว
tong	ทง
huingx	หฮวีง
biauv	เปย๊า
ngorh	ง่อ
zouv	โฒ้ว
gemh	เก้ม
yinh	ยิ่น
yiem	เยียม
hmei	เฮมย
bin	ปิน
luoqc	หลัวะ
sung	ซูง
jiu	จิว
baang	ปาง
you	โยว
nzauh	เฑ่า
gikc	กีก
zaanc	หฒ่าน
kungx	ขูง
zohyie	โฒ่เยีย
hnyouv	เฮญี้ยว
zingh	ฒี่ง
gouv	โก๊ว
laic	ไหล่
huv	ฮู้
jaanx	จ๋าน
jien	เจียน
fouv	โฟ้ว
ging	กีง
loz	โล์
nzaeng	แฑง
norm	นอม
ndorqc	เดาะ
nzung	ฑูง
faang	ฟาง
nqaaix	หฆาย
hei	เฮย
horngc	ห่อง
bungx	ปู๋ง
sing	ซีง
qiex	เฉีย
saaiv	ซ้าย
ndui	ดุย
zaeqv	แฒะ
morngh	ม่อง
huaax	หฮวา
nyinz	ญิ์น
haanz	ฮ์าน
ceng	เธง
douz	โต์ว
nzauc	เหฑ่า
ndaam	ดาม
dorng	ตอง
siou	เซียว
caeqv	แธะ
jaangh	จ้าง
zaangv	ฒ้าง
dekc	เตก
doqc	โตะ
yungz	ยู์ง
hmien	เฮมียน
sin	ซิน
dor	ตอ
dangx	ตั๋ง
donx	ต๋น
njaaux	หฌาว
bingx	ปี๋ง
ciouv	เธี้ยว
domh	ต้ม
ngaaiz	ง์าย
ndonx	ด๋น
joih	จ้อย
zuoqc	หฒัวะ
guoqv	กั๊วะ
hmz	ฮม์
cietv	เธี้ยด
jaai	จาย
cai	ไธ
mbiauz	เบย์า
normh	น่อม
liangx	เหลียง
ngaeqv	แงะ
faam	ฟาม
baeqv	แป๊ะ
bou	โปว
doz	โต์
hnamv	ฮนั้ม
nzuonx	หฑวน
minc	หมิ่น
sioux	เสียว
don	ตน
maac	หม่า
ziou	เฒียว
hniev	เฮนี้ย
cin	ธิน
maanc	หม่าน
fiqv	ฟิ
nguaaz	งว์า
jorm	จอม
zung	ฒูง
ndaang	ดาง
seix	เสย
mouh	โม่ว
kouv	โค้ว
fomv	ฟ้ม
gem	เกม
guai	ไกว
gaengv	แก๊ง
njuov	ฌั้ว
nyiemz	เญี์ยม
ndiouh	เดี้ยว
njimv	ฌิ้ม
mbiorqc	เบยาะ
njeiv	เฌ้ย
kuing	ควีง
njongc	หฌ่ง
lingh	ลี่ง
jiex	เจี๋ย
mbiauh	เบย้า
paaiv	พ้าย
poux	โผว
zuih	ฒุ่ย
jaangv	จ๊าง
ngongh	ง่ง
norqc	เหนาะ
yangh	ยั่ง
tiux	ถิว
gou	โกว
muoc	หมั่ว
nziez	เฑี์ย
buang	ปวัง
soux	โสว
mbiec	เบี่ย
guaa	กวา
domx	ต๋ม
kaeqv	แคะ
meiv	เม้ย
mbietc	เบียด
taatv	ท้าด
juonh	จ้วน
mbeux	เบ๋ว
siaam	ซยาม
nziang	เฑียง
dorh	ต้อ
diev	เตี๊ย
hmeiv	เฮม้ย
gorng	กอง
duqv	ตุ๊
daau	ตาว
heh	เฮ่
maanh	ม่าน
horngz	ฮ์อง
hlieqv	เฮลียะ
nyorx	หญอ
njuotv	ฌ้วด
njietc	เหฌียด
yienh	เยี่ยน
nyouz	โญ์ว
baav	ป๊า
maux	เหมา
ormv	อ๊อม
mbienc	เบี่ยน
ceuv	เธ้ว
faanh	ฟ่าน
dungz	ตู์ง
lungz	ลู์ง
buoc	ปั่ว
naauz	น์าว
zueih	เฒว่ย
loz	โล์
qangx	ฉัง
citv	ธิด
jaix	ไจ๋
zueiv	เฒว้ย
nzomz	ฑ์ม
juv	จู๊
muo	มัว
fiem	เฟียม
guh	กู้
jiepv	เจี๊ยบ
suangx	สวัง
dimc	ติ่ม
bamc	ปั่ม
nzueic	เหฑว่ย
korx	ขอ
laanh	ล่าน
siepv	เซี้ยบ
nouh	โน่ว
zaangz	ฒ์าง
nyaah	ญ่า
mbing	บีง
dorngc	ต่อง
nangv	นั้ง
nzormc	หฑ่อม
bouv	โป๊ว
guaengv	แกว๊ง
mbaaix	บ๋าย
yaang	ยาง
njapv	ฌับ
buonc	ป่วน
ciqv	ธิ
cunx	หธุน
ding	ตีง
taanx	ถาน
gaengh	แก้ง
nyungc	หญู่ง
bunh	ปุ้น
fun	ฟุน
zeiv	ย
paangh	พ่าง
hoz	โฮ์
ndoqc	โดะ
biei	เปยย
zuonx	หฒวน
ndiev’	เดี๊ย’
nzuih	ฑุ่ย
nyorc	หญ่อ
ngaengc	แหง่ง
puix	ผุย
junc	จุ่น
buv	ปู๊
nqo	โฆ
nauv	เน้า
fuqv	ฟุ
loqc	โหละ
mbungv	บู๊ง
qaqv	ชะ
leqc	เหละ
nzungh	ฑู่ง
jaang	จาง
zueix	เหฒวย
ndiepv	เดี๊ยบ
ongx	อ๋ง
ndunh	ดุ้น
liemh	เลี่ยม
fing	ฟีง
nziu	ฑิว
kamx	ขัม
bui	ปุย
hoh	โฮ่
sei	เซย
dongz	ต์ง
ndaatv	ด๊าด
fangv	ฟั้ง
sengh	เซ่ง
limc	หลิ่ม
gaam	กาม
cuqv	ธุ
buangh	ปวั้ง
muonz	ม์วน
zanc	หฒั่น
nqaiv	ไฆ้
qom	ชม
qaau	ชาว
caax	หธา
junh	จุ้น
jaapv	จ๊าบ
dangv	ตั๊ง
nziangx	เหฑียง
longx	หลง
namx	หนัม
nyuonh	ญ่วน
or	ออ
biom	ปยม
jai	ไจ
gorngx	ก๋อง
siouv	เซี้ยว
njaangh	ฌ่าง
sietv	เซี้ยด
nyang	ญัง
diuh	ติ้ว
haengh	แฮ่ง
suang	ซวัง
sorn	ซอน
jang	จัง
hlang	ฮลัง
njomc	หฌ่ม
ben	เปน
mbieqv	เบี๊ยะ
forv	ฟ้อ
gorngc	ก่อง
caaiv	ธ้าย
naamx	หนาม
hleix	เหฮลย
jung	จูง
kou	โคว
mbuox	บั๋ว
saibatckoiv	ไซ​ปัดค้อย
zoux	โหฒว
bung’	ปูง’
fioux	เฝียว
nyienh	เญี่ยน
nzunc	หฑุ่น
zaa	ฒา
daamv	ต๊าม
miec	เหมี่ย
yienv	เยี้ยน
hui	ฮวุย
ganx	กั๋น
ndorngh	ด้อง
deic	เต่ย
mbuangh	บวั้ง
geh	เก้
nzang	ฑัง
zaamv	ฒ้าม
nzaangc	หฑั่ง
qaauv	ช้าว
caamx	หธาม
peix	เผย
dong	ตง
gunv	กุ๊น
mbai	ไบ
ei	เอย
douh	โต้ว
mbiuic	บยุ่ย
diex’	เตี๋ย’
coux	โหธว
nyietv	เญี้ยด
torqv	เทาะ
sienx	เสียน
caeng	แธง
mbiangx	เบี๋ยง
nqox	โหฆ
jomc	จ่ม
laengc	แหล่ง
mbaang	บาง
fouh	โฟ่ว
ndortv	ด๊อด
mbienv	เบี๊ยน
lingc	หลี่ง
hiaang	ฮยาง
damh	ตั้ม
maengc	แหม่ง
ndapv	ดั๊บ
ornx	อ๋อน
tei	เทย
ziangh	เฒี่ยง
bingv	ปี๊ง
zeix	เหฒย
dangc	ตั่ง
dingc	ตี่ง
waeqc	แหวะ
daaux	ต๋าว
paan	พาน
pei	เพย
yelusaalem	เย​ลู​ซา​เลม
yohan	โยฮัน
iyipv	อียิบ
hipvlu	ฮิบลู
enden	เอเดน
kolinto	โคลินโท
noyaa	โนยา
yaafetv	ยาเฟ้ด
apclaam	อับลาม
gaalaatie	กาลาเทีย
haalaan	ฮาลาน
saalaai	ซาลาย
kaanaaan	คานาอัน
sekem	เซเคม
mole	โมเล
sinaa	ซีนา
amlaafen	อัมลาเฟน
enlaasaax	เอนลาสา
aaliokc	อาลีโอก
elaam	เอลาม
kendolaaome	เคโดลาโอเม
goyim	โกยิม
tindaan	ทิดาน
en	เอนซัดได
apclaaham	อับลาฮัม
mamle	มัมเล
saalaa	ซาลา
ketulaa	เคทูลา
simxlaan	สิมลาน
yokvsaan	โย้กซาน
mendaan	เมดาน
mindien	มีเดียน
itcmbaakc	อิดบาก
quwaa	ชูวา
qembaa	เชบา
ndendaan	เดดาน
atcsulim	อัดซูลิม
letusim	เลทูซิม
leummim	เลอุมมิม
efaa	เอฟา
efe	เอเฟ
haanokv	ฮาโน้ก
aambindaa	อาบีดา
enndaaaa	เอนดาอา
isakc	อีสัก
gelaaaa	เกลาอา
yaakopv	ยาโค้บ
maahaanaaim	มาหะนาอิม
sei	เสอี
endom	เอโดม
esaau	เอซาว
leaa	เลอา
laasen	ลาเซน
yiutai	ยิวไท
ndinaa	ดีนา
hiwai	ฮีไว
mbetcen	เบดเอน
yosepv	โยเซ้บ
yundaa	ยูดา
aandunlam	อาดุนลัม
hilaa	ฮีลา
quaa	ชูอา
eaa	เออา
onan	โอนัน
taamaa	ทามา
faalo	ฟาโล
naiaa	ไนอา
yaakopv	ยาโค้บ
isaalaaen	อิสะลาเอน
lumben	ลูเบน
simeon	สิเมโอน
lewi	เลวี
yundaa	ยูดา
sembulun	เสบูลุน
saindorn	ไซดอน
itcsaaxkaa	อิดสาคา
fingxisaalaaen	ฝีงอิสะลาเอน
mose	โมเซ
aalon	อาโลน
elim	เอลิม
sinaai	ซีนาย
lefindim	เลฟีดิม
yeto	เยโท
huaa	ฮูอา
uli	อุลี
mbesaalen	เบซาเลน
aamolai	อาโมไล
hitvtai	ฮิดไท
belitvsi	เปลิดซี
yembutc	เยบุด
efotv	เอโฟ้ด
naandapc	นาดับ
aambihu	อาบีฮู
bide	ปีเต
eseken	เอเสเคน
naasi	นาสี
miliem	มิเลียม
eleaasaa	เอเลอาซา
sindaa	สีดา
kaandetc	คาเดด
moapc	โมอับ
jorndaen	จอแดน
yeliko	เยลีโค
sipcbo	สิบโป
mbaalaakv	บาล้าก
mbaalaaam	บาลาอัม
mbeo	เบโอ
sitvtim	ซิดทิม
matvtaai	มัดทาย
lumben	ลูเบน
yaase	ยาเซ
gileaatc	กิเลอาด
laamaasetc	ลามาเสด
sukckotv	สุกโค้ด
etaam	เอทาม
mbaasaan	บาซาน
endeni	เอเดนอี
aambipc	อาบีบ
yosuwaa	โยซูวา
lembaanorn	เลบานอน
haaso	ฮาโซ
yaambin	ยาบิน
maandon	มาโดน
yombapc	โยบับ
simlon	ซิมโลน
akcsaapv	อักซ้าบ
aannon	อานโนน
hemon	เฮโมน
aalaambaa	อาลาบา
filisaadie	ฟีลิสะเตีย
gesu	เกซู
aataalotv	อาทาโล้ด
aanki	อานคี
maanatvse	มะนัดเส
maaki	มาคี
aambiyese	อาบีเยเซ
helekv	เฮเล้ก
atclien	อัดลีเอน
hefe	เฮเฟ
semindaa	เซมิดา
selofehatc	เสโลเฟหัด
maakile	มาคีเล
maahaalaa	มาฮาลา
hokvlaa	โฮ้กลา
minkaa	มินคา
tilaasaa	ทีละซา
simeon	สิเมโอน
mbeeqembaa	เบเอเชบา
qembaa	เชบา
molaandaa	โมลาดา
gingaan	กินกาน
mbokim	โบคิม
ehutv	เอฮู้ด
ndembolaa	เดโบลา
aambinoam	อาบีโนอัม
aamaalekv	อามาเล้ก
efaaim	เอฟาอิม
gindeon	กิเดโอน
maanoaa	มาโนอา
solaa	โสลา
saemsanx	แซมสัน
timnaahaa	ทิมนาฮา
gaasaa	กาซา
mikaa	มีคา
etctaaon	เอดทาโอน
mbetclehem	เบดเลเฮม
yundie	ยูเดีย
elimelekv	เอลีเมเล้ก
naaomi	นาโอมี
maalon	มาโลน
kilion	คิลิโอน
efaataa	เอฟาทา
mboaatc	โบอาด
mbaali	บาลี
laamaataaim	ลามาทาอิม
laamaataaim	ลามาทาอิมโซฟิม
laamaa	ลามา
enkaanaa	เอนคานา
yeloham	เยโลฮัม
elihu	เอลีฮู
tohu	โทหุ
saamuen	ซามูเอน
eli	เอลี
embenese	เอเบนเอเซ
aafekv	อาเฟ้ก
kiliyaatv	คีลิย้าดเยอาลิม
taux	อาบีนาดับ
mitvbaadorh	มิดปาต้อ
yoen	โยเอน
aambiyaa	อาบียา
mbenyaamin	เบนยามิน
aambien	อาบีเอน
selo	เสโล
mbekolatv	เบโคลัด
aafiyaa	อาฟียา
saulo	เซาโล
ammon	อัมโมน
naahaatc	นาหาด
yaambetc	ยาเบดกิเลอาด
gileaatc	ยาเบด
ndaawitv	ดาวิด
yonaataan	โยนาทาน
saulo	เซาโล
aahimelekv	อาหิเมเล้ก
maako	มาโค
lugaa	ลูกา
ndaawitv	ดาวิด
en	เอนเกดี
baalaan	ปาลาน
maaon	มาโอน
kaanmen	คานเมน
sipcaa	สิบอา
gimbeaa	กิเบอา
haakilaa	ฮาคีลา
yesimon	เยซิโมน
yitvleen	ยิดเลเอน
aakitv	อาคิด
ginmboaa	กินโบอา
hembolon	เฮโบโลน
amnon	อัมโนน
aahinoam	อาหิโนอัม
kileaapc	คิเลอาบ
naambaan	นาบาน
aambigaayin	อาบีกายิน
apcsaalom	อับซาโลม
tanmai	ทันไม
maaaakaa	มาอาคา
aandoniyaa	อาโดนียา
hakvgitc	ฮักกีด
sefaatiyaa	เซฟาทิยา
aambitan	อาบีทัน
itcleam	อิดเลอัม
ekclaa	เอกลา
apcne	อับเน
naatan	นาทัน
seluyaa	เสลุยา
yoaapc	โยอาบ
tekoaa	เทโคอา
mefimbosetv	เมฟีโบเซ้ด
simbaa	ซิบา
aahitofen	อาหิโทเฟน
mbikcli	บีกลี
jetcsi	เจียดซี
saalomorn	ซาโลมอน
yelusaalem	เยลูซาเลม
gimbeon	กิเบโอน
saaxndokc	สาโดก
aasaaliyaa	อาซาลิยา
qiqaa	ชีชา
eliholepv	เอลีโฮเล้บ
aahiyaa	อาหิยา
aahilutv	อาหิลู้ด
yehosaafatv	เยโฮซาฟัด
yehoyaandaa	เยโฮยาดา
mbenaiyaa	เบไนยา
aambiyaataa	อาบียาทา
saaxmbutc	สาบุด
aahiqaa	อาหิชา
apcndaa	อับดา
aandonilam	อาโดนีลัม
tailaqv	ไทละ
hilaam	ฮีลาม
ndaawitv	ดาวิด
sion	สิโอน
etaanim	เอทานิม
lehoxmboam	เลโหโบอัม
nembatc	เนบัด
yelomboam	เยโลโบอัม
iyipv	อียิบ
silo	ซีโล
haanaani	ฮานานี
yehu	เยฮู
mbaaaaqaa	บาอาชา
silie	ซีเลีย
aalam	อาลัม
haandatc	เบนฮาดัด
saamaalie	สะมาเลีย
naambotc	นาโบด
aahapc	อาหับ
naaaamaan	นาอามาน
elisaa	เอลีซา
gileaatc	ลาโม้ดกิเลอาด
nimsi	นิมซี
aahatcyaa	อาหัดยา
yoaatc	โยอาด
yehoaahaatc	เยโฮอาหาด
yehoaatc	เยโฮอาด
aamaasiyaa	อามาซิยา
yehoatcndin	เยโฮอัดดิน
lemaaliyaa	เลมาลิยา
bekaa	เปคา
yotaam	โยทาม
aahatc	อาหัด
elaa	เอลา
hoseyaa	โฮเซยา
hesekiyaa	เฮเซคียา
sekaaliyaa	เสคาลิยา
aambi	อาบี
eliyaakim	เอลียาคิม
sepvnaa	เซ้บนา
aamortv	อาม้อด
isaayaa	อิสะยา
hepvsimbaa	เฮ้บซีบา
yelemi	เยเลมี
yehoyaakim	เยโฮยาคิม
mbaambilon	บาบีโลน
nembukatvnetvsaa	เนบูคัดเน้ดซา
ndaanien	ดานีเอน
sendekiyaa	เสเดคียา
itcsaaxkaa	อิดสาคา
sembulun	เสบูลุน
napvtaali	นับทาลี
aase	อาเซ
beletv	เปเล้ด
hetvlon	เฮ้ดโลน
kaanmi	คานมี
sombaan	โซบาน
leaayaa	เลอายา
yaahaatc	ยาหาด
aahumai	อาหุไม
laahaatv	ลาฮ้าด
geson	เกโซน
kohaatv	โคฮ้าด
melaali	เมลาลี
amlaam	อัมลาม
itchaa	อิดฮา
utcsien	อุดซีเอน
itaamaa	อิทามา
finehatc	ฟีเนหัด
aambiquwaa	อาบีชูวา
mbukcki	บุกคี
utcsi	อุดซี
selaahiyaa	เสลาหิยา
melaayotv	เมลาโย้ด
aamaaliyaa	อามาลิยา
aahitupv	อาหิทู้บ
aahimaaatc	อาหิมาอัด
yohaanan	โยฮานัน
yehosaandakc	เยโฮซาดัก
tolaa	โทลา
puaa	พูอา
yaasupv	ยาซู้บ
lefaiyaa	เลไฟยา
yelien	เยลีเอน
yaamai	ยาไม
ipcsamx	อิบสัม
isaalaahiyaa	อิสะลาหิยา
mikaaen	มีคาเอน
ombaandi	โอบาดี
itcsiyaa	อิดซียา
mbelaa	เบลา
mbeke	เบเค
yendiyaaen	เยดียาเอน
etcmbon	เอดโบน
yelimotv	เยลีโม้ด
ili	อิลี
semilaa	เสมิลา
eliyese	เอลีเยเซ
elionai	เอลีโอไน
omli	โอมลี
yelemotv	เยเลโม้ด
aanaatotv	อานาโท้ด
aalemetv	อาเลเม้ด
mbinhaan	บินฮาน
yeutc	เยอูด
kenaaaanaa	เคนาอะนา
setaan	เสทาน
taansitv	ทานซิด
aahiqaahaa	อาหิชาฮา
supvbim	ซุบปิม
hupcbim	หุบปิม
ilaqv	อีละ
husim	หุซิม
aahe	อาเฮ
atcmben	อัดเบน
aahaalaa	อาหะลา
nohaa	โนฮา
laafaa	ลาฟา
atcndaa	อัดดา
gelaa	เกลา
aambihutv	อาบีฮู้ด
aahoxaa	อาโหอา
sefufaan	เซฟูฟาน
hulaam	หุลาม
gembaa	เกบา
maanaahaatv	มานาฮ้าด
utcsaa	อุดซา
aahihutv	อาหิฮู้ด
saahaalaaim	ซาหะลาอิม
mbaaaalaaaa	บาอาลาอา
hondetc	โฮเดด
simbie	สิเบีย
mesaa	เมซา
mankaam	มันคาม
nehaami	เนหะมี
sikclaakv	สิกล้าก
sammuwaa	ซัมมุวา
sombapc	โซบับ
elisaamaa	เอลีซามา
mbeenyaandaa	เบเอนยาดา
elifeletv	เอลีเฟเล้ด
ulien	อุลีเอน
aasaaxyaa	อาสายา
elisaafaan	เอลีซาฟาน
semaiaa	เซไมอา
elien	เอลีเอน
amminaandapc	อัมมีนาดับ
sombaa	โสบา
haandatcese	ฮาดัดเอเซ
haamatv	ฮามัด
yufeditc	ยูเฟติด
ndaamatvgatc	ดามัดกัด
saadaan	ซาตาน
aasaapc	อาสาบ
hemaan	เฮมาน
yendutun	เยดูทูน
sakcge	สักเก
netaaniyaa	เนทานิยา
aaqaalelaa	อาชาเลลา
gendaaliyaa	เกดาลิยา
seli	เสลี
yesaayaa	เยซายา
simei	ซิเมอี
haasaabiyaa	ฮาซาปิยา
matvtitiyaa	มัดทีทิยา
haamatv	ฮามัดโสบา
tatvmo	ทัดโม
sisakv	ซิซัก
ondetc	โอเดด
aasaax	อาสา
mbaaan	บาอัน
aaselaa	อาเซลา
yehohaanan	เยโฮฮานัน
isaamaaen	อิสะมาเอน
ombetc	โอเบด
aandaayaa	อาดายา
maaaaseaa	มาอาเสอา
sikcli	สิกลี
elisaafatv	เอลีซาฟัด
simbiyaa	สิบียา
yelusaa	เยลูซา
utcsiyaa	อุดซียา
ofen	โอเฟน
atcsilie	อัดซีเลีย
sennaakelipv	เซนนาเคลิบ
yosiyaa	โยสิยา
yoaahaatc	โยอาหาด
sailatv	ไซลัด
besie	เปเซีย
esaalaa	เอสะลา
selupvmbaamben	เสลุบบาเบน
yesuaa	เยซูอา
selaiaa	เสไลอา
leelaiyaa	เลเอไลยา
mondekai	โมเดไค
mbinsaan	บินซาน
mitvbaa	มิดปา
mbikcwai	บิกไว
lehum	เลฮูม
mbaaaanaa	บาอานา
baalotv	ปาโล้ด
aalaa	อาลา
hakvgai	ฮักไก
itcndo	อิดโด
seantien	เซอันทิเอน
yosaandakc	โยซาดัก
tatvtenai	ทัดเทไน
qetaa	เชทาโบเซไน
ndaaliatc	ดาลิอัด
mindie	มีเดีย
ekcmbaataanaa	เอกบาทานา
aantaasesitv	อานทาเซซี้ด
hinkiyaa	ฮินคียา
sanlum	ซันลูม
gesom	เกโซม
hatvtatv	ฮัดทัด
sekaaniyaa	เซคานิยา
sanxmbaanlatv	สันบานลัด
haananyaa	ฮานันยา
qembaaniyaa	เชบานียา
manlukv	มันลุก
maaaasiyaa	มาอาซิยา
mbingai	บินไก
ginnetoi	กินเนทอย
aahaasuelatv	อาหะสุเอลัด
watvqaati	วัดชาที
aagakc	อากัก
hammendaataa	ฮัมเมดาทา
haamaan	ฮามาน
esete	เอเซเท
aandaa	อาดา
temaan	เทมาน
elifatv	เอลีฟัด
mbinndatc	บินดัด
naaaame	นาอาเม
sofaa	โสฟา
yaake	ยาเค
aagu	อากู
muyorc	มูหย่อ
etiobie	เอทีโอเปีย
sefanyaa	เสฟันยา
lewiaataan	เลวีอาทาน
aamon	อาโมน
isaalaaen	อิสะลาเอน
imme	อิมเม
baatche	ปาดเฮ
nembusaalaandaan	เนบูซาละดาน
mikvndon	มิกโดน
taabaanhetc	ทาปานเหด
memfitv	เมมฟิด
neliyaa	เนลิยา
haamutaan	ฮามุทาน
lipvnaa	ลิบนา
oholaa	โอโฮลา
oholimbaa	โอโฮลีบา
aamotv	อาโม้ด
kembaa	เคบา
mbensatvsaa	เบนซัดซา
taambo	ทาโบ
aakaasiezoux	อาคาเซีย
betuen	เปทุเอน
kaanne	คานเน
aamitvtai	อามิดไท
yonaa	โยนา
ninaawe	นินะเว
haambaagukc	ฮาบากุก
kusi	คูซี
kitvlepv	คิดเล้บ
giduc	กีตู่
uliyaa	อุลียา
yolam	โยลัม
helotv	เฮโล้ด
faalisi	ฟาลิสี
gaalili	กาลิลี
maazli	มาลี
kaabenaaum	คาเปนาอุม
gennesaaletv	เกนเนซาเล้ด
kaanaa	คานา
bilaatv	ปีล้าด
simon	ซีโมน
tomatv	โทมัด
naataanaaen	นาทานาเอน
sembendi	เสเบดี
aanaanie	อานาเนีย
sapcfilaa	สับฟีลา
saatefen	สะเทเฟน
ikoniyum	อีโคนียูม
baulo	เปาโล
mbaanaambatc	บานาบัด
silaa	ซีลา
amfimbuli	อัมฟีบุลี
aaborlonie	อาปอโลเนีย
tesaalonigaa	เทสะโลนิกา
aaten	อาเทน
aakuinlaa	อาควินลา
borntatv	ปอนทัด
bitcsinxlaa	ปิดสินลา
idaali	อิตาลี
kaalaaundiatc	คาลาวดิอัด
timotai	ทิโมไท
maasindonie	มาซีโดเนีย
tetulatv	เททูลัด
sisaaliyaa	ซีซาลียา
fesaatatv	เฟสะทัด
atclaamitvtiyum	อัดลามิดทิยุม
esie	เอเซีย
silisie	ซีลีเซีย
bamfilie	ปัมฟีเลีย
lisie	ลีเซีย
morndaa	มอนตา
filipvpoi	ฟีลิบพอย
aamen	อาเมน
tidatc	ทิตัด
kolosi	โคโลสี
yuondie	ยูโอเดีย
sinxtike	สินทิเค
kenmen	เคนเมน
laundisie	เลาดีเซีย
filemon	ฟีเลโมน
kapvbaandosie	คับปาโดเซีย
mbitinie	บิทีเนีย
efeso	เอเฟโซ
aandam	อา​ดัม
kaain	คา​อิน
aambaen	อา​แบน
enden	เอ​เดน
aandaa	อา​ดา
maahaalaalen	มา​หะ​ลา​เลน
metuselaa	เม​ทู​เส​ลา
kaanaaan	คา​นา​อัน
gome	โก​เม
maandai	มา​ได
tumban	ทู​บัน
atckenatv	อัด​เค​นัด
togaanmaa	โท​กาน​มา
eliseaa	เอ​ลี​เซ​อา
kitvtim	คิด​ทิม
londaanim	โล​ดา​นิม
iyipv	อี​ยิบ
sembaa	เส​บา
haawilaa	ฮา​วิ​ลา
sapctaa	สับ​ทา
laaaamaa	ลา​อา​มา
sapctekaa	สับ​เท​คา
qembaa	เช​บา
ndendaan	เด​ดาน
ninaawe	นิ​นะ​เว
lundim	ลู​ดิม
aanaamim	อา​นา​มิม
lehaambim	เล​หะ​บิม
napvtuhim	นับ​ทู​ฮิม
atcsu	อัด​ซู
aanfaasatv	อาน​ฟา​ซัด
lunde	ลู​เด
gete	เก​เท
embe	เอ​เบ
yokvtaan	โย้ก​ทาน
anmondatc	อัน​โม​ดัด
haasaanmaawetv	ฮา​ซาน​มา​เว้ด
haandolam	ฮา​โด​ลัม
ndikclaa	ดิก​ลา
aambimaaen	อา​บี​มา​เอน
yombapc	โย​บับ
mbaamben	บา​เบน
leu	เล​อู
naaho	นา​โฮ
apclaam	อับ​ลาม
mbetcen	เบด​เอน
sondom	โส​โดม
gomolaa	โก​โม​ลา
atcmaa	อัด​มา
semboyim	เส​โบ​ยิม
soaa	โส​อา
aamaalekv	อา​มา​เล้ก
aamolai	อา​โม​ไล
sitcndim	สิด​ดิม
ndaamatvgatc	ดา​มัด​กัด
kendolaaome	เค​โด​ลา​โอ​เม
aane	อา​เน
etcko	เอด​โค
eliyese	เอ​ลี​เย​เซ
apclaaham	อับ​ลา​ฮัม
hitvtai	ฮิด​ไท
belitvsi	เป​ลิด​ซี
lefaaim	เล​ฟา​อิม
isaamaaen	อิ​สะ​มา​เอน
gelaaaa	เก​ลา​อา
aambimelekv	อา​บี​เม​เล้ก
isakc	อี​สัก
mbeeqembaa	เบ​เอ​เช​บา
mbetuen	เบ​ทู​เอน
lembekaa	เล​เบ​คา
hembolon	เฮ​โบ​โลน
sohaax	โส​หา
efolon	เอ​โฟ​โลน
laambaan	ลา​บาน
ketulaa	เค​ทู​ลา
yokvsaan	โย้ก​ซาน
mitvmaa	มิด​มา
haandatc	ฮา​ดัด
kendemaa	เค​เด​มา
filisaadie	ฟี​ลิ​สะ​เตีย
mbeeli	เบ​เอ​ลี
mbaasematv	บา​เส​มัด
laambaan	ลา​บาน
mbinhaa	บิน​ฮา
leaa	เล​อา
napvtaali	นับ​ทา​ลี
sinxbaa	สิน​ปา
ndundaaim	ดู​ดา​อิม
isaalaaen	อิ​สะ​ลา​เอน
sei	เส​อี
simeon	สิ​เม​โอน
efaalaataa	เอ​ฟา​ลา​ทา
mbenyaamin	เบน​ยา​มิน
aase	อา​เซ
elifatv	เอ​ลี​ฟัด
leuen	เล​อู​เอน
naahatc	นา​หัด
yeutc	เย​อูด
oholimbaamaa	โอ​โฮ​ลี​บา​มา
endom	เอ​โดม
sombaan	โซ​บาน
maanaahaatv	มา​นา​ฮ้าด
embaan	เอ​บาน
etcmbaan	เอด​บาน
itclaan	อิด​ลาน
ese	เอ​เซ
simbeon	สิ​เบ​โอน
endom	เอ​โดม
ndinhaambaa	ดิน​ฮา​บา
mbosaalaa	โบ​ซา​ลา
mbendatc	เบ​ดัด
moapc	โม​อับ
mindien	มี​เดียน
samxlaa	สัม​ลา
lehoxmbotc	เล​โห​โบด
saaun	ซา​อุน
akcmbo	อัก​โบ
mipvsaa	มิบ​ซา
lumben	ลู​เบน
yundaa	ยู​ดา
quaa	ชู​อา
eaa	เอ​อา
hipvlu	ฮิบ​ลู
naiaa	ไน​อา
hetvlon	เฮ้ด​โลน
yemuen	เย​มู​เอน
ohaatc	โอ​หาด
kohaatv	โค​ฮ้าด
melaali	เม​ลา​ลี
itcsaaxkaa	อิด​สา​คา
sembulun	เส​บู​ลุน
yaaleen	ยา​เล​เอน
hakvgi	ฮัก​กี
etcmbon	เอด​โบน
elei	เอ​เล​อี
aaleli	อา​เล​ลี
itcwaa	อิด​วา
itcwi	อิด​วี
mbeliyaa	เบ​ลี​ยา
selaaaa	เซ​ลา​อา
hembe	เฮ​เบ
atcmben	อัด​เบน
naaaamaan	นา​อา​มาน
yaasien	ยา​ซี​เอน
maanatvse	มะ​นัด​เส
efaaim	เอ​ฟา​อิม
jorndaen	จอ​แดน
lipvni	ลิบ​นี
simei	ซิ​เม​อี
itchaa	อิด​ฮา
sikcli	สิก​ลี
utcsien	อุด​ซี​เอน
misaaen	มิ​ซา​เอน
ensaafaan	เอน​ซา​ฟาน
naandapc	นา​ดับ
itaamaa	อิ​ทา​มา
atcsi	อัด​สี
enkaanaa	เอน​คา​นา
eleaasaa	เอ​เล​อา​ซา
finehatc	ฟี​เน​หัด
sukckotv	สุก​โค้ด
aambipc	อา​บีบ
lefindim	เล​ฟี​ดิม
huaa	ฮู​อา
yosuwaa	โย​ซู​วา
aambihu	อา​บี​ฮู
kelumbim	เค​ลู​บิม
mbesaalen	เบ​ซา​เลน
yembutc	เย​บุด
oholiapc	โอ​โฮ​ลี​อับ
selomitv	เซ​โล​มิด
suxlisatvndai	สู​ลิ​ซัด​ได
selumien	เซ​ลู​มิ​เอน
amminaandapc	อัม​มี​นา​ดับ
zuaa	ฒู​อา
netanen	เน​ทัน​เอน
eliapc	เอ​ลี​อับ
ammihutv	อัม​มี​ฮู้ด
elisaamaa	เอ​ลี​ซา​มา
bendaasu	เป​ดา​ซู
gaamaalien	กา​มา​ลิ​เอน
gindeoni	กิ​เด​โอ​นี
aambindan	อา​บี​ดัน
aahiyese	อา​หิ​เย​เซ
baagien	ปา​กี​เอน
ndeuen	เด​อู​เอน
eliyaasaapc	เอ​ลี​ยา​สาบ
aahilaa	อา​หิ​ลา
elisaafaan	เอ​ลี​ซา​ฟาน
maanaa	มา​นา
sakcge	สัก​เก
sammuwaa	ซัม​มุ​วา
yefunne	เย​ฟุน​เน
igaan	อิ​กาน
hoseyaa	โฮ​เซ​ยา
mikaaen	มี​คา​เอน
aambilam	อา​บี​ลัม
melimbaa	เม​ลี​บา
kaandetc	คา​เดด
hoaa	โฮ​อา
sihonx	สิ​โหน
hetvmbon	เฮ้ด​โบน
sipcbo	สิบ​โป
mbaalaaam	บา​ลา​อัม
mbaaan	บา​อัน
mbeo	เบ​โอ
beo	เป​โอ
simxli	สิม​ลี
kotvmbi	โค้ด​บี
suxaa	สู​อา
otcni	โอด​นี
atclien	อัด​ลี​เอน
semindaa	เซ​มิ​ดา
selofehatc	เส​โล​เฟ​หัด
maahaalaa	มา​ฮา​ลา
hokvlaa	โฮ้ก​ลา
tilaasaa	ที​ละ​ซา
suham	ซู​ฮัม
gileaatc	กิ​เล​อาด
maakile	มา​คี​เล
aambaalim	อา​บา​ลิม
lembaa	เล​บา
mikvndon	มิก​โดน
lipvnaa	ลิบ​นา
taahatc	ทา​หัด
yotvmbaataa	โย้ด​บา​ทา
ombotc	โอ​โบด
nembo	เน​โบ
atcmon	อัด​โมน
mendidelenien	เม​ดิ​เต​เล​เนียน
sendatc	เส​ดัด
mbukcki	บุก​คี
hannien	ฮัน​นี​เอน
kemuen	เค​มู​เอน
bantien	ปัน​ที​เอน
aahihutv	อา​หิ​ฮู้ด
endeni	เอ​เดน​อี
atctaalotv	อัด​ทา​โล้ด
yaahaatv	ยา​ฮ้าด
aangopc	อาน​โกบ
saindorn	ไซ​ดอน
aalaambaa	อา​ลา​บา
bitcgaa	ปิด​กา
gelisim	เก​ลิ​ซิม
laahapc	ลา​หับ
gingaan	กิน​กาน
yeliko	เย​ลี​โค
sapcndi	สับ​ดี
gimbeon	กิ​เบ​โอน
mbeelotv	เบ​เอ​โล้ด
yelusaalem	เย​ลู​ซา​เลม
ekclon	เอก​โลน
ndembi	เด​บี
aasekaa	อา​เซ​คา
makvkendaa	มัก​เค​ดา
aiyaalon	ไอ​ยา​โลน
yaambin	ยา​บิน
maandon	มา​โดน
akcsaapv	อัก​ซ้าบ
mitvbaa	มิด​ปา
aandunlam	อา​ดุน​ลัม
tapvbuwaa	ทับ​ปู​วา
megitcndo	เม​กิด​โด
kendetc	เค​เดด
yokvneam	โย้ก​เน​อัม
maaaakaa	มา​อา​คา
saaxlekaa	สา​เล​คา
kendemotv	เค​เด​โม้ด
mefaaaatc	เม​ฟา​อาด
mbaaaalaa	บา​อา​ลา
timnaahaa	ทิม​นา​ฮา
akcsaax	อัก​สา
otcnien	โอด​นี​เอน
sipcaa	สิบ​อา
mbeaalotv	เบ​อา​โล้ด
molaandaa	โม​ลา​ดา
entolatv	เอน​โท​ลัด
sikclaakv	สิก​ล้าก
matvmannaa	มัด​มัน​นา
mbotckaatv	โบด​ค้าด
ete	เอ​เท
atcnaa	อัด​นา
etctemoaa	เอด​เท​โม​อา
maaon	มา​โอน
yitvleen	ยิด​เล​เอน
gendo	เก​โด
aataalotv	อา​ทา​โล้ด
naaaalaa	นา​อา​ลา
apcwim	อับ​วิม
ofaalaa	โอ​ฟา​ลา
kision	คี​ซิ​โอน
embetc	เอ​เบด
kinneletv	คิน​เน​เล้ด
etctaaon	เอด​ทา​โอน
ekolon	เอ​โค​โลน
enteke	เอน​เท​เค
gipcmbeton	กิบ​เบ​โทน
mbaaaalatv	บา​อา​ลัด
aahimaan	อา​หิ​มาน
akcsipv	อัก​ซี้บ
lehopc	เล​โหบ
ehutv	เอ​ฮู้ด
ndembolaa	เด​โบ​ลา
aambinoam	อา​บี​โน​อัม
taambo	ทา​โบ
siselaa	สิ​เส​ลา
gindeon	กิ​เด​โอน
yoaatc	โย​อาด
aambiyese	อา​บี​เย​เซ
zembaa	เฒ​บา
sanxmunnaa	สัน​มุน​นา
benuen	เป​นู​เอน
mbee	เบ​เอ
sembun	เส​บุน
gaaan	กา​อัน
tembetc	เท​เบด
jaai	จา​อี
yepvtaa	เย้บ​ทา
aaloe	อา​โล​เอ
mbetclehem	เบด​เล​เฮม
bilaaton	ปิ​ลา​โทน
apcndon	อับ​โดน
maanoaa	มา​โน​อา
saemsanx	แซม​สัน
ndelilaa	เด​ลิ​ลา
laaitc	ลา​อิด
gimbeaa	กิ​เบ​อา
naaomi	นา​โอ​มี
elimelekv	เอ​ลี​เม​เล้ก
lute	ลู​เท
kilion	คิ​ลิ​โอน
mboaatc	โบ​อาด
sanxmon	สัน​โมน
ombetc	โอ​เบด
jetcsi	เจียด​ซี
hopvni	โฮ้บ​นี
beninnaa	เป​นิน​นา
saamuen	ซา​มู​เอน
atcndotc	อัด​โดด
aambinaandapc	อา​บี​นา​ดับ
yaambetc	ยา​เบด
naahaatc	นา​หาด
mikvmaatv	มิก​ม้าด
suan	ซู​อัน
yonaataan	โย​นา​ทาน
aahiyaa	อา​หิ​ยา
apcne	อับ​เน
aambien	อา​บี​เอน
goliatc	โก​ลิ​อัด
saaaalaaim	ซา​อา​ลา​อิม
aahimelekv	อา​หิ​เม​เล้ก
ndoekc	โด​เอก
aahitupv	อา​หิ​ทู้บ
aambiyaataa	อา​บี​ยา​ทา
keilaa	เค​อี​ลา
naambaan	นา​บาน
aambigaayin	อา​บี​กา​ยิน
aahinoam	อา​หิ​โน​อัม
seluyaa	เส​ลุ​ยา
yoaapc	โย​อาบ
aambiqai	อา​บี​ไช
ginmboaa	กิน​โบ​อา
keleti	เค​เล​ที
yaatvti	ย้าด​ที
yelaameen	เย​ลา​เม​เอน
itcmbosetv	อิด​โบ​เซ้ด
maahaanaaim	มา​หะ​นา​อิม
aasaaxhen	อา​สา​เฮน
aandoniyaa	อา​โด​นี​ยา
hakvgitc	ฮัก​กีด
sefaatiyaa	เซ​ฟา​ทิ​ยา
gitctaaim	กิด​ทา​อิม
mbaaaanaa	บา​อา​นา
saalomorn	ซา​โล​มอน
ipchaa	อิบ​ฮา
elisuwaa	เอ​ลี​ซู​วา
eliyaandaa	เอ​ลี​ยา​ดา
elifeletv	เอ​ลี​เฟ​เล้ด
gembaa	เก​บา
utcsaa	อุด​ซา
sindaa	สี​ดา
sombaa	โส​บา
haandatcese	ฮา​ดัด​เอ​เซ
yufeditc	ยู​เฟ​ติด
yehoyaandaa	เย​โฮ​ยา​ดา
mbenaiyaa	เบ​ไน​ยา
simbaa	ซิ​บา
mefimbosetv	เม​ฟี​โบ​เซ้ด
mbatcqembaa	บัด​เช​บา
uliaa	อุ​ลี​อา
lapvmbaa	ลับ​บา
apcsaalom	อับ​ซา​โลม
yonaandapc	โย​นา​ดับ
tekoaa	เท​โค​อา
itctai	อิด​ไท
saaxndokc	สา​โดก
aahimaaatc	อา​หิ​มา​อัด
aahitofen	อา​หิ​โท​เฟน
mbaasinlai	บา​ซิน​ไล
aamaasaax	อา​มา​สา
mbikcli	บีก​ลี
ilaa	อิ​ละ
aiaa	ไอ​อา
litvbaa	ลิด​ปา
simehaa	ซี​เม​ฮา
aahoxhai	อา​โห​ไฮ
ndondo	โด​โด
enhaanan	เอน​ฮา​นัน
heletvte	เฮ​เล้ด​เท
ikcketc	อิก​เขด
aanaatotv	อา​นา​โท้ด
netofaa	เน​โท​ฟา
maahaalai	มา​หะ​ไล
limbai	ลี​ไบ
gaaatc	กา​อัด
mbaahulim	บา​ฮู​ลิม
atcmaawetv	อัด​มา​เว้ด
aahiyam	อา​หิ​ยัม
hetvlo	เฮ้ด​โล
naahaalai	นา​หะ​ไล
itclai	อิด​ไล
uliyaa	อุ​ลี​ยา
aalaaunaa	อา​ลาว​นา
aambiqaakv	อา​บี​ช้าก
aasaaliyaa	อา​ซา​ลิ​ยา
aahilutv	อา​หิ​ลู้ด
itcndo	อิด​โด
yehosaafatv	เย​โฮ​ซา​ฟัด
lembaanorn	เล​บา​นอน
aandonilam	อา​โด​นี​ลัม
sion	สิ​โอน
gaalili	กา​ลิ​ลี
taabenetv	ทา​เป​เน้ด
yelomboam	เย​โล​โบ​อัม
lehoxmboam	เล​โห​โบ​อัม
aambiyaa	อา​บี​ยา
nembatc	เน​บัด
aambiyam	อา​บี​ยัม
aambiqaalom	อา​บี​ชา​โลม
mbaaaaqaa	บา​อา​ชา
saamaalie	สะ​มา​เลีย
aahapc	อา​หับ
aaselaa	อา​เซ​ลา
eliyaa	เอ​ลี​ยา
ombaandi	โอ​บา​ดี
yesemben	เย​เซ​เบน
yehu	เย​ฮู
elisaa	เอ​ลี​ซา
haasaaen	ฮา​ซา​เอน
naambotc	นา​โบด
mikaayaa	มี​คา​ยา
aahatcyaa	อา​หัด​ยา
sinhi	ซิน​หิ
aasumbaa	อา​ซุ​บา
yeholam	เย​โฮ​ลัม
gehaasi	เก​หะ​ซี
yehoaahaatc	เย​โฮ​อา​หาด
aataaliyaa	อา​ทา​ลิ​ยา
yehoaatc	เย​โฮ​อาด
aamaasiyaa	อา​มา​ซิ​ยา
sekaaliyaa	เส​คา​ลิ​ยา
utcsiyaa	อุด​ซี​ยา
gaandi	กา​ดี
menaahem	เม​นา​เฮม
atcsilie	อัด​ซี​เลีย
bekaahiyaa	เป​คา​หิ​ยา
lemaaliyaa	เล​มา​ลิ​ยา
aahatc	อา​หัด
kiaa	คี​อา
mindie	มี​เดีย
mbaambilon	บา​บี​โลน
sefaanwaaim	เส​ฟาน​วา​อิม
hesekiyaa	เฮ​เซ​คี​ยา
sennaakelipv	เซน​นา​เค​ลิบ
isaayaa	อิ​สะ​ยา
ipcwaa	อิบ​วา
yosiyaa	โย​สิ​ยา
aandaayaa	อา​ดา​ยา
mesunlaam	เม​ซุน​ลาม
aasaalaiyaa	อา​ซา​ไล​ยา
hinkiyaa	ฮิน​คี​ยา
aahikam	อา​หิ​คัม
aasaaxyaa	อา​สา​ยา
hunndaa	ฮุน​ดา
kitclon	ขิด​โลน
haamutaan	ฮา​มุ​ทาน
yelemi	เย​เล​มี
lipvlaa	ลิบ​ลา
yehoyaakim	เย​โฮ​ยา​คิม
bendaayaa	เป​ดา​ยา
yehoyaakin	เย​โฮ​ยา​คีน
ennaatan	เอน​นา​ทัน
sendekiyaa	เส​เด​คี​ยา
matvsaax	มัด​สา
mitvsaa	มิด​ซา
mbinhaan	บิน​ฮาน
saaxwaan	สา​วาน
matvlekaa	มัด​เล​คา
makvndien	มัก​ดี​เอน
ilaam	อิ​ลาม
ndaanndaa	ดาน​ดา
yete	เย​เท
aambihaain	อา​บี​ฮา​อิน
itci	อิด​อี
akclai	อัก​ไล
saaxmbaatc	สา​บาด
eleaasaax	เอ​เล​อา​สา
yekaamiyaa	เย​คา​มิ​ยา
efaa	เอ​ฟา
saaapc	ซา​อับ
simeaa	ซิ​เม​อา
selupvmbaamben	เส​ลุบ​บา​เบน
haananyaa	ฮา​นัน​ยา
mbelekiyaa	เบ​เล​คิ​ยา
belaatiyaa	เป​ลา​ที​ยา
yesaayaa	เย​ซา​ยา
lefaiyaa	เล​ไฟ​ยา
sekaaniyaa	เซ​คา​นิ​ยา
semaiaa	เซ​ไม​อา
hatvtatv	ฮัด​ทัด
neaaliyaa	เน​อา​ลี​ยา
elionai	เอ​ลี​โอ​ไน
atclikam	อัด​ลี​คัม
hondaawiyaa	โฮ​ดา​วิ​ยา
eliyaasipv	เอ​ลี​ยา​ซี้บ
belaiyaa	เป​ไล​ยา
akckupc	อัก​ขูบ
yohaanan	โย​ฮา​นัน
ndelaiyaa	เด​ไล​ยา
leaayaa	เล​อา​ยา
yaahaatc	ยา​หาด
itcmaa	อิด​มา
baaseaa	ปา​เส​อา
selaiaa	เส​ไล​อา
etclaa	เอด​ลา
maahaalaalen	มา​หะ​ลา​เลน
metuselaa	เม​ทู​เส​ลา
isakc	อี​สัก
haandatc	ฮา​ดัด
yundaa	ยู​ดา
amminaandapc	อัม​มี​นา​ดับ
sanxmon	สัน​โมน
ombetc	โอ​เบด
jaai	จา​อี
yehu	เย​ฮู
lehoxmboam	เล​โห​โบ​อัม
aambiyaa	อา​บี​ยา
aamaasiyaa	อา​มา​ซิ​ยา
aasaaliyaa	อา​ซา​ลิ​ยา
aahatc	อา​หัด
hesekiyaa	เฮ​เซ​คี​ยา
yehoyaakin	เย​โฮ​ยา​คีน
selupvmbaamben	เส​ลุบ​บา​เบน
yesaayaa	เย​ซา​ยา
lefaiyaa	เล​ไฟ​ยา
ombaandi	โอ​บา​ดี
semaiaa	เซ​ไม​อา
yaahaatc	ยา​หาด
maalesaa	มา​เล​ซา
gendelaa	เก​เด​ลา
nemuen	เน​มู​เอน
mipvsamx	มิบ​สัม
sakcge	สัก​เก
yoen	โย​เอน
aasien	อา​สิ​เอน
aandien	อา​ดี​เอน
yendaayaa	เย​ดา​ยา
gileaatc	กิ​เล​อาด
mikaaen	มี​คา​เอน
aahi	อา​หิ
elien	เอ​ลี​เอน
finehatc	ฟี​เน​หัด
aambiquwaa	อา​บี​ชู​วา
mbukcki	บุก​คี
utcsi	อุด​ซี
selaahiyaa	เส​ลา​หิ​ยา
selaahiyaa	เส​ลา​หิ​ยา
melaayotv	เม​ลา​โย้ด
aamaaliyaa	อา​มา​ลิ​ยา
aamaaliyaa	อา​มา​ลิ​ยา
saaxndokc	สา​โดก
hinkiyaa	ฮิน​คี​ยา
yehosaandakc	เย​โฮ​ซา​ดัก
nembukatvnetvsaa	เน​บู​คัด​เน้ด​ซา
simxmaa	สิม​มา
yoaa	โย​อา
enkaanaa	เอน​คา​นา
embiyaasaapc	เอ​บี​ยา​สาบ
embiyaasaapc	เอ​บี​ยา​สาบ
taahatc	ทา​หัด
ulien	อุ​ลี​เอน
utcsiyaa	อุด​ซี​ยา
eliapc	เอ​ลี​อับ
yeloham	เย​โล​ฮัม
yeloham	เย​โล​ฮัม
simeaa	ซิ​เม​อา
maahaatv	มา​ฮ้าด
aamaasaix	อา​มา​ไส
yoen	โย​เอน
sefanyaa	เส​ฟัน​ยา
atcsi	อัด​สี
itchaa	อิด​ฮา
kohaatv	โค​ฮ้าด
mbelekiyaa	เบ​เล​คิ​ยา
mankiyaa	มัน​คิ​ยา
simxmaa	สิม​มา
apcndi	อับ​ดี
haasaabiyaa	ฮา​ซา​ปิ​ยา
haasaabiyaa	ฮา​ซา​ปิ​ยา
melaali	เม​ลา​ลี
utcsi	อุด​ซี
melaayotv	เม​ลา​โย้ด
ndaambelatv	ดา​เบ​ลัด
puaa	พู​อา
yendiyaaen	เย​ดี​ยา​เอน
yelimotv	เย​ลี​โม้ด
yelemotv	เย​เล​โม้ด
aalemetv	อา​เล​เม้ด
kenaaaanaa	เค​นา​อะ​นา
hupcbim	หุบ​ปิม
supvbim	ซุบ​ปิม
taahan	ทา​ฮัน
laandaan	ลา​ดาน
laandaan	ลา​ดาน
mankien	มัน​คี​เอน
yaafeletv	ยา​เฟ​เล้ด
some	โซ​เม
atcndaa	อัด​ดา
enbaaan	เอน​ปา​อัน
aahiyo	อา​หิ​โย
sembaandiyaa	เส​บา​ดิ​ยา
ende	เอ​เด
yohaa	โย​ฮา
sinxletai	สิน​เล​ไท
yeien	เย​อี​เอน
simxli	สิม​ลี
mbineaa	บิ​เน​อา
mbineaa	บิ​เน​อา
eleaasaax	เอ​เล​อา​สา
mbokelu	โบ​เค​ลู
seaaliyaa	เซ​อา​ลิ​ยา
isaalaaen	อิ​สะ​ลา​เอน
yeuen	เย​อู​เอน
sanxlu	สัน​ลู
hatcsenuaa	หัด​เส​นู​อา
mesunlaam	เม​ซุน​ลาม
sefaatiyaa	เซ​ฟา​ทิ​ยา
leuen	เล​อู​เอน
aandaayaa	อา​ดา​ยา
baatche	ปาด​เฮ
baatche	ปาด​เฮ
mankiyaa	มัน​คิ​ยา
matvtaaniyaa	มัด​ทา​นิ​ยา
sikcli	สิก​ลี
yendutun	เย​ดู​ทูน
yendutun	เย​ดู​ทูน
mikvlotv	มิก​โล้ด
yembutc	เย​บุด
sipcmbekai	สิบ​เบ​ไค
saaanmbon	ซา​อัน​โบน
eliyaambaa	เอ​ลี​ยา​บา
uaa	อู​อา
itclai	อิด​ไล
yaaaasien	ยา​อา​ซี​เอน
semaaliyaa	เซ​มา​ลิ​ยา
itcsiyaa	อิด​ซี​ยา
aasaalen	อา​ซา​เลน
yaasombeam	ยา​โซ​เบ​อัม
aambiqai	อา​บี​ไช
selomotv	เซ​โล​โม้ด
miyaamin	มิ​ยา​มิน
hakvkotc	ฮัก​โขด
yesuaa	เย​ซู​อา
mbingaa	บิน​กา
betaahiyaa	เป​ทา​หิ​ยา
maaaasiyaa	มา​อา​ซิ​ยา
yaaaasiyaa	ยา​อา​ซี​ยา
gendaaliyaa	เก​ดา​ลิ​ยา
matvtitiyaa	มัด​ที​ทิ​ยา
sembuen	เซ​บู​เอน
haanaani	ฮา​นา​นี
yehohaanan	เย​โฮ​ฮา​นัน
henndai	เฮน​ได
elihu	เอ​ลี​ฮู
itcmaiaa	อิด​ไม​อา
saalomorn	ซา​โล​มอน
yapvfaa	ยับ​ฟา
kelumbim	เค​ลู​บิม
isaalaaen	อิ​สะ​ลา​เอน
saalomorn	ซา​โล​มอน
yelomboam	เย​โล​โบ​อัม
maahaalatv	มา​หะ​ลัด
yelusaalem	เย​ลู​ซา​เลม
yundaa	ยู​ดา
ondetc	โอ​เดด
mbaaaaqaa	บา​อา​ชา
yehosaafatv	เย​โฮ​ซา​ฟัด
netaaniyaa	เน​ทา​นิ​ยา
tombiyaa	โท​บี​ยา
yehosaambaatc	เย​โฮ​ซา​บาด
aahapc	อา​หับ
yaahaasien	ยา​ฮา​ซี​เอน
sekaaliyaa	เส​คา​ลิ​ยา
mbenaiyaa	เบ​ไน​ยา
aahatcyaa	อา​หัด​ยา
yeholam	เย​โฮ​ลัม
yehien	เย​ฮี​เอน
etiobie	เอ​ที​โอ​เปีย
yehu	เย​ฮู
yehoyaandaa	เย​โฮ​ยา​ดา
simeatc	ซิ​เม​อัด
yehoaatc	เย​โฮ​อาด
yekoliyaa	เย​โค​ลี​ยา
filisaadie	ฟี​ลิ​สะ​เตีย
maaaaseaa	มา​อา​เส​อา
mesinlemotv	เม​ซิน​เล​โม้ด
maanatvse	มะ​นัด​เส
yosaambaatc	โย​ซา​บาด
yoaahaatc	โย​อา​หาด
yelemi	เย​เล​มี
haanditc	ฮา​ดิด
senaaaa	เส​นา​อา
aantaasesitv	อาน​ทา​เซ​ซี้ด
mitvlendaatc	มิด​เล​ดาด
ndaaliatc	ดา​ลิ​อัด
hakvgai	ฮัก​ไก
aahitupv	อา​หิ​ทู้บ
aambiquwaa	อา​บี​ชู​วา
eleaasaa	เอ​เล​อา​ซา
esaalaa	เอ​สะ​ลา
aahaawaa	อา​หะ​วา
esaalaa	เอ​สะ​ลา
sapvmbetai	ซับ​เบ​ไท
kelitaa	เค​ลิ​ทา
melemotv	เม​เล​โม้ด
matvtenai	มัด​เท​ไน
selemiyaa	เซ​เล​มิ​ยา
haakaaliyaa	ฮา​คา​ลิ​ยา
nehaami	เน​หะ​มี
sanxmbaanlatv	สัน​บาน​ลัด
tombiaa	โท​บี​อา
mesesaamben	เม​เซ​ซา​เบน
yoyaandaa	โย​ยา​ดา
haasapvneyaa	ฮา​ซับ​เน​ยา
hatcsupv	หัด​ซู้บ
hanlohetc	ฮัน​โล​เหด
lehum	เล​ฮูม
sapcmbai	สับ​ไบ
hatcsupv	หัด​ซู้บ
henaandatc	เฮ​นา​ดัด
tombiaa	โท​บี​อา
mondekai	โม​เด​ไค
mbikcwai	บิก​ไว
katcmien	ขัด​มี​เอน
qembaaniyaa	เช​บา​นี​ยา
selebiyaa	เซ​เล​ปี​ยา
hondiyaa	โฮ​ดี​ยา
ndaanien	ดา​นี​เอน
ginneton	กิน​เน​โทน
batclotv	ปัด​โล้ด
satctu	สัด​ทู
atcgaatc	อัด​กาด
mbembai	เบ​ไบ
aandin	อา​ดีน
aate	อา​เท
yaatvnduwaa	ย้าด​ดู​วา
aanaayaa	อา​นา​ยา
sanxlai	สัน​ไล
yoyaalipv	โย​ยา​ลิบ
atclikam	อัด​ลี​คัม
sihaqc	สี​หะ
seantien	เซ​อัน​ทิ​เอน
yoyaakim	โย​ยา​คิม
yonaataan	โย​นา​ทาน
minyaamin	มิน​ยา​มิน
hosaayaa	โฮ​ซา​ยา
matvtaaniyaa	มัด​ทา​นิ​ยา
mikaayaa	มี​คา​ยา
eliyaakim	เอ​ลี​ยา​คิม
aahaasuelatv	อา​หะ​สุ​เอ​ลัด
inndie	อิน​เดีย
watvqaati	วัด​ชา​ที
yekoniyaa	เย​โค​นี​ยา
mondekai	โม​เด​ไค
esete	เอ​เซ​เท
esete	เอ​เซ​เท
esete	เอ​เซ​เท
kenndie	เคน​เดีย
lewiaataan	เล​วี​อา​ทาน
mbinndatc	บิน​ดัด
naaaame	นา​อา​เม
elihu	เอ​ลี​ฮู
mbehemotv	เบ​เฮ​โม้ด
lembaanorn	เล​บา​นอน
gembaan	เก​บาน
menkisendekc	เมน​คี​เซ​เดก
jorndaen	จอ​แดน
efaataa	เอ​ฟา​ทา
itien	อิ​ที​เอน
itien	อิ​ที​เอน
anman	อัน​มัน
ndaamatvgatc	ดา​มัด​กัด
efaaim	เอ​ฟา​อิม
mbaambilon	บา​บี​โลน
moapc	โม​อับ
naiaa	ไน​อา
iyipv	อี​ยิบ
atcsilie	อัด​ซี​เลีย
sepvnaa	เซ้บ​นา
aalien	อา​ลี​เอน
aalien	อา​ลี​เอน
sion	สิ​โอน
isaayaa	อิ​สะ​ยา
faangensen	ฟาน​เกน​เซน
mbaaan	บา​อัน
mankiaa	มัน​คี​อา
yosiyaa	โย​สิ​ยา
sindaa	สี​ดา
atckelon	อัด​เค​โลน
uliaa	อุ​ลี​อา
gemaaliyaa	เก​มา​ลิ​ยา
kolaayaa	โค​ลา​ยา
nehelaam	เน​เฮ​ลาม
sefanyaa	เส​ฟัน​ยา
sendekiyaa	เส​เด​คี​ยา
kenndie	เคน​เดีย
neliyaa	เน​ลิ​ยา
koniyaa	โค​นิ​ยา
yehukan	เย​ฮู​คัน
mbenyaamin	เบน​ยา​มิน
matvtaan	มัด​ทาน
kaaleaa	คา​เล​อา
tanhumetv	ทัน​หุ​เม้ด
kaaleaa	คา​เล​อา
gendaaliyaa	เก​ดา​ลิ​ยา
taabaanhetc	ทา​ปาน​เหด
kiliyaataaim	คี​ลิ​ยา​ทา​อิม
ndimbon	ดี​โบน
endom	เอ​โดม
endom	เอ​โดม
mbaambilon	บา​บี​โลน
nembukatvnetvsaa	เน​บู​คัด​เน้ด​ซา
kembaa	เค​บา
yaaaasanyaa	ยา​อา​ซัน​ยา
oholaa	โอ​โฮ​ลา
oholimbaa	โอ​โฮ​ลี​บา
etiobie	เอ​ที​โอ​เปีย
home	โฮ​เม
ndaanien	ดา​นี​เอน
mbentesatvsaa	เบน​เท​ซัด​ซา
satvlakv	ซัด​ลัก
aambetcnego	อา​เบด​เน​โก
aambetcnego	อา​เบด​เน​โก
mbensatvsaa	เบน​ซัด​ซา
gaambelien	กา​เบ​เลียน
hoseyaa	โฮ​เซ​ยา
keliotc	เค​ลิ​โอด
gingaan	กิน​กาน
finisie	ฟี​นี​เซีย
saaxlefatv	สา​เล​ฟัด
ninaawe	นิ​นะ​เว
naahum	นา​ฮูม
limbie	ลิ​เบีย
haambaagukc	ฮา​บา​กุก
yosuwaa	โย​ซู​วา
hetvlon	เฮ้ด​โลน
mboaatc	โบ​อาด
jetcsi	เจียด​ซี
eliyaakim	เอ​ลี​ยา​คิม
maaliyaa	มา​ลี​ยา
maaliyaa	มา​ลี​ยา
imaanuen	อี​มา​นู​เอน
yundie	ยู​เดีย
naasaaletv	นา​ซา​เล้ด
naasaaletv	นา​ซา​เล้ด
yohan	โย​ฮัน
yohan	โย​ฮัน
yohan	โย​ฮัน
sembendi	เส​เบ​ดี
totvmbuli	โท้ด​บุ​ลี
mbaatolomiu	บา​โท​โล​มิว
matvtaai	มัด​ทาย
anfeatc	อัน​เฟ​อัด
tatvndeatc	ทัด​เด​อัด
yundaatc	ยู​ดาด
isaakaaliotc	อิ​สะ​คา​ลิ​โอด
faalisi	ฟา​ลิ​สี
faalisi	ฟา​ลิ​สี
mbeensembun	เบ​เอน​เซ​บูน
helondietc	เฮ​โล​เดียด
saandusi	สะ​ดู​สี
saandusi	สะ​ดู​สี
mbetaani	เบ​ทา​นี
kaayaafaatv	คา​ยา​ฟ้าด
yundaatc	ยู​ดาด
mbaalapvmbatc	บา​ลับ​บัด
mbaalapvmbatc	บา​ลับ​บัด
laamaasaambakctaani	ลา​มา​ซา​บัก​ทา​นี
makvndaalaa	มัก​ดา​ลา
anndaalu	อัน​ดา​ลู
kaabenaaum	คา​เป​นา​อุม
mbetcsaindaa	เบด​ไซ​ดา
hosaanaa	โฮ​ซา​นา
aalekvsaannde	อา​เล้ก​ซาน​เด
elisaambetc	เอ​ลี​ซา​เบด
matvtatv	มัด​ทัด
matvtatv	มัด​ทัด
matvtaatiatc	มัด​ทา​ที​อัด
matvtaatiatc	มัด​ทา​ที​อัด
eaa	เอ​อา
simeon	สิ​เม​โอน
apclaaham	อับ​ลา​ฮัม
naaho	นา​โฮ
leu	เล​อู
embe	เอ​เบ
aanfaasatv	อาน​ฟา​ซัด
aandam	อา​ดัม
gelaasaa	เก​ลา​ซา
saamaalie	สะ​มา​เลีย
gaalili	กา​ลิ​ลี
siloam	สี​โล​อัม
laasaalatv	ลา​ซา​ลัด
sakckietv	สัก​เคี้ยด
naataanaaen	นา​ทา​นา​เอน
nikondematv	นี​โค​เด​มัด
laasaalatv	ลา​ซา​ลัด
laasaalatv	ลา​ซา​ลัด
yundaatc	ยู​ดาด
aanaanie	อา​นา​เนีย
aanaanie	อา​นา​เนีย
saatefen	สะ​เท​เฟน
antiokc	อัน​ที​โอก
nikolau	นี​โค​เลา
aineatc	ไอ​เน​อัด
litvndaa	ลิด​ดา
koneliatc	โค​เน​ลิ​อัด
koneliatc	โค​เน​ลิ​อัด
sisaaliyaa	ซี​ซา​ลี​ยา
mbaanaambatc	บา​นา​บัด
mbaanaambatc	บา​นา​บัด
ikoniyum	อี​โค​นี​ยูม
maasindonie	มา​ซี​โด​เนีย
tesaalonigaa	เท​สะ​โล​นิ​กา
timotai	ทิ​โม​ไท
kolinto	โค​ลิน​โท
kaalitvbatc	คะ​ลิด​ปัด
ganlio	กัน​ลิ​โอ
aakaayaa	อา​คา​ยา
efeso	เอ​เฟ​โซ
bitcsinxlaa	ปิด​สิน​ลา
aakuinlaa	อา​ควิน​ลา
aaborlo	อา​ปอ​โล
aantemitv	อาน​เท​มิด
ndemetvliatc	เด​เม้ด​ลิ​อัด
mbeloaa	เบ​โล​อา
aalitvtaakatv	อา​ลิด​ทา​คัด
gaaiatc	กาย​อัด
tikigatc	ที​คิ​กัด
dofimatv	โต​ฟี​มัด
doatc	โต​อัด
silisie	ซี​ลี​เซีย
kaalaaundiatc	คา​ลาว​ดิ​อัด
fesaatatv	เฟ​สะ​ทัด
fesaatatv	เฟ​สะ​ทัด
aanqipaa	อา​ฆี​พา
aanqipaa	อา​ฆี​พา
apclaaham	อับ​ลา​ฮัม
lusiatc	ลู​สิ​อัด
saatefaanatv	สะ​เท​ฟา​นัด
aaborlo	อา​ปอ​โล
maasindonie	มา​ซี​โด​เนีย
ebaafaa	เอ​ปา​ฟา
laundisie	เลา​ดี​เซีย
himeneatc	ฮี​เม​เน​อัด
gaalaatie	กา​ลา​เทีย
onesifolatv	โอ​เน​สิ​โฟ​ลัด
elatvtatv	เอ​ลัด​ทัด
miletatv	มิ​เล​ทัด
filemon	ฟี​เล​โมน
onesimatv	โอ​เน​สิ​มัด
mbaalaaam	บา​ลา​อัม
kaain	คา​อิน
ilaatv	อิ​ล้าด
mehuxyaaen	เม​หู​ยา​เอน
metusaaen	เม​ทู​ซา​เอน
yaambaan	ยา​บาน
yaambaan	ยา​บาน
yumbaan	ยู​บาน
yumbaan	ยู​บาน
aalaalatv	อา​ลา​ลัด
kaanaaan	คา​นา​อัน
akckatv	อัก​คัด
lehoxmbotci	เล​โห​โบด​อี
batclusimx	ปัด​ลุ​สิม
katvluhim	คัด​ลู​ฮิม
kapvtolim	คับ​โท​ลิม
gegaasi	เก​กา​ซี
apclaam	อับ​ลาม
apclaam	อับ​ลาม
apclaam	อับ​ลาม
sondom	โส​โดม
amlaafen	อัม​ลา​เฟน
enlaasaax	เอน​ลา​สา
aaliokc	อา​ลี​โอก
tindaan	ทิ​ดาน
enbaalaan	เอน​ปา​ลาน
tindaan	ทิ​ดาน
amlaafen	อัม​ลา​เฟน
enlaasaax	เอน​ลา​สา
aaleokc	อา​เล​โอก
katcmonai	ขัด​โม​ไน
isaamaaen	อิ​สะ​มา​เอน
gomolaa	โก​โม​ลา
mbenammi	เบน​อัม​มี
mbenammi	เบน​อัม​มี
aambimelekv	อา​บี​เม​เล้ก
mbeeqembaa	เบ​เอ​เช​บา
mbetuen	เบ​ทู​เอน
leumaa	เล​อู​มา
tembaa	เท​บา
gaaham	กา​ฮัม
taahaatc	ทา​หาด
hitvtai	ฮิด​ไท
efolon	เอ​โฟ​โลน
makvbelaa	มัก​เป​ลา
laambaan	ลา​บาน
lembekaa	เล​เบ​คา
lembekaa	เล​เบ​คา
ketulaa	เค​ทู​ลา
simxlaan	สิม​ลาน
mendaan	เม​ดาน
itcmbaakc	อิด​บาก
ndendaan	เด​ดาน
aambindaa	อา​บี​ดา
enndaaaa	เอน​ดา​อา
nembaayotv	เน​บา​โย้ด
kendaa	เค​ดา
atcmbeen	อัด​เบ​เอน
isakc	อี​สัก
esekc	เอ​เสก
sitcnaa	สิด​นา
aahutcsatv	อา​หุด​ซัด
isakc	อี​สัก
qimbaa	ชี​บา
leaa	เล​อา
leaa	เล​อา
mbinhaa	บิน​ฮา
benien	เป​นี​เอน
efaalaataa	เอ​ฟา​ลา​ทา
lumben	ลู​เบน
sei	เส​อี
oholimbaamaa	โอ​โฮ​ลี​บา​มา
yombapc	โย​บับ
samxlaa	สัม​ลา
muyorc	มู​หย่อ
botifaa	โป​ทิ​ฟา
botifelaa	โป​ทิ​เฟ​ลา
aasenatv	อา​เส​นัด
saaun	ซา​อุน
sifiyon	สิ​ฟิ​โยน
sipcbolaa	สิบ​โป​ลา
sipcbolaa	สิบ​โป​ลา
yokembetc	โย​เค​เบด
yokembetc	โย​เค​เบด
eliqembaa	เอ​ลี​เช​บา
iyipv	อี​ยิบ
lefindim	เล​ฟี​ดิม
isaalaaen	อิ​สะ​ลา​เอน
mbesaalen	เบ​ซา​เลน
itcsaaxkaa	อิด​สา​คา
sembulun	เส​บู​ลุน
aase	อา​เซ
napvtaali	นับ​ทา​ลี
suxlien	สู​ลิ​เอน
maanaa	มา​นา
enndaatc	เอน​ดาด
mendaatc	เม​ดาด
hembolon	เฮ​โบ​โลน
soan	โส​อัน
aamaalekv	อา​มา​เล้ก
aambilam	อา​บี​ลัม
hoaa	โฮ​อา
hoaa	โฮ​อา
waahepv	วา​เฮ้บ
mbee	เบ​เอ
matvtaanaa	มัด​ทา​นา
naahaalien	นา​หะ​ลี​เอน
hetvmbon	เฮ้ด​โบน
sihonx	สิ​โหน
hetvmbon	เฮ้ด​โบน
mbaalaaam	บา​ลา​อัม
mbaalaaam	บา​ลา​อัม
mbaalaaam	บา​ลา​อัม
mbaalaaam	บา​ลา​อัม
aalo	อา​โล
saaxlu	สา​ลู
beo	เป​โอ
nemuen	เน​มู​เอน
hakvgi	ฮัก​กี
otcni	โอด​นี
elei	เอ​เล​อี
aaleli	อา​เล​ลี
puaa	พู​อา
yaaleen	ยา​เล​เอน
maakile	มา​คี​เล
maakile	มา​คี​เล
gileaatc	กิ​เล​อาด
iyese	อี​เย​เซ
iyese	อี​เย​เซ
atclien	อัด​ลี​เอน
semindaa	เซ​มิ​ดา
sutelaa	ซู​เท​ลา
sutelaa	ซู​เท​ลา
taahan	ทา​ฮัน
sutelaa	ซู​เท​ลา
atcmben	อัด​เบน
aahilam	อา​หิ​ลัม
aahilam	อา​หิ​ลัม
sefufaam	เซ​ฟู​ฟาม
naaaamaan	นา​อา​มาน
suham	ซู​ฮัม
itcwi	อิด​วี
mbeliyaa	เบ​ลี​ยา
hembe	เฮ​เบ
mankien	มัน​คี​เอน
yaaseen	ยา​เซ​เอน
yaaseen	ยา​เซ​เอน
eleaasaa	เอ​เล​อา​ซา
ndofaakaa	โด​ฟะ​คา
litvsaax	ลิด​สา
kehelaataa	เค​เฮ​ลา​ทา
haalaandaa	ฮา​ลา​ดา
makvhelotv	มัก​เฮ​โล้ด
mitvkaa	มิด​คา
hatvmonaa	ฮัด​โม​นา
sanxmonaa	สัน​โม​นา
yeliko	เย​ลี​โค
mendidelenien	เม​ดิ​เต​เล​เนียน
haasaalenan	ฮา​ซา​เล​นัน
yaaaakan	ยา​อา​คัน
moselaa	โม​เส​ลา
gutcgondaa	กุด​โก​ดา
aambipc	อา​บีบ
mesobodemie	เม​โส​โป​เต​เมีย
yesulun	เย​ซู​ลุน
yesulun	เย​ซู​ลุน
laahapc	ลา​หับ
aalaambaa	อา​ลา​บา
yosuwaa	โย​ซู​วา
jorndaen	จอ​แดน
gimbeon	กิ​เบ​โอน
makvkendaa	มัก​เค​ดา
lipvnaa	ลิบ​นา
ekclon	เอก​โลน
mbaaan	บา​อัน​กาด
yapvmborkc	ยับ​บอก
sihox	ซิ​โห
meaalaa	เม​อา​ลา
mendembaa	เม​เด​บา
mendembaa	เม​เด​บา
hembolon	เฮ​โบ​โลน
aakclapvmbim	อาก​ลับ​บิม
sikvkelon	ซิก​เค​โลน
yapvneen	ยับ​เน​เอน
otcnien	โอด​นี​เอน
kapcseen	ขับ​เซ​เอน
lembaaotc	เล​บา​โอด
sinhim	ซิน​ฮิม
aanditaaim	อา​ดี​ทา​อิม
gendelotaaim	เก​เด​โล​ทา​อิม
mbetcen	เบด​เอน
maalean	มา​เล​อัน
ndapcmbesetv	ดับ​เบ​เซ้ด
katcdaatc	ขัด​ตาด
naahaalaan	นา​หะ​ลาน
indaalaa	อิ​ดา​ลา
kesunxlotv	เค​สุน​โล้ด
embon	เอ​โบน
maahaalaapv	มา​หะ​ล้าบ
aamolai	อา​โม​ไล
seelaa	เซ​เอ​ลา
ehutv	เอ​ฮู้ด
ehutv	เอ​ฮู้ด
ehutv	เอ​ฮู้ด
seilaa	เส​อี​ลา
ehutv	เอ​ฮู้ด
ndembolaa	เด​โบ​ลา
ndembolaa	เด​โบ​ลา
siselaa	สิ​เส​ลา
siselaa	สิ​เส​ลา
yaaen	ยา​เอน
yaaen	ยา​เอน
siselaa	สิ​เส​ลา
yaaen	ยา​เอน
yaaen	ยา​เอน
yaaen	ยา​เอน
yaaen	ยา​เอน
siselaa	สิ​เส​ลา
yaaen	ยา​เอน
mindien	มี​เดียน
mindien	มี​เดียน
gindeon	กิ​เด​โอน
gindeon	กิ​เด​โอน
gindeon	กิ​เด​โอน
gindeon	กิ​เด​โอน
mbetcmbaalaaaa	เบด​บา​ลา​อา
mbetcmbaalaaaa	เบด​บา​ลา​อา
sanxmunnaa	สัน​มุน​นา
nombaa	โน​บา
yokvmbehaa	โย้ก​เบ​ฮา
sukckotv	สุก​โค้ด
sanxmunnaa	สัน​มุน​นา
aalumaa	อา​ลู​มา
gaaan	กา​อัน
sembun	เส​บุน
gaaan	กา​อัน
aalumaa	อา​ลู​มา
yepvtaa	เย้บ​ทา
yepvtaa	เย้บ​ทา
yepvtaa	เย้บ​ทา
yepvtaa	เย้บ​ทา
mitvbaa	มิด​ปา
yepvtaa	เย้บ​ทา
yepvtaa	เย้บ​ทา
yepvtaa	เย้บ​ทา
qipvmboletv	ชิบ​โบ​เล้ด
sipcmboletv	สิบ​โบ​เล้ด
apcndon	อับ​โดน
maanoaa	มา​โน​อา
maanoaa	มา​โน​อา
maanoaa	มา​โน​อา
timnaahaa	ทิม​นา​ฮา
saemsanx	แซม​สัน
saemsanx	แซม​สัน
saemsanx	แซม​สัน
ndelilaa	เด​ลิ​ลา
mbetclehem	เบด​เล​เฮม
etctaaon	เอด​ทา​โอน
gimbeaa	กิ​เบ​อา
gimbeaa	กิ​เบ​อา
mbenyaamin	เบน​ยา​มิน
naaomi	นา​โอ​มี
naaomi	นา​โอ​มี
naaomi	นา​โอ​มี
mboaatc	โบ​อาด
mboaatc	โบ​อาด
laamaataaim	ลา​มา​ทา​อิม
tohu	โท​หุ
tohu	โท​หุ
beninnaa	เป​นิน​นา
saamuen	ซา​มู​เอน
saamuen	ซา​มู​เอน
saamuen	ซา​มู​เอน
saamuen	ซา​มู​เอน
saamuen	ซา​มู​เอน
saamuen	ซา​มู​เอน
saamuen	ซา​มู​เอน
saamuen	ซา​มู​เอน
saamuen	ซา​มู​เอน
embenese	เอ​เบน​เอ​เซ
filisaadie	ฟี​ลิ​สะ​เตีย
ikaambotc	อี​คา​โบด
mbekolatv	เบ​โค​ลัด
mbekolatv	เบ​โค​ลัด
aafiyaa	อา​ฟี​ยา
hipvlu	ฮิบ​ลู
aahiyaa	อา​หิ​ยา
yonaataan	โย​นา​ทาน
aahimelekv	อา​หิ​เม​เล้ก
aahimelekv	อา​หิ​เม​เล้ก
heletvti	เฮ​เล้ด​ที
aambiyaataa	อา​บี​ยา​ทา
keilaa	เค​อี​ลา
keilaa	เค​อี​ลา
haakilaa	ฮา​คี​ลา
yesimon	เย​ซิ​โมน
naambaan	นา​บาน
naambaan	นา​บาน
naambaan	นา​บาน
aambigaayin	อา​บี​กา​ยิน
naambaan	นา​บาน
naambaan	นา​บาน
aambigaayin	อา​บี​กา​ยิน
apcne	อับ​เน
apcne	อับ​เน
itcmbosetv	อิด​โบ​เซ้ด
yoaapc	โย​อาบ
aasaaxhen	อา​สา​เฮน
aasaaxhen	อา​สา​เฮน
yoaapc	โย​อาบ
mbeelotv	เบ​เอ​โล้ด
haandatcese	ฮา​ดัด​เอ​เซ
haandatcese	ฮา​ดัด​เอ​เซ
toi	โท​อี
simbaa	ซิ​บา
simbaa	ซิ​บา
mefimbosetv	เม​ฟี​โบ​เซ้ด
sombakc	โซ​บัก
uliaa	อุ​ลี​อา
uliaa	อุ​ลี​อา
yendindiyaa	เย​ดี​ดิ​ยา
lapvmbaa	ลับ​บา
apcsaalom	อับ​ซา​โลม
apcsaalom	อับ​ซา​โลม
aahitofen	อา​หิ​โท​เฟน
aamaasaax	อา​มา​สา
itctaalaa	อิด​ทา​ลา
itctaalaa	อิด​ทา​ลา
aahimaaatc	อา​หิ​มา​อัด
aahimaaatc	อา​หิ​มา​อัด
mefimbosetv	เม​ฟี​โบ​เซ้ด
mbaasinlai	บา​ซิน​ไล
mbaasinlai	บา​ซิน​ไล
kimhaam	คิม​ฮาม
mbikcli	บีก​ลี
sapcbe	สับ​เป
aalaaunaa	อา​ลาว​นา
aalaaunaa	อา​ลาว​นา
aandoniyaa	อา​โด​นี​ยา
mbatcqembaa	บัด​เช​บา
mbatcqembaa	บัด​เช​บา
mbatcqembaa	บัด​เช​บา
gihon	กี​โฮน
gihon	กี​โฮน
aandoniyaa	อา​โด​นี​ยา
aambiqaakv	อา​บี​ช้าก
mbenaiyaa	เบ​ไน​ยา
simei	ซิ​เม​อี
simei	ซิ​เม​อี
eliholepv	เอ​ลี​โฮ​เล้บ
saaxmbutc	สา​บุด
aahiqaa	อา​หิ​ชา
gembe	เก​เบ
tipvsaax	ทิบ​สา
maaho	มา​โฮ
aalaambie	อา​ละ​เบีย
kue	คู​เอ
kue	คู​เอ
saalomorn	ซา​โล​มอน
taabenetv	ทา​เป​เน้ด
genumbatc	เก​นู​บัด
selendaa	เส​เล​ดา
seluwaa	เส​ลุ​วา
yelomboam	เย​โล​โบ​อัม
aambiyam	อา​บี​ยัม
aambiyam	อา​บี​ยัม
mbaaaaqaa	บา​อา​ชา
hien	ฮี​เอน
titvmbi	ทิด​บี
titvmbi	ทิด​บี
saaxlefatv	สา​เล​ฟัด
eliyaa	เอ​ลี​ยา
eliyaa	เอ​ลี​ยา
eliyaa	เอ​ลี​ยา
yesemben	เย​เซ​เบน
haasaaen	ฮา​ซา​เอน
elisaa	เอ​ลี​ซา
elisaa	เอ​ลี​ซา
naambotc	นา​โบด
gehaasi	เก​หะ​ซี
yesemben	เย​เซ​เบน
yehu	เย​ฮู
aataaliyaa	อา​ทา​ลิ​ยา
yoaatc	โย​อาด
yosaakaa	โย​ซา​คา
yehoaahaatc	เย​โฮ​อา​หาด
yehoaahaatc	เย​โฮ​อา​หาด
yehoatcndin	เย​โฮ​อัด​ดิน
yokvteen	โย้ก​เท​เอน
bekaahiyaa	เป​คา​หิ​ยา
yelusaa	เย​ลู​ซา
ndaamatvgatc	ดา​มัด​กัด
saamaalie	สะ​มา​เลีย
atcsilie	อัด​ซี​เลีย
tilaahaakaa	ที​ละ​หะ​คา
mesunlemetv	เม​ซุน​เล​เม้ด
yotvmbaa	โย้ด​บา
nembukatvnetvsaa	เน​บู​คัด​เน้ด​ซา
nembusaalaandaan	เน​บู​ซา​ละ​ดาน
nembusaalaandaan	เน​บู​ซา​ละ​ดาน
nembusaalaandaan	เน​บู​ซา​ละ​ดาน
lipvlaa	ลิบ​ลา
kapvto	คับ​โท
yokvtaan	โย้ก​ทาน
mbatcsuwaa	บัด​ซู​วา
huaa	ฮู​อา
maaatc	มา​อัด
aambiqu	อา​บี​ชู
saaxsaa	สา​ซา
yaalaahaa	ยา​ละ​ฮา
atctai	อัด​ไท
saaxmbaatc	สา​บาด
sembe	เซ​เบ
tilaahaanaa	ที​ละ​หะ​นา
tilaatai	ทิ​ลา​ไท
haananyaa	ฮา​นัน​ยา
neaaliyaa	เน​อา​ลี​ยา
sombaan	โซ​บาน
naaaalaa	นา​อา​ลา
aahutcsaam	อา​หุด​ซาม
temeni	เท​เม​นี
haaaahatctaali	ฮา​อา​หัด​ทา​ลี
sombembaa	โส​เบ​บา
aahaanxhen	อา​หาน​เฮน
yaambetc	ยา​เบด
naaham	นา​ฮัม
maaaakatv	มา​อา​คัด
kosembaa	โค​เซ​บา
mitvmaa	มิด​มา
meunim	เม​อู​นิม
ziaa	ฒี​อา
yohaanan	โย​ฮา​นัน
lipvni	ลิบ​นี
atcsi	อัด​สี
aahimotv	อา​หิ​โม้ด
naahatc	นา​หัด
lipvni	ลิบ​นี
toaa	โท​อา
aamaasaix	อา​มา​ไส
mbileam	บิ​เล​อัม
limmono	ลิม​โม​โน
yelien	เย​ลี​เอน
ipcsamx	อิบ​สัม
isaalaahiyaa	อิ​สะ​ลา​หิ​ยา
isaalaahiyaa	อิ​สะ​ลา​หิ​ยา
ilaqv	อี​ละ
aahe	อา​เฮ
mbendaan	เบ​ดาน
eleaandaa	เอ​เล​อา​ดา
eleaandaa	เอ​เล​อา​ดา
eleatc	เอ​เล​อัด
elisaamaa	เอ​ลี​ซา​มา
naaaalan	นา​อา​ลัน
enbaaan	เอน​ปา​อัน
mitvam	มิด​อัม
mikvlotv	มิก​โล้ด
aasaaxyaa	อา​สา​ยา
hatcsenuaa	หัด​เส​นู​อา
kole	โค​เล
meselemiyaa	เม​เซ​เล​มิ​ยา
hakvmoni	ฮัก​โม​นี
yosaambaatc	โย​ซา​บาด
enpeletv	เอน​เพ​เล้ด
kusaayaa	คู​ซา​ยา
aalaamotv	อา​ลา​โม้ด
tou	โท​อู
saawaasaa	ซา​วะ​ซา
naahaatc	นา​หาด
sipcbai	สิบ​ไป
sembuen	เซ​บู​เอน
yendeyaa	เย​เด​ยา
selomotv	เซ​โล​โม้ด
itcsiyaa	อิด​ซี​ยา
soham	โซ​ฮัม
ipcli	อิบ​ลี
aaqaalelaa	อา​ชา​เล​ลา
sumbaaen	ซู​บา​เอน
lefaaen	เล​ฟา​เอน
semaakiyaa	เส​มา​คิ​ยา
lehapcyaa	เล​หับ​ยา
lehapcyaa	เล​หับ​ยา
ammisaambaatc	อัม​มี​ซะ​บาด
aasaasiyaa	อา​ซา​ซิ​ยา
sitvlai	ซิด​ไล
atclai	อัด​ไล
moliyaa	โม​ลิ​ยา
sukiim	สุ​คี​อิม
aambiyaa	อา​บี​ยา
aamatvyaa	อา​มัด​ยา
mikaayaa	มี​คา​ยา
yeluen	เย​ลู​เอน
aahatcyaa	อา​หัด​ยา
yehoyaandaa	เย​โฮ​ยา​ดา
aahatc	อา​หัด
yehuen	เย​ฮู​เอน
yelusaalem	เย​ลู​ซา​เลม
aasaasiyaa	อา​ซา​ซิ​ยา
itcsaamaakiyaa	อิด​สะ​มา​คิ​ยา
yosiyaa	โย​สิ​ยา
yoaahaatc	โย​อา​หาด
mitvlendaatc	มิด​เล​ดาด
setvmbatcsaa	เซ้ด​บัด​ซา
setvmbatcsaa	เซ้ด​บัด​ซา
leelaiyaa	เล​เอ​ไล​ยา
sakckai	สัก​ไค
aandonikam	อา​โด​นี​คัม
gipcmbaa	กิบ​บา
haatitaa	ฮา​ทิ​ทา
sombai	โซ​ไบ
haasuxfaa	ฮา​สู​ฟา
tapvmbaaotc	ทับ​บา​โอด
siaahaa	สี​อา​ฮา
paandon	พา​โดน
lembaanaa	เล​บา​นา
haagaambaa	ฮา​กา​บา
gitcnden	กิด​เดน
gaahaa	กา​ฮา
nekondaa	เน​โค​ดา
gatcsaam	กัด​ซาม
nefisimx	เน​ฟิ​สิม
mbakcmbukc	บัก​บูก
haakufaa	ฮา​คู​ฟา
haanhu	ฮาน​ฮู
mbatclutv	บัด​ลู้ด
mehindaa	เม​หิ​ดา
nesiyaa	เน​ซิ​ยา
haatifaa	ฮา​ทิ​ฟา
hatcsofeletv	หัด​โส​เฟ​เล้ด
belundaa	เป​ลุ​ดา
yaaaalaa	ยา​อา​ลา
gitcnden	กิด​เดน
nekondaa	เน​โค​ดา
esaanxhatvndon	เอ​สาน​ฮัด​โดน
yosaandakc	โย​ซา​ดัก
kaasifie	คา​สิ​เฟีย
maaaaseaa	มา​อา​เส​อา
elaasaax	เอ​ลา​สา
laamiyaa	ลา​มี​ยา
aasisaa	อา​ซี​ซา
sean	เซ​อัน
itcsijaa	อิด​ซี​จา
qimeon	ชี​เม​โอน
matvtatvdaa	มัด​ทัด​ตา
yelemai	เย​เล​ไม
maaaandai	มา​อา​ได
uen	อู​เอน
sembinaa	เส​บิ​นา
yaatvndai	ย้าด​ได
haanhaayaa	ฮาน​ฮา​ยา
haamibaakatv	ฮา​มี​ปา​คัด
tombiaa	โท​บี​อา
hesekiyaa	เฮ​เซ​คี​ยา
hondaawiyaa	โฮ​ดา​วิ​ยา
siaa	สี​อา
nefusesimx	เน​ฟู​เซ​สิม
mbatclitv	บัด​ลี้ด
sofeletv	โส​เฟ​เล้ด
belindaa	เป​ลี​ดา
hatvmbatcndaanaa	ฮัด​บัด​ดา​นา
aasanyaa	อา​ซัน​ยา
hondiyaa	โฮ​ดี​ยา
aataayaa	อา​ทา​ยา
yoetc	โย​เอด
yoetc	โย​เอด
bendaayaa	เป​ดา​ยา
kolaayaa	โค​ลา​ยา
belaaliyaa	เป​ลา​ลิ​ยา
belaaliyaa	เป​ลา​ลิ​ยา
aamaatvsaix	อา​ม้าด​ไส
akcsai	อัก​ไซ
akcsai	อัก​ไซ
mesinlemotv	เม​ซิน​เล​โม้ด
hakcgendolim	หัก​เก​โด​ลิม
mekonaa	เม​โค​นา
yesuaa	เย​ซู​อา
milaalai	มิ​ลา​ไล
gilaalai	กิ​ลา​ไล
maaai	มา​ไอ
haandaasaa	ฮา​ดา​ซา
hammendaataa	ฮัม​เม​ดา​ทา
hammendaataa	ฮัม​เม​ดา​ทา
haanmbonaa	ฮาน​โบ​นา
mbaalaaken	บา​ลา​เคน
zaayin	ฒา​ยิน
saamekv	ซา​เม้ก
zaande	ฒา​เด
muyorc	มู​หย่อ
selaafim	เส​ลา​ฟิม
yembelekiyaa	เย​เบ​เล​คี​ยา
aalaambie	อา​ละ​เบีย
belaasim	เป​ลา​ซิม
aanaatotv	อา​นา​โท้ด
mbaambilon	บา​บี​โลน
haananen	ฮา​นัน​เอน
haanamen	ฮา​นัม​เอน
annaatotv	อัน​นา​โท้ด
haanamen	ฮา​นัม​เอน
haambaasinyaa	ฮา​บา​ซิน​ยา
gemaaliyaa	เก​มา​ลิ​ยา
yehundi	เย​ฮู​ดี
yehoyaakim	เย​โฮ​ยา​คิม
kenndie	เคน​เดีย
netaaniyaa	เน​ทา​นิ​ยา
mbaaaasaa	บา​อา​ซา
netaaniyaa	เน​ทา​นิ​ยา
heliombuli	เฮ​ลี​โอ​บุ​ลี
lindie	ลิ​เดีย
moapc	โม​อับ
kendaa	เค​ดา
melaataaim	เม​ลา​ทา​อิม
sendekiyaa	เส​เด​คี​ยา
qoaa	โช​อา
koaa	โค​อา
siene	สิ​เอ​เน
haamonaa	ฮา​โม​นา
melimbatc	เม​ลิ​บัด​คา​เดด
mbentesatvsaa	เบน​เท​ซัด​ซา
gaambelien	กา​เบ​เลียน
yitvleen	ยิด​เล​เอน
efaaim	เอ​ฟา​อิม
betuen	เป​ทุ​เอน
sakckutv	สัก​คุด
molesetv	โม​เล​เซ้ด
tembetc	เท​เบด
yehosaandakc	เย​โฮ​ซา​ดัก
hatclaakv	หัด​ล้าก
maalaaki	มา​ลา​คี
gaandaalaa	กา​ดา​ลา
matvtaai	มัด​ทาย
helondietc	เฮ​โล​เดียด
gennesaaletv	เกน​เน​ซา​เล้ด
maagaandaan	มา​กา​ดาน
filipvpoi	ฟี​ลิบ​พอย
getcsemaani	เกด​เส​มา​นี
aalimaatie	อา​ลิ​มา​เทีย
faalisi	ฟา​ลิ​สี
ndaanmaanutaa	ดาน​มา​นู​ทา
teofilatv	เท​โอ
orgatcdatc	ออ​กัด​ตัด
gelaasaa	เก​ลา​ซา
mbeensembun	เบ​เอน​เซ​บูน
sakckietv	สัก​เคี้ยด
emmaautc	เอม​มา​อูด
lapvmbi	ลับ​บี
lapvmbi	ลับ​บี
timbelietv	ทิ​เบ​เลี้ยด
siloam	สี​โล​อัม
isaayaa	อิ​สะ​ยา
lapvmboni	ลับ​โบ​นี
kapvbaandosie	คับ​ปา​โด​เซีย
faalijie	ฟา​ลี​เจีย
bamfilie	ปัม​ฟี​เลีย
idaali	อิ​ตา​ลี
koneliatc	โค​เน​ลิ​อัด
antiokc	อัน​ที​โอก
mbaalaasaatatv	บะ​ละ​สะ​ทัด
nige	นี​เก
maanaaen	มา​นา​เอน
maanaaen	มา​นา​เอน
selukie	เซ​ลู​เคีย
saalaamitv	ซา​ลา​มิด
mbaayesu	บา​เย​ซู
mbaayesu	บา​เย​ซู
sejiatc	เส​จี​อัด
sejiatc	เส​จี​อัด
bisindie	ปิ​สิ​เดีย
lisaadaa	ลิ​สะ​ตา
timotai	ทิ​โม​ไท
filipvpoi	ฟี​ลิบ​พอย
aalekvsaanndelie	อา​เล้ก​ซาน​เด​เลีย
aantemitv	อาน​เท​มิด
torlemi	ทอ​เล​มี
maanaasanx	มะ​นา​สัน
maanaasanx	มะ​นา​สัน
antibaadi	อัน​ทิ​ปา​ตี
ndusinxlaa	ดู​สิน​ลา
atclaamitvtiyum	อัด​ลา​มิด​ทิ​ยุม
kaanindatc	คา​นี​ดัด
sanxmone	สัน​โม​เน
kaaundaa	คาว​ดา
morndaa	มอน​ตา
apcbiatc	อับ​ปี​อัด
apclaaham	อับ​ลา​ฮัม
inlilikum	อิน​ลี​ลี​คุม
fembi	เฟ​บี
kenkelie	เคน​เค​เลีย
ebenetatv	เอ​เป​เน​ทัด
anndonikatv	อัน​โด​นิ​คัด
yuniatc	ยู​นี​อัด
ampaaliaatatv	อัม​พะ​ลี​อา​ทัด
umbaanatv	อู​บา​นัด
saataakitv	สะ​ทา​คิด
helondion	เฮ​โล​ดิ​โอน
naasitvsatc	นา​ซิด​สัด
aasinxkitatv	อา​สิน​คี​ทัด
faalegon	ฟะ​เล​โกน
batclombatc	ปัด​โล​บัด
kaantatv	คาน​ทัด
sosaatenetv	โส​สะ​เท​เน้ด
kaaloe	คะ​โล​เอ
aaletatv	อา​เล​ทัด
kolosi	โค​โล​สี
hielaambuli	ฮี​เอ​ลา​บุ​ลี
laundisie	เลา​ดี​เซีย
aakaayaa	อา​คา​ยา
loitc	โล​อิด
onesifolatv	โอ​เน​สิ​โฟ​ลัด
kaanbatc	คาน​ปัด
yumbulatv	ยู​บู​ลัด
bunden	ปู​เดน
kaalaaundie	คา​ลาว​เดีย
aantemaatv	อาน​เท​ม้าด
nikombuli	นิ​โค​บุ​ลี
apcfie	อับ​เฟีย
aankipvbatc	อาน​คิบ​ปัด
filemon	ฟี​เล​โมน
mbitinie	บิ​ที​เนีย
ndemetvliatc	เด​เม้ด​ลิ​อัด
saamenaa	สะ​เม​นา
begaamam	เป​กา​มัม
filaandenfie	ฟี​ลา​เดน​เฟีย
siangyelusaalem	เซียงเย​ลู​ซา​เลม
aambatcndon	อา​บัด​โดน
aaborliyon	อา​ปอ​ลิ​โยน
janxtaiv	จั๋นไท้
tinhungh	ทินฮู่ง
cingnzengc	ธีงเหฑ่ง
jauvlouc	เจ๊าโหล่ว
ndaundiev	เดาเดี๊ย
niembung	เนียบูง
saengkuv	แซงคู้
ndaamvlungh	ด๊ามลู่ง
dornjueiv	ตอนเจว๊ย
funfaqv	ฟุนฟะ
ndaubeih	เดาเป้ย
nyungcnyungc	หญู่งๆ
laimaeng	ไลแมง
laimiev	ไลเมี้ย
zeivfun	เฒ้ยฟุน
mbiungcsuivimx	บยู่งซุ้ยอิ๋ม
waaceix	หว่าเอ๋ย
fingxfingx	ฝีงๆ
deicbung	เต่ยปูง
funfaqv	ฟุนฟะ
gongzoh	กงโฒ่
ziecdorngh	เหฒี่ยต้อง
hnyangxjeiv	หฮญังเจ๊ย
zanczanc	หฒั่นๆ
ndiangxlomc	เดี๋ยงหล่ม
ndopvliuh	ด๊บลิ่ว
camvdauh	ธั้มเต้า
jaadingh	จาตี้ง
wuomkuotv	ววมค้วด
lomchuaang	หล่มฮวาง
finmienh	ฟินเมี่ยน
tinhungh	ทินฮู่ง
leizfingx	เล์ยฝีง
miucfangx	หมิ่วฝัง
luihoux	ลุยโหว
muozdoic	มั์วต่อย
dornhlo	ตอนโฮล
baengbieiv	แปงเปย๊ย
youzlaai	โย์วลาย
mbiouzmbiouz	เบี์ยวๆ
wuommueic	ววมเหมว่ย
winwangv	วินวั้ง
luindaauv	ลุยด๊าว
ndautouv	เดาโท้ว
koivhlen	ค้อยเฮลน
nzangvbouc	ฑั้งโป่ว
gapvjaaix	กั๊บจ๋าย
jangxhoc	จั๋งโห่
leizlatc	เล์ยหลัด
tinhunghyie	ทินฮู่งเยีย
deicbunghuaang	เต่ยปูงฮวาง
ongdaa	องตา
siqvhongc	ซิห่ง
ndiemuonc	เดียหม่วน
labieivsiqv	หละเปย๊ยซิ
jaadorngx	จาต๋อง
feixbung	เฝยปูง
ndaamvziecdorngh	ด๊ามเหฒี่ยต้อง
labieivjaaix	หละเปย๊ยจ๋าย
ndiangxzaangc	เดี๋ยงหฒั่ง
buozdauh	ปั์วเต้า
labieivbenv	หละเปย๊ยเป๊น
fusux	ฟูสู
jiemfinx	เจียมฝิน
saengyietv	แซงเยี้ยด
mbuonvmuonc	บ๊วนหม่วน
caqvbouc	ธะโป่ว
leiznyeic	เล์ยเหญ่ย
orvmbiorngz	อ๊อบย์อง
gorqvmienh	เก๊าะเมี่ยน
hunglouh	ฮูงโล่ว
niemor	เนียมอ
wuomsui	ววมซุย
hnoinyieqc	ฮนอยเหญียะ
janxdaic	จั๋นไต่
jaasic	จาสี่
nziemxyaangh	เหฑียมย่าง
biaavmbiaac	ปย๊าบย่า
ongtaaix	องถาย
nyeizsiqv	เญ์ยซิ
buozndoqv	ปั์วโด๊ะ
ndaubaengh	เดาแป้ง
doixngaanc	ต๋อยหง่าน
wuonbaengc	ววนแป่ง
muozsieqv	มั์วเซียะ
leizbaaix	เล์ยป๋าย
jouxjoux	โจ๋วๆ
auvguaav	เอ๊ากว๊า
auvleih	เอ๊าเล่ย
buozndiev	ปั์วเดี๊ย
deicjaaix	เต่ยจ๋าย
maanzhmuangx	ม์านหฮมวัง
maazcie	ม์าเธีย
wuomdaaih	ววมต้าย
gorxyouz	ก๋อโย์ว
jauvhlen	เจ๊าเฮลน
cungaeng	ธุนแกง
doixdiuc	ต๋อยติ่ว
borngbuoz	ปองปั์ว
mbongaiv	บงไอ๊
mbongjuoqv	บงจั๊วะ
fingxbienx	ฝีงเปี๋ยน
koivnzauv	ค้อยเฑ้า
dueivmueiz	เตว๊ยเมว์ย
koivcongx	ค้อยหธง
wuomzingv	ววมฒี้ง
caqvbouc	ธะโป่ว
ndaamvfingx	ด๊ามฝีง
taaixbaengh	ถายแป้ง
normnorm	นอมๆ
mbaengxngaamh	แบ๋งง่าม
mbaengxkuotv	แบ๋งค้วด
hnyangxdaauh	หฮญังต้าว
jaavzeih	จ๊าเฒ่ย
sieqvlaangh	เซียะล่าง
cienceqv	เธียนเธะ
ganaaivcenv	กะน้ายเธ้น
dornfaix	ตอนไฝ
butvzoih	ปุ๊ดฒ่อย
fusux	เม่ย
juangzinx	จวังหฒิน
houxhlaang	โหวฮลาง
junbaeng	จุนแปง
njienyouh	เฌียนโย่ว
cincin	ธินๆ
waancwaanc	หว่านๆ
waancwaanc	หว่านๆ
nyei	เต่ยปูงฮวาง
doixngaanc	ต๋อยหง่าน
nziaamvfei	ฑย้ามเฟย
ndopvliuh	ด๊บลิ่ว
congmengh	ธงเม่ง
mbongningv	บงนี้ง
biouvnqaai	เปี๊ยวฆาย
ndopvmbuoqc	ด๊บบัวะ
soubiuv	โซวปิ๊ว
soudaan	โซวตาน
saengvziouv	แซ้งเฒี้ยว
gongmienh	กงเมี่ยน
bungbung	ปูงๆ
zauxndiev	เหฒาเดี๊ย
hnaangxdieh	หฮนางเตี้ย
zorngzuqv	ฒองฒุ
diuvzaanv	ติ๊วฒ้าน
baengguanh	แปงกวั้น
sieqvfaix	เซียะไฝ
ndiecou	เดียโธว
hlohlo	โฮลๆ
faixfaix	ไฝๆ
saengziepc	แซงเหฒียบ
saengjuov	แซงจั๊ว
dorndiex	ตอนเตี๋ย
buonvdeic	ป๊วนเต่ย
labieivzaangc	หละเปย๊ยหฒั่ง
fiuvlaangz	ฟิ้วล์าง
baengciangv	แปงเธี้ยง
jiemtorngvbaaih	เจียมท้องป้าย
fiuvdaanh	ฟิ้วต้าน
mbuovmaeng	บั๊วแมง
labieivmuonc	หละเปย๊ยหม่วน
labieivmau	หละเปย๊ยเมา
ndormndorm	ดอมๆ
muonzmuonz	ม์วนๆ
sianghlaax	เซียงหฮลา
njanglaangc	ฌังหล่าง
siangceix	เซียงเหธย
cingjaa	ธีงจา
baengbeiv	แปงเป๊ย
nzouzinh	โฑวฒิ่น
hnyangxhnyangx	หฮญังๆ
siepvsiepv	เซี้ยบๆ
labieivdongc	หละเปย๊ยต่ง
buonvmungv	ป๊วนมู้ง
buonvlaangz	ป๊วนล์าง
aengx	เซียงเหลียบ
siangliepc	เจี์ย
camvhnyangx	ธั้มหฮญัง
gongzinh	กงฒิ่น
congmengh	ธงเม่ง
ornlorqc	ออนเหลาะ
fujueivfaix	ฝุเจว๊ยไฝ
hlauvndongh	เฮล้าด้ง
dorngxdaauh	ต๋องต้าว
gornbaengx	กอนแป๋ง
ndeicnqenx	เด่ยเหฆน
hlaaxnyieqc	หฮลาเหญียะ
nziaauxzunc	หฑยาวหฒุ่น
gornndoqv	กอนโด๊ะ
ndauhuaang	เดาฮวาง
ndaunzaaih	เดาฑ่าย
jaaxzinh	จ๋าฒิ่น
saengeix	แซงเอ๋ย
cangfou	ธังโฟว
congmengh	ธง
hnaangxnqaai	หฮนางฆาย
waacsapv	หว่าซับ
gaengzuangx	แกงหฒวัง
gorngvhemx	ก๊องเหม
gorngvbaeqc	ก๊องแปะ
cunciou	ธุนเธียว
ndiangxndongh	เดี๋ยงด้ง
siangmbuangz	เซียงบวั์ง
mueizdorngh	เมว์ยต้อง
mueizpengx	เมว์ยเผง
naangjieqv	นางเจี๊ยะ
kuotvndaangc	ค้วดด่าง
korvlienh	ค้อเลี่ยน
jopvnyeic	จ๊บเหญ่ย
ciedoix	เธียต๋อย
qouqou	โชวๆ
dangcov	ตังโธ้
gunguaazmbuoqc	กู้งว์าบัวะ
gongfim	กงฟิม
ndiangxnquaah	เดี๋ยงฆว่า
ndiangxgaaz	เดี๋ยงก์า
sounjunc	โซวหฌุ่น
forngndongh	ฟองด้ง
niezun	เนียฒุน
gornbuonv	กอนป๊วน
mievbiangh	เมี้ยเปี้ยง
mancmanc	หมั่นๆ
sieqvlunx	เซียะหลุน
cingnzengc	ธีงเหฑ่ง
jiemfangx	เจียมฝัง
hlaanghlopv	ฮลางฮลบ
zorngzengx	ฒองเหฒง
zuiznipc	ฒุ์ยหนิบ
janxzaqc	จั๋นหฒะ
jauvkuv	เจ๊าคู้
saengfeix	แซงเฝย
tindorngh	ทินต้อง
saigorx	ไซก๋อ
koivdorn	ค้อยตอน
ndormnziouv	ดอมเฑี้ยว
mbuonxjieqv	บ๋วนเจี๊ยะ
mbiungcnziaaux	บยู่งหฑยาว
poutong	โพวทง
huingxziouv	หฮวีงเฒี้ยว
maazli	มาลี
sieqvdorn	เซียะตอน
sianglaangh	เซียงล่าง
biauvngorh	เปย๊าง่อ
zouvgemh	โฒ้วเก้ม
waacbeiv	หว่าเป๊ย
cingjaayinh	ธีงจายิ่น
yiemtoi	เยียมทอย
hmeinquaah	เฮมยฆว่า
biaavbin	ปย๊าปิน
luindaauvluoqc	ลุยด๊าวหลัวะ
sunggunguaaz	ซูงกู้งว์า
jiubaang	จิวปาง
koivnzou	ค้อยโฑว
younzauh	โยวเฑ่า
janxgikc	จั๋นกีก
waaczaanc	หว่าหฒ่าน
waaccou	หว่าโธว
miucfangx	หมิ่วฝัง
kungxwaac	ขูงหว่า
gongzohyie	กงโฒ่เยีย
hnyouvzoih	เฮญี้ยวฒ่อย
gorxyouz	ก๋อ
longxlongx	หลงๆ
enzingh	เอนฒี่ง
finsaeng	ฟินแซง
gouvlaic	โก๊วไหล่
waachuv	หว่าฮู้
auvjaanx	เอ๊าจ๋าน
jienfouv	เจียนโฟ้ว
sianglungh	เซียงลู่ง
gingsou	กีงโซว
leizlatc	เล์ย
lozhnoi	โล์ฮนอย
jiembuozndoqvnzaeng	เจียมปั์วโด๊ะแฑง
luihouxhuv	ลุยโหวฮู้
jiemjaax	เจียมจ๋า
ndaamvnorm	ด๊ามนอม
biaavndorqc	ปย๊าเดาะ
siangnzung	เซียงฑูง
faangdaauh	ฟางต้าว
faangnqaaix	ฟางหฆาย
miucbiauv	หมิ่วเปย๊า
heihorngc	เฮยห่อง
bungxsing	ปู๋งซีง
bungxqiex	ปู๋งเฉีย
saaivndui	ซ้ายดุย
buozndoqvnzaeng	ปั์วโด๊ะแฑง
zauxhlen	เหฒาเฮลน
zaeqvziouv	แฒะเฒี้ยว
kungxmorngh	ขูงม่อง
huaaxnyinz	หฮวาญิ์น
ndaunqaai	เดาฆาย
deicbunghaanz	เต่ยปูงฮ์าน
hnoihnoi	ฮนอยๆ
cenghlo	เธงโฮล
aandam	อา​ดัม
haawaa	ฮา​วา
kaain	คา​อิน
aambaen	อา​แบน
enokv	เอ​โน้ก
laamekv	ลา​เม้ก
aandaa	อา​ดา
enotv	เอ​โน้ด
kenan	เค​นัน
maahaalaalen	มา​หะ​ลา​เลน
yaaletv	ยา​เล้ด
metuselaa	เม​ทู​เส​ลา
noyaa	โน​ยา
yaafetv	ยา​เฟ้ด
kaanaaan	คา​นา​อัน
gome	โก​เม
maagokc	มา​โกก
maandai	มา​ได
yaawaan	ยา​วาน
tumban	ทู​บัน
mesekv	เม​เซ้ก
tilaatv	ทิ​ล้าด
atckenatv	อัด​เค​นัด
lifaatv	ลี​ฟ้าด
togaanmaa	โท​กาน​มา
eliseaa	เอ​ลี​เซ​อา
taansitv	ทาน​ซิด
kitvtim	คิด​ทิม
londaanim	โล​ดา​นิม
iyipv	อี​ยิบ
sembaa	เส​บา
haawilaa	ฮา​วิ​ลา
sapctaa	สับ​ทา
laaaamaa	ลา​อา​มา
sapctekaa	สับ​เท​คา
qembaa	เช​บา
ndendaan	เด​ดาน
nimlotv	นิม​โล้ด
ninaawe	นิ​นะ​เว
lundim	ลู​ดิม
aanaamim	อา​นา​มิม
lehaambim	เล​หะ​บิม
napvtuhim	นับ​ทู​ฮิม
hiwai	ฮี​ไว
aankaa	อาน​คา
sini	สี​นี
elaam	เอ​ลาม
atcsu	อัด​ซู
aanfaasatv	อาน​ฟา​ซัด
lunde	ลู​เด
aalam	อา​ลัม
gete	เก​เท
qelaa	เช​ลา
embe	เอ​เบ
yokvtaan	โย้ก​ทาน
anmondatc	อัน​โม​ดัด
qelepv	เช​เล้บ
haasaanmaawetv	ฮา​ซาน​มา​เว้ด
yelaa	เย​ลา
haandolam	ฮา​โด​ลัม
usaan	อุ​ซาน
ndikclaa	ดิก​ลา
aambimaaen	อา​บี​มา​เอน
ofi	โอ​ฟี
yombapc	โย​บับ
mbaamben	บา​เบน
belekv	เป​เล้ก
leu	เล​อู
selukv	เส​ลุก
naaho	นา​โฮ
telaa	เท​ลา
apclaam	อับ​ลาม
haalaan	ฮา​ลาน
saalaai	ซา​ลาย
minkaa	มิน​คา
negepc	เน​เกบ
faalo	ฟา​โล
mbetcen	เบด​เอน
sondom	โส​โดม
gomolaa	โก​โม​ลา
atcmaa	อัด​มา
semboyim	เส​โบ​ยิม
mbelaa	เบ​ลา
soaa	โส​อา
taamaa	ทา​มา
aamaalekv	อา​มา​เล้ก
aamolai	อา​โม​ไล
sitcndim	สิด​ดิม
ndaamatvgatc	ดา​มัด​กัด
kendolaaome	เค​โด​ลา​โอ​เม
aane	อา​เน
etcko	เอด​โค
mamle	มัม​เล
torngvbaaih	ท้องป้าย
eliyese	เอ​ลี​เย​เซ
apclaaham	อับ​ลา​ฮัม
hitvtai	ฮิด​ไท
belitvsi	เป​ลิด​ซี
lefaaim	เล​ฟา​อิม
haagaa	ฮา​กา
isaamaaen	อิ​สะ​มา​เอน
saalaa	ซา​ลา
gelaaaa	เก​ลา​อา
aambimelekv	อา​บี​เม​เล้ก
isakc	อี​สัก
mbeeqembaa	เบ​เอ​เช​บา
haaso	ฮา​โซ
mbetuen	เบ​ทู​เอน
lembekaa	เล​เบ​คา
hembolon	เฮ​โบ​โลน
sohaax	โส​หา
efolon	เอ​โฟ​โลน
laambaan	ลา​บาน
ketulaa	เค​ทู​ลา
yokvsaan	โย้ก​ซาน
mitvmaa	มิด​มา
ndumaa	ดู​มา
haandatc	ฮา​ดัด
temaa	เท​มา
yetu	เย​ทู
naafitv	นา​ฟิด
kendemaa	เค​เด​มา
esaau	เอ​ซาว
yaakopv	ยา​โค้บ
filisaadie	ฟี​ลิ​สะ​เตีย
mbeeli	เบ​เอ​ลี
elon	เอ​โลน
mbaasematv	บา​เส​มัด
laasen	ลา​เซน
laambaan	ลา​บาน
mbinhaa	บิน​ฮา
leaa	เล​อา
lewi	เล​วี
napvtaali	นับ​ทา​ลี
sinxbaa	สิน​ปา
ndundaaim	ดู​ดา​อิม
ndinaa	ดี​นา
isaalaaen	อิ​สะ​ลา​เอน
yosepv	โย​เซ้บ
sei	เส​อี
haamo	ฮา​โม
sekem	เซ​เคม
simeon	สิ​เม​โอน
efaalaataa	เอ​ฟา​ลา​ทา
mbenyaamin	เบน​ยา​มิน
aase	อา​เซ
elifatv	เอ​ลี​ฟัด
leuen	เล​อู​เอน
temaan	เท​มาน
omaa	โอ​มา
sefo	เส​โฟ
naahatc	นา​หัด
zelaa	เฒ​ลา
aanaa	อา​นา
yeutc	เย​อูด
yaalaam	ยา​ลาม
kolaa	โค​ลา
oholimbaamaa	โอ​โฮ​ลี​บา​มา
endom	เอ​โดม
holi	โฮ​ลี
homam	โฮ​มัม
lotaan	โล​ทาน
timnaa	ทิม​นา
sombaan	โซ​บาน
maanaahaatv	มา​นา​ฮ้าด
embaan	เอ​บาน
onam	โอ​นัม
ndison	ดี​โซน
etcmbaan	เอด​บาน
itclaan	อิด​ลาน
kelaan	เค​ลาน
ese	เอ​เซ
ndisaan	ดี​ซาน
aalan	อา​ลัน
simbeon	สิ​เบ​โอน
endom	เอ​โดม
ndinhaambaa	ดิน​ฮา​บา
mbosaalaa	โบ​ซา​ลา
husaam	หุ​ซาม
mbendatc	เบ​ดัด
moapc	โม​อับ
mindien	มี​เดียน
aawitv	อา​วี้ด
samxlaa	สัม​ลา
lehoxmbotc	เล​โห​โบด
saaun	ซา​อุน
akcmbo	อัก​โบ
anwaa	อัน​วา
yetetv	เย​เท้ด
elaa	เอ​ลา
binon	ปี​โนน
kenatv	เค​นัด
mipvsaa	มิบ​ซา
ndotaan	โด​ทาน
lumben	ลู​เบน
yundaa	ยู​ดา
quaa	ชู​อา
eaa	เอ​อา
onan	โอ​นัน
hipvlu	ฮิบ​ลู
naiaa	ไน​อา
haanokv	ฮา​โน้ก
banlu	ปัน​ลู
hetvlon	เฮ้ด​โลน
kaanmi	คาน​มี
yemuen	เย​มู​เอน
yaamin	ยา​มีน
ohaatc	โอ​หาด
yaakin	ยา​คีน
geson	เก​โซน
kohaatv	โค​ฮ้าด
melaali	เม​ลา​ลี
itcsaaxkaa	อิด​สา​คา
tolaa	โท​ลา
simlon	ซิม​โลน
sembulun	เส​บู​ลุน
seletv	เส​เล้ด
yaaleen	ยา​เล​เอน
hakvgi	ฮัก​กี
suni	ซู​นี
etcmbon	เอด​โบน
elei	เอ​เล​อี
aaleli	อา​เล​ลี
imnaa	อิม​นา
itcwaa	อิด​วา
itcwi	อิด​วี
mbeliyaa	เบ​ลี​ยา
selaaaa	เซ​ลา​อา
hembe	เฮ​เบ
mbeke	เบ​เค
atcmben	อัด​เบน
gelaa	เก​ลา
naaaamaan	นา​อา​มาน
husim	หุ​ซิม
yaasien	ยา​ซี​เอน
guni	กุ​นี
yese	เย​เซ
sinlem	ซิน​เลม
gosen	โก​เซน
maanatvse	มะ​นัด​เส
efaaim	เอ​ฟา​อิม
jorndaen	จอ​แดน
maaki	มา​คี
mose	โม​เซ
aalon	อา​โลน
lipvni	ลิบ​นี
simei	ซิ​เม​อี
maazli	มา​ลี
musi	มู​ซี
itchaa	อิด​ฮา
nefekv	เน​เฟ้ก
sikcli	สิก​ลี
utcsien	อุด​ซี​เอน
misaaen	มิ​ซา​เอน
ensaafaan	เอน​ซา​ฟาน
naason	นา​โซน
naandapc	นา​ดับ
itaamaa	อิ​ทา​มา
atcsi	อัด​สี
enkaanaa	เอน​คา​นา
eleaasaa	เอ​เล​อา​ซา
finehatc	ฟี​เน​หัด
biauvhlen	เปย๊าเฮลน
douznzauc	โต์วเหฑ่า
mbaali	บา​ลี
sukckotv	สุก​โค้ด
aambipc	อา​บีบ
miliem	มิ​เลียม
lefindim	เล​ฟี​ดิม
huaa	ฮู​อา
yosuwaa	โย​ซู​วา
yeto	เย​โท
sinaai	ซี​นาย
mbongningv	บง
mbongnqenx	บงเหฆน
aambihu	อา​บี​ฮู
kelumbim	เค​ลู​บิม
efotv	เอ​โฟ้ด
ndaamdorng	ดามตอง
uli	อุ​ลี
mbesaalen	เบ​ซา​เลน
siousetv	เซียวเซ้ด
yembutc	เย​บุด
oholiapc	โอ​โฮ​ลี​อับ
caeqvjaangh	แธะจ้าง
ulim	อุ​ลิม
tummim	ทุม​มิม
buozzaangv	ปั์วฒ้าง
molekv	โม​เล้ก
selomitv	เซ​โล​มิด
buonvfingx	ป๊วนฝีง
suxlisatvndai	สู​ลิ​ซัด​ได
selumien	เซ​ลู​มิ​เอน
amminaandapc	อัม​มี​นา​ดับ
zuaa	ฒู​อา
netanen	เน​ทัน​เอน
helon	เฮ​โลน
eliapc	เอ​ลี​อับ
ammihutv	อัม​มี​ฮู้ด
elisaamaa	เอ​ลี​ซา​มา
bendaasu	เป​ดา​ซู
gaamaalien	กา​มา​ลิ​เอน
gindeoni	กิ​เด​โอ​นี
aambindan	อา​บี​ดัน
aahiyese	อา​หิ​เย​เซ
okaan	โอ​คาน
baagien	ปา​กี​เอน
ndeuen	เด​อู​เอน
eliyaasaapc	เอ​ลี​ยา​สาบ
enan	เอ​นัน
aahilaa	อา​หิ​ลา
amlaam	อัม​ลาม
elisaafaan	เอ​ลี​ซา​ฟาน
maanaa	มา​นา
sakcge	สัก​เก
sammuwaa	ซัม​มุ​วา
saafatv	ซา​ฟัด
yefunne	เย​ฟุน​เน
kaalepv	คา​เล้บ
igaan	อิ​กาน
hoseyaa	โฮ​เซ​ยา
mikaaen	มี​คา​เอน
homaa	โฮ​มา
doixdekc	ต๋อยเตก
ndaataan	ดา​ทาน
aambilam	อา​บี​ลัม
siangsic	เซียงสี่
melimbaa	เม​ลี​บา
kaandetc	คา​เดด
hoaa	โฮ​อา
aalaatv	อา​ล้าด
naangdoqc	นางโตะ
zeletv	เฒ​เล้ด
sihonx	สิ​โหน
hetvmbon	เฮ้ด​โบน
kemotv	เค​โม้ด
sipcbo	สิบ​โป
mbaalaakv	บา​ล้าก
mbaalaaam	บา​ลา​อัม
mbaaan	บา​อัน
mbeo	เบ​โอ
kenai	เค​ไน
beo	เป​โอ
simxli	สิม​ลี
kotvmbi	โค้ด​บี
suxaa	สู​อา
otcni	โอด​นี
yaasupv	ยา​ซู้บ
atclien	อัด​ลี​เอน
semindaa	เซ​มิ​ดา
hefe	เฮ​เฟ
selofehatc	เส​โล​เฟ​หัด
maahaalaa	มา​ฮา​ลา
hokvlaa	โฮ้ก​ลา
tilaasaa	ที​ละ​ซา
suham	ซู​ฮัม
gileaatc	กิ​เล​อาด
maakile	มา​คี​เล
aambaalim	อา​บา​ลิม
ewi	เอ​วี
lekem	เล​เคม
lembaa	เล​บา
mikvndon	มิก​โดน
lipvnaa	ลิบ​นา
taahatc	ทา​หัด
yotvmbaataa	โย้ด​บา​ทา
ombotc	โอ​โบด
nembo	เน​โบ
atcmon	อัด​โมน
mendidelenien	เม​ดิ​เต​เล​เนียน
haamatv	ฮา​มัด
sendatc	เส​ดัด
mbukcki	บุก​คี
hannien	ฮัน​นี​เอน
kemuen	เค​มู​เอน
bantien	ปัน​ที​เอน
aahihutv	อา​หิ​ฮู้ด
endeni	เอ​เดน​อี
atctaalotv	อัด​ทา​โล้ด
mbaasaan	บา​ซาน
holepv	โฮ​เล้บ
aanaakv	อา​น้าก
yaahaatv	ยา​ฮ้าด
aangopc	อาน​โกบ
hemon	เฮ​โมน
saindorn	ไซ​ดอน
seni	เส​นี
aalaambaa	อา​ลา​บา
bitcgaa	ปิด​กา
kungxbuoz	ขูงปั์ว
ammon	อัม​โมน
gelisim	เก​ลิ​ซิม
aamen	อา​เมน
laahapc	ลา​หับ
gingaan	กิน​กาน
yeliko	เย​ลี​โค
sapcndi	สับ​ดี
aakaan	อา​คาน
gimbeon	กิ​เบ​โอน
mbeelotv	เบ​เอ​โล้ด
yelusaalem	เย​ลู​ซา​เลม
yaanmutv	ยาน​มู้ด
laakitv	ลา​คี้ด
yaafie	ยา​เฟีย
ekclon	เอก​โลน
ndembi	เด​บี
aasekaa	อา​เซ​คา
makvkendaa	มัก​เค​ดา
aiyaalon	ไอ​ยา​โลน
gese	เก​เซ
yaambin	ยา​บิน
maandon	มา​โดน
akcsaapv	อัก​ซ้าบ
mitvbaa	มิด​ปา
aandunlam	อา​ดุน​ลัม
tapvbuwaa	ทับ​ปู​วา
aafekv	อา​เฟ้ก
megitcndo	เม​กิด​โด
kendetc	เค​เดด
kaanmen	คาน​เมน
yokvneam	โย้ก​เน​อัม
goyim	โก​ยิม
gesu	เก​ซู
maaaakaa	มา​อา​คา
saaxlekaa	สา​เล​คา
kendemotv	เค​เด​โม้ด
mefaaaatc	เม​ฟา​อาด
mbaaaalaa	บา​อา​ลา
timnaahaa	ทิม​นา​ฮา
akcsaax	อัก​สา
otcnien	โอด​นี​เอน
sipcaa	สิบ​อา
telem	เท​เลม
mbeaalotv	เบ​อา​โล้ด
semaa	เซ​มา
molaandaa	โม​ลา​ดา
esem	เอ​เซม
entolatv	เอน​โท​ลัด
sikclaakv	สิก​ล้าก
matvmannaa	มัด​มัน​นา
soko	โส​โค
mbotckaatv	โบด​ค้าด
ete	เอ​เท
aaqan	อา​ชัน
atcnaa	อัด​นา
aanaapv	อา​น้าบ
etctemoaa	เอด​เท​โม​อา
aalapc	อา​หลับ
maaon	มา​โอน
yitvleen	ยิด​เล​เอน
gendo	เก​โด
aataalotv	อา​ทา​โล้ด
naaaalaa	นา​อา​ลา
silo	ซี​โล
apcwim	อับ​วิม
ofaalaa	โอ​ฟา​ลา
laamaa	ลา​มา
mosaa	โม​ซา
kision	คี​ซิ​โอน
embetc	เอ​เบด
hammatv	ฮัม​มัด
kinneletv	คิน​เน​เล้ด
solaa	โส​ลา
etctaaon	เอด​ทา​โอน
ekolon	เอ​โค​โลน
enteke	เอน​เท​เค
gipcmbeton	กิบ​เบ​โทน
mbaaaalatv	บา​อา​ลัด
mbesekv	เบ​เซ้ก
sesai	เซ​ไซ
aahimaan	อา​หิ​มาน
tanmai	ทัน​ไม
akcsipv	อัก​ซี้บ
lehopc	เล​โหบ
ehutv	เอ​ฮู้ด
aanaatv	อา​น้าด
samgaa	ซัม​กา
ndembolaa	เด​โบ​ลา
aambinoam	อา​บี​โน​อัม
taambo	ทา​โบ
siselaa	สิ​เส​ลา
gindeon	กิ​เด​โอน
yoaatc	โย​อาด
wuomhlen	ววมเฮลน
aambiyese	อา​บี​เย​เซ
zembaa	เฒ​บา
sanxmunnaa	สัน​มุน​นา
benuen	เป​นู​เอน
heletv	เฮ​เล้ด
yotaam	โย​ทาม
mbee	เบ​เอ
sembun	เส​บุน
gaaan	กา​อัน
tembetc	เท​เบด
saami	ซา​มี
jaai	จา​อี
yepvtaa	เย้บ​ทา
aaloe	อา​โล​เอ
mbetclehem	เบด​เล​เฮม
bilaaton	ปิ​ลา​โทน
apcndon	อับ​โดน
maanoaa	มา​โน​อา
saemsanx	แซม​สัน
gaasaa	กา​ซา
ndelilaa	เด​ลิ​ลา
mikaa	มี​คา
laaitc	ลา​อิด
gimbeaa	กิ​เบ​อา
naaomi	นา​โอ​มี
elimelekv	เอ​ลี​เม​เล้ก
lute	ลู​เท
maalon	มา​โลน
kilion	คิ​ลิ​โอน
hnievhniev	เฮนี้ยๆ
maalaa	มา​ลา
mboaatc	โบ​อาด
camvcamv	ธั้มๆ
sanxmon	สัน​โมน
ombetc	โอ​เบด
jetcsi	เจียด​ซี
ndaawitv	ดา​วิด
buonvzingh	ป๊วนฒี่ง
eli	เอ​ลี
beninnaa	เป​นิน​นา
hannaa	ฮัน​นา
saengyungz	แซงยู์ง
saamuen	ซา​มู​เอน
atcndotc	อัด​โดด
lozdorngx	โล์ต๋อง
aambinaandapc	อา​บี​นา​ดับ
saulo	เซา​โล
yaambetc	ยา​เบด
naahaatc	นา​หาด
mikvmaatv	มิก​ม้าด
suan	ซู​อัน
yonaataan	โย​นา​ทาน
aahiyaa	อา​หิ​ยา
apcne	อับ​เน
aambien	อา​บี​เอน
suwaa	ซู​วา
aagakc	อา​กัก
sammaa	ซัม​มา
hmienfangx	เฮมียนฝัง
goliatc	โก​ลิ​อัด
saaaalaaim	ซา​อา​ลา​อิม
sieqvhlo	เซียะโฮล
mikaan	มี​คาน
naayotv	นา​โย้ด
aahimelekv	อา​หิ​เม​เล้ก
aakitv	อา​คิด
ndoekc	โด​เอก
aahitupv	อา​หิ​ทู้บ
aambiyaataa	อา​บี​ยา​ทา
keilaa	เค​อี​ลา
naambaan	นา​บาน
aambigaayin	อา​บี​กา​ยิน
aahinoam	อา​หิ​โน​อัม
seluyaa	เส​ลุ​ยา
yoaapc	โย​อาบ
aambiqai	อา​บี​ไช
sunem	ซู​เนม
ginmboaa	กิน​โบ​อา
keleti	เค​เล​ที
laamotv	ลา​โม้ด
yaatvti	ย้าด​ที
yelaameen	เย​ลา​เม​เอน
yaasaa	ยา​ซา
itcmbosetv	อิด​โบ​เซ้ด
maahaanaaim	มา​หะ​นา​อิม
aasaaxhen	อา​สา​เฮน
amnon	อัม​โนน
aandoniyaa	อา​โด​นี​ยา
hakvgitc	ฮัก​กีด
sefaatiyaa	เซ​ฟา​ทิ​ยา
gitctaaim	กิด​ทา​อิม
limmon	ลิม​โมน
lekaapv	เล​ค้าบ
mbaaaanaa	บา​อา​นา
minlo	มิน​โล
naatan	นา​ทัน
saalomorn	ซา​โล​มอน
ipchaa	อิบ​ฮา
elisuwaa	เอ​ลี​ซู​วา
eliyaandaa	เอ​ลี​ยา​ดา
elifeletv	เอ​ลี​เฟ​เล้ด
gembaa	เก​บา
utcsaa	อุด​ซา
sindaa	สี​ดา
sombaa	โส​บา
haandatcese	ฮา​ดัด​เอ​เซ
yufeditc	ยู​เฟ​ติด
silie	ซี​เลีย
yehoyaandaa	เย​โฮ​ยา​ดา
mbenaiyaa	เบ​ไน​ยา
peletv	เพ​เล้ด
simbaa	ซิ​บา
mefimbosetv	เม​ฟี​โบ​เซ้ด
haanun	ฮา​นูน
mbatcqembaa	บัด​เช​บา
uliaa	อุ​ลี​อา
lapvmbaa	ลับ​บา
apcsaalom	อับ​ซา​โลม
yonaandapc	โย​นา​ดับ
tekoaa	เท​โค​อา
itctai	อิด​ไท
saaxndokc	สา​โดก
aahimaaatc	อา​หิ​มา​อัด
aahitofen	อา​หิ​โท​เฟน
husai	หุ​ไซ
mbaasinlai	บา​ซิน​ไล
aamaasaax	อา​มา​สา
mbikcli	บีก​ลี
ilaa	อิ​ละ
aiaa	ไอ​อา
litvbaa	ลิด​ปา
simehaa	ซี​เม​ฮา
aahoxhai	อา​โห​ไฮ
ndondo	โด​โด
haalaa	ฮา​ลา
enhaanan	เอน​ฮา​นัน
haalotv	ฮา​โล้ด
heletvte	เฮ​เล้ด​เท
ikcketc	อิก​เขด
aanaatotv	อา​นา​โท้ด
husaa	หุ​ซา
netofaa	เน​โท​ฟา
maahaalai	มา​หะ​ไล
limbai	ลี​ไบ
gaaatc	กา​อัด
mbaahulim	บา​ฮู​ลิม
atcmaawetv	อัด​มา​เว้ด
aahiyam	อา​หิ​ยัม
gilon	กิ​โลน
hetvlo	เฮ้ด​โล
mbaani	บา​นี
selekv	เส​เล้ก
naahaalai	นา​หะ​ไล
itclai	อิด​ไล
gaalepv	กา​เล้บ
uliyaa	อุ​ลี​ยา
yaase	ยา​เซ
aalaaunaa	อา​ลาว​นา
aambiqaakv	อา​บี​ช้าก
aasaaliyaa	อา​ซา​ลิ​ยา
aahilutv	อา​หิ​ลู้ด
itcndo	อิด​โด
yehosaafatv	เย​โฮ​ซา​ฟัด
hilaam	ฮี​ลาม
lembaanorn	เล​บา​นอน
aandonilam	อา​โด​นี​ลัม
ndiangxbenv	เดี๋ยงเป๊น
tailaqv	ไท​ละ
sion	สิ​โอน
gaalili	กา​ลิ​ลี
taabenetv	ทา​เป​เน้ด
yelomboam	เย​โล​โบ​อัม
lehoxmboam	เล​โห​โบ​อัม
lozziouv	โล์เฒี้ยว
aambiyaa	อา​บี​ยา
jaandaangc	จาด่าง
sisakv	ซิ​ซัก
nembatc	เน​บัด
aambiyam	อา​บี​ยัม
aambiqaalom	อา​บี​ชา​โลม
aasaax	อา​สา
mbaaaaqaa	บา​อา​ชา
omli	โอม​ลี
saamaalie	สะ​มา​เลีย
aahapc	อา​หับ
aaselaa	อา​เซ​ลา
eliyaa	เอ​ลี​ยา
ombaandi	โอ​บา​ดี
yesemben	เย​เซ​เบน
kison	คี​โซน
yehu	เย​ฮู
elisaa	เอ​ลี​ซา
haasaaen	ฮา​ซา​เอน
naambotc	นา​โบด
imlaa	อิม​ลา
mikaayaa	มี​คา​ยา
aahatcyaa	อา​หัด​ยา
sinhi	ซิน​หิ
aasumbaa	อา​ซุ​บา
yolam	โย​ลัม
yeholam	เย​โฮ​ลัม
saidiex	ไซเตี๋ย
gehaasi	เก​หะ​ซี
aannon	อาน​โนน
yehoaahaatc	เย​โฮ​อา​หาด
aataaliyaa	อา​ทา​ลิ​ยา
yehoaatc	เย​โฮ​อาด
aamaasiyaa	อา​มา​ซิ​ยา
sekaaliyaa	เส​คา​ลิ​ยา
sanlum	ซัน​ลูม
utcsiyaa	อุด​ซี​ยา
gaandi	กา​ดี
menaahem	เม​นา​เฮม
atcsilie	อัด​ซี​เลีย
bekaahiyaa	เป​คา​หิ​ยา
lemaaliyaa	เล​มา​ลิ​ยา
bekaa	เป​คา
aahatc	อา​หัด
lesin	เล​ซิน
kiaa	คี​อา
mindie	มี​เดีย
mbaambilon	บา​บี​โลน
sefaanwaaim	เส​ฟาน​วา​อิม
hesekiyaa	เฮ​เซ​คี​ยา
sennaakelipv	เซน​นา​เค​ลิบ
isaayaa	อิ​สะ​ยา
aanbatc	อาน​ปัด
henaa	เฮ​นา
ipcwaa	อิบ​วา
aamon	อา​โมน
yosiyaa	โย​สิ​ยา
aandaayaa	อา​ดา​ยา
mesunlaam	เม​ซุน​ลาม
aasaalaiyaa	อา​ซา​ไล​ยา
saafaan	ซา​ฟาน
hinkiyaa	ฮิน​คี​ยา
aahikam	อา​หิ​คัม
aasaaxyaa	อา​สา​ยา
hunndaa	ฮุน​ดา
kitclon	ขิด​โลน
buonvsin	ป๊วนซิน
haamutaan	ฮา​มุ​ทาน
yelemi	เย​เล​มี
lipvlaa	ลิบ​ลา
yehoyaakim	เย​โฮ​ยา​คิม
bendaayaa	เป​ดา​ยา
yehoyaakin	เย​โฮ​ยา​คีน
ennaatan	เอน​นา​ทัน
sendekiyaa	เส​เด​คี​ยา
aanwatv	อาน​วัด
matvsaax	มัด​สา
gaataam	กา​ทาม
mitvsaa	มิด​ซา
anwaan	อัน​วาน
mbinhaan	บิน​ฮาน
saaxwaan	สา​วาน
matvlekaa	มัด​เล​คา
makvndien	มัก​ดี​เอน
ilaam	อิ​ลาม
beletv	เป​เล้ด
haamun	ฮา​มูน
etaan	เอ​ทาน
hemaan	เฮ​มาน
kaanko	คาน​โค
ndaanndaa	ดาน​ดา
yete	เย​เท
segupc	เส​กุบ
sammai	ซัม​ไม
aambihaain	อา​บี​ฮา​อิน
itci	อิด​อี
sesan	เซ​ซัน
akclai	อัก​ไล
saaxmbaatc	สา​บาด
eleaasaax	เอ​เล​อา​สา
yekaamiyaa	เย​คา​มิ​ยา
beletc	เป​เหลด
efaa	เอ​ฟา
saaapc	ซา​อับ
qewaa	เช​วา
simeaa	ซิ​เม​อา
nogaa	โน​กา
selupvmbaamben	เส​ลุบ​บา​เบน
haananyaa	ฮา​นัน​ยา
mbelekiyaa	เบ​เล​คิ​ยา
belaatiyaa	เป​ลา​ที​ยา
yesaayaa	เย​ซา​ยา
lefaiyaa	เล​ไฟ​ยา
sekaaniyaa	เซ​คา​นิ​ยา
semaiaa	เซ​ไม​อา
hatvtatv	ฮัด​ทัด
neaaliyaa	เน​อา​ลี​ยา
elionai	เอ​ลี​โอ​ไน
atclikam	อัด​ลี​คัม
hondaawiyaa	โฮ​ดา​วิ​ยา
eliyaasipv	เอ​ลี​ยา​ซี้บ
belaiyaa	เป​ไล​ยา
akckupc	อัก​ขูบ
yohaanan	โย​ฮา​นัน
ndelaiyaa	เด​ไล​ยา
leaayaa	เล​อา​ยา
yaahaatc	ยา​หาด
edaam	เอ​ตาม
itcmaa	อิด​มา
helaa	เฮ​ลา
baaseaa	ปา​เส​อา
selaiaa	เส​ไล​อา
etclaa	เอด​ลา
meletv	เม​เล้ด
efe	เอ​เฟ
kenan	เค​นัน
maahaalaalen	มา​หะ​ลา​เลน
enokv	เอ​โน้ก
metuselaa	เม​ทู​เส​ลา
noyaa	โน​ยา
aalam	อา​ลัม
qelaa	เช​ลา
isakc	อี​สัก
lotaan	โล​ทาน
ndison	ดี​โซน
haandatc	ฮา​ดัด
yundaa	ยู​ดา
amminaandapc	อัม​มี​นา​ดับ
naason	นา​โซน
sanxmon	สัน​โมน
ombetc	โอ​เบด
jaai	จา​อี
sesan	เซ​ซัน
naatan	นา​ทัน
yehu	เย​ฮู
ndaawitv	ดา​วิด
lehoxmboam	เล​โห​โบ​อัม
aambiyaa	อา​บี​ยา
aasaax	อา​สา
aamaasiyaa	อา​มา​ซิ​ยา
aasaaliyaa	อา​ซา​ลิ​ยา
aahatc	อา​หัด
hesekiyaa	เฮ​เซ​คี​ยา
ammon	อัม​โมน
yehoyaakin	เย​โฮ​ยา​คีน
selupvmbaamben	เส​ลุบ​บา​เบน
yesaayaa	เย​ซา​ยา
lefaiyaa	เล​ไฟ​ยา
ombaandi	โอ​บา​ดี
semaiaa	เซ​ไม​อา
yaahaatc	ยา​หาด
maalesaa	มา​เล​ซา
gendelaa	เก​เด​ลา
nemuen	เน​มู​เอน
yaalipv	ยา​ลี้บ
sanlum	ซัน​ลูม
mipvsamx	มิบ​สัม
sakcge	สัก​เก
aayin	อา​ยิน
yoen	โย​เอน
aasien	อา​สิ​เอน
aandien	อา​ดี​เอน
zizaa	ฒี​ฒา
yendaayaa	เย​ดา​ยา
simli	ซิม​ลี
mikaa	มี​คา
gileaatc	กิ​เล​อาด
mikaaen	มี​คา​เอน
aahi	อา​หิ
elien	เอ​ลี​เอน
finehatc	ฟี​เน​หัด
aambiquwaa	อา​บี​ชู​วา
mbukcki	บุก​คี
utcsi	อุด​ซี
selaahiyaa	เส​ลา​หิ​ยา
selaahiyaa	เส​ลา​หิ​ยา
melaayotv	เม​ลา​โย้ด
aamaaliyaa	อา​มา​ลิ​ยา
aamaaliyaa	อา​มา​ลิ​ยา
saaxndokc	สา​โดก
hinkiyaa	ฮิน​คี​ยา
yehosaandakc	เย​โฮ​ซา​ดัก
nembukatvnetvsaa	เน​บู​คัด​เน้ด​ซา
simxmaa	สิม​มา
yoaa	โย​อา
zelaa	เฒ​ลา
enkaanaa	เอน​คา​นา
embiyaasaapc	เอ​บี​ยา​สาบ
embiyaasaapc	เอ​บี​ยา​สาบ
taahatc	ทา​หัด
ulien	อุ​ลี​เอน
utcsiyaa	อุด​ซี​ยา
eliapc	เอ​ลี​อับ
yeloham	เย​โล​ฮัม
yeloham	เย​โล​ฮัม
simeaa	ซิ​เม​อา
maahaatv	มา​ฮ้าด
aamaasaix	อา​มา​ไส
yoen	โย​เอน
sefanyaa	เส​ฟัน​ยา
atcsi	อัด​สี
itchaa	อิด​ฮา
kohaatv	โค​ฮ้าด
lewi	เล​วี
aasaapc	อา​สาบ
aasaapc	อา​สาบ
mbelekiyaa	เบ​เล​คิ​ยา
mankiyaa	มัน​คิ​ยา
simxmaa	สิม​มา
geson	เก​โซน
apcndi	อับ​ดี
manlukv	มัน​ลุก
haasaabiyaa	ฮา​ซา​ปิ​ยา
haasaabiyaa	ฮา​ซา​ปิ​ยา
amsi	อัม​ซี
amsi	อัม​ซี
mbaani	บา​นี
qeme	เช​เม
maazli	มา​ลี
melaali	เม​ลา​ลี
utcsi	อุด​ซี
melaayotv	เม​ลา​โย้ด
ndaambelatv	ดา​เบ​ลัด
puaa	พู​อา
yendiyaaen	เย​ดี​ยา​เอน
yelimotv	เย​ลี​โม้ด
yelemotv	เย​เล​โม้ด
aalemetv	อา​เล​เม้ด
kenaaaanaa	เค​นา​อะ​นา
hupcbim	หุบ​ปิม
supvbim	ซุบ​ปิม
belaetv	เป​แล้ด
ulaam	อุ​ลาม
telaa	เท​ลา
taahan	ทา​ฮัน
laandaan	ลา​ดาน
laandaan	ลา​ดาน
mankien	มัน​คี​เอน
yaafeletv	ยา​เฟ​เล้ด
some	โซ​เม
hotaam	โฮ​ทาม
sofaa	โส​ฟา
mbese	เบ​เซ
aalaa	อา​ลา
atcndaa	อัด​ดา
mesaa	เม​ซา
enbaaan	เอน​ปา​อัน
aahiyo	อา​หิ​โย
saasakv	ซา​ซัก
sembaandiyaa	เส​บา​ดิ​ยา
ende	เอ​เด
yohaa	โย​ฮา
yaakim	ยา​คิม
sinxletai	สิน​เล​ไท
haanan	ฮา​นัน
yeien	เย​อี​เอน
saulo	เซา​โล
biton	ปิ​โทน
melekv	เม​เล้ก
taalie	ทา​เลีย
simxli	สิม​ลี
mbineaa	บิ​เน​อา
mbineaa	บิ​เน​อา
eleaasaax	เอ​เล​อา​สา
aasen	อา​เซน
mbokelu	โบ​เค​ลู
seaaliyaa	เซ​อา​ลิ​ยา
isaalaaen	อิ​สะ​ลา​เอน
yeuen	เย​อู​เอน
sanxlu	สัน​ลู
hatcsenuaa	หัด​เส​นู​อา
elaa	เอ​ลา
mesunlaam	เม​ซุน​ลาม
sefaatiyaa	เซ​ฟา​ทิ​ยา
leuen	เล​อู​เอน
aandaayaa	อา​ดา​ยา
baatche	ปาด​เฮ
baatche	ปาด​เฮ
mankiyaa	มัน​คิ​ยา
imme	อิม​เม
gaalaan	กา​ลาน
matvtaaniyaa	มัด​ทา​นิ​ยา
sikcli	สิก​ลี
yendutun	เย​ดู​ทูน
yendutun	เย​ดู​ทูน
mikvlotv	มิก​โล้ด
yembutc	เย​บุด
belon	เป​โลน
sipcmbekai	สิบ​เบ​ไค
saaanmbon	ซา​อัน​โบน
eliyaambaa	เอ​ลี​ยา​บา
gimso	กิม​โซ
haasem	ฮา​เซม
uaa	อู​อา
itclai	อิด​ไล
yaaaasien	ยา​อา​ซี​เอน
semaaliyaa	เซ​มา​ลิ​ยา
itcsiyaa	อิด​ซี​ยา
aasaalen	อา​ซา​เลน
yaasombeam	ยา​โซ​เบ​อัม
aambiqai	อา​บี​ไช
silie	ซี​เลีย
saadaan	ซา​ตาน
selomotv	เซ​โล​โม้ด
gesom	เก​โซม
haalim	ฮา​ลิม
miyaamin	มิ​ยา​มิน
hakvkotc	ฮัก​โขด
yesuaa	เย​ซู​อา
mbingaa	บิน​กา
hesi	เฮ​ซี
betaahiyaa	เป​ทา​หิ​ยา
maaaasiyaa	มา​อา​ซิ​ยา
yaaaasiyaa	ยา​อา​ซี​ยา
gendaaliyaa	เก​ดา​ลิ​ยา
matvtitiyaa	มัด​ที​ทิ​ยา
sembuen	เซ​บู​เอน
haanaani	ฮา​นา​นี
yehohaanan	เย​โฮ​ฮา​นัน
hosaax	โฮ​สา
henndai	เฮน​ได
elihu	เอ​ลี​ฮู
itcmaiaa	อิด​ไม​อา
aanki	อาน​คี
saalomorn	ซา​โล​มอน
tailaqv	ไท​ละ
yapvfaa	ยับ​ฟา
kelumbim	เค​ลู​บิม
isaalaaen	อิ​สะ​ลา​เอน
saalomorn	ซา​โล​มอน
sekem	เซ​เคม
yelomboam	เย​โล​โบ​อัม
maahaalatv	มา​หะ​ลัด
yelusaalem	เย​ลู​ซา​เลม
yundaa	ยู​ดา
ondetc	โอ​เดด
mbaaaaqaa	บา​อา​ชา
yehosaafatv	เย​โฮ​ซา​ฟัด
netaaniyaa	เน​ทา​นิ​ยา
tombiyaa	โท​บี​ยา
yehosaambaatc	เย​โฮ​ซา​บาด
aahapc	อา​หับ
yaahaasien	ยา​ฮา​ซี​เอน
aahatcyaa	อา​หัด​ยา
yeholam	เย​โฮ​ลัม
yehien	เย​ฮี​เอน
etiobie	เอ​ที​โอ​เปีย
yolam	โย​ลัม
yehu	เย​ฮู
yehoyaandaa	เย​โฮ​ยา​ดา
simeatc	ซิ​เม​อัด
yehoaatc	เย​โฮ​อาด
yekoliyaa	เย​โค​ลี​ยา
filisaadie	ฟี​ลิ​สะ​เตีย
aamortv	อา​ม้อด
ofen	โอ​เฟน
yotaam	โย​ทาม
maaaaseaa	มา​อา​เส​อา
mesinlemotv	เม​ซิน​เล​โม้ด
maanatvse	มะ​นัด​เส
aamon	อา​โมน
yosaambaatc	โย​ซา​บาด
yoaahaatc	โย​อา​หาด
yelemi	เย​เล​มี
besie	เป​เซีย
sailatv	ไซ​ลัด
haanditc	ฮา​ดิด
ono	โอ​โน
senaaaa	เส​นา​อา
aantaasesitv	อาน​ทา​เซ​ซี้ด
mitvlendaatc	มิด​เล​ดาด
ndaaliatc	ดา​ลิ​อัด
hakvgai	ฮัก​ไก
yiutai	ยิว​ไท
aahitupv	อา​หิ​ทู้บ
aambiquwaa	อา​บี​ชู​วา
eleaasaa	เอ​เล​อา​ซา
esaalaa	เอ​สะ​ลา
aahaawaa	อา​หะ​วา
esaalaa	เอ​สะ​ลา
sapvmbetai	ซับ​เบ​ไท
kelitaa	เค​ลิ​ทา
melemotv	เม​เล​โม้ด
matvtenai	มัด​เท​ไน
selemiyaa	เซ​เล​มิ​ยา
haakaaliyaa	ฮา​คา​ลิ​ยา
nehaami	เน​หะ​มี
susaax	สุ​สา
sanxmbaanlatv	สัน​บาน​ลัด
tombiaa	โท​บี​อา
gesem	เก​เซม
imli	อิม​ลี
mesesaamben	เม​เซ​ซา​เบน
yoyaandaa	โย​ยา​ดา
haasapvneyaa	ฮา​ซับ​เน​ยา
hatcsupv	หัด​ซู้บ
hanlohetc	ฮัน​โล​เหด
lehum	เล​ฮูม
sapcmbai	สับ​ไบ
mbaalukv	บา​ลุก
hatcsupv	หัด​ซู้บ
henaandatc	เฮ​นา​ดัด
mbinnui	บิน​นุย
baalaan	ปา​ลาน
baalotv	ปา​โล้ด
tombiaa	โท​บี​อา
mondekai	โม​เด​ไค
mbinsaan	บิน​ซาน
mbikcwai	บิก​ไว
katcmien	ขัด​มี​เอน
qembaaniyaa	เช​บา​นี​ยา
mbunni	บุน​นี
selebiyaa	เซ​เล​ปี​ยา
hondiyaa	โฮ​ดี​ยา
ndaanien	ดา​นี​เอน
ginneton	กิน​เน​โทน
batclotv	ปัด​โล้ด
satctu	สัด​ทู
atcgaatc	อัด​กาด
mbembai	เบ​ไบ
aandin	อา​ดีน
aate	อา​เท
haasum	ฮา​ซูม
mbesai	เบ​ไซ
haalipv	ฮา​ลิบ
yaatvnduwaa	ย้าด​ดู​วา
aanaayaa	อา​นา​ยา
sanxlai	สัน​ไล
yoyaalipv	โย​ยา​ลิบ
atclikam	อัด​ลี​คัม
sihaqc	สี​หะ
seantien	เซ​อัน​ทิ​เอน
yoyaakim	โย​ยา​คิม
yonaataan	โย​นา​ทาน
minyaamin	มิน​ยา​มิน
aamokv	อา​โม้ก
tanmon	ทัน​โมน
hosaayaa	โฮ​ซา​ยา
matvtaaniyaa	มัด​ทา​นิ​ยา
mikaayaa	มี​คา​ยา
eliyaakim	เอ​ลี​ยา​คิม
aahaasuelatv	อา​หะ​สุ​เอ​ลัด
inndie	อิน​เดีย
watvqaati	วัด​ชา​ที
yekoniyaa	เย​โค​นี​ยา
mondekai	โม​เด​ไค
esete	เอ​เซ​เท
esete	เอ​เซ​เท
esete	เอ​เซ​เท
haamaan	ฮา​มาน
haamaan	ฮา​มาน
haataakv	ฮา​ท้าก
haataakv	ฮา​ท้าก
kenndie	เคน​เดีย
lewiaataan	เล​วี​อา​ทาน
quwaa	ชู​วา
mbinndatc	บิน​ดัด
naaaame	นา​อา​เม
elihu	เอ​ลี​ฮู
mbehemotv	เบ​เฮ​โม้ด
selaa	เซ​ลา
selaa	เซ​ลา
dorziec	ตอเหฒี่ย
zuizmienh	ฒุ์ยเมี่ยน
lembaanorn	เล​บา​นอน
dangxdonx	ตั๋งต๋น
gembaan	เก​บาน
aamen	อา​เมน
wuomlaangc	ววมหล่าง
menkisendekc	เมน​คี​เซ​เดก
jorndaen	จอ​แดน
yaakopv	ยา​โค้บ
efaataa	เอ​ฟา​ทา
singqiex	ซีงเฉีย
gorngvnjaaux	ก๊องหฌาว
itien	อิ​ที​เอน
itien	อิ​ที​เอน
saalon	ซา​โลน
janxmuangz	จั๋น
anman	อัน​มัน
sicdorngh	สี่ต้อง
bingxciouv	ปี๋งเธี้ยว
biauvhuaang	เปย๊าฮวาง
wuomdomh	ววมต้ม
ndaamatvgatc	ดา​มัด​กัด
efaaim	เอ​ฟา​อิม
baengcngaaiz	แป่งง์าย
ndiangxndonx	เดี๋ยงด๋น
mbaambilon	บา​บี​โลน
moapc	โม​อับ
naiaa	ไน​อา
iyipv	อี​ยิบ
atcsilie	อัด​ซี​เลีย
sepvnaa	เซ้บ​นา
laihnaangx	ไลหฮนาง
aalien	อา​ลี​เอน
aalien	อา​ลี​เอน
nziaauxjieqv	หฑยาวเจี๊ยะ
sion	สิ​โอน
isaayaa	อิ​สะ​ยา
saibatc	ไซ​ปัด
biouvjoih	เปี๊ยวจ้อย
lozgaeng	โล์แกง
mbaaan	บา​อัน
buozzaux	ปั์วเหฒา
mankiaa	มัน​คี​อา
yosiyaa	โย​สิ​ยา
sindaa	สี​ดา
atckelon	อัด​เค​โลน
uliaa	อุ​ลี​อา
gemaaliyaa	เก​มา​ลิ​ยา
kolaayaa	โค​ลา​ยา
nehelaam	เน​เฮ​ลาม
sefanyaa	เส​ฟัน​ยา
bungxzuoqc	ปู๋งหฒัวะ
sendekiyaa	เส​เด​คี​ยา
kenndie	เคน​เดีย
neliyaa	เน​ลิ​ยา
mbaalukv	บา​ลุก
gorqvmienh	เก๊าะเมี่ยน
koniyaa	โค​นิ​ยา
yehukan	เย​ฮู​คัน
mbenyaamin	เบน​ยา​มิน
matvtaan	มัด​ทาน
kaaleaa	คา​เล​อา
tanhumetv	ทัน​หุ​เม้ด
kaaleaa	คา​เล​อา
gendaaliyaa	เก​ดา​ลิ​ยา
taabaanhetc	ทา​ปาน​เหด
memfitv	เมม​ฟิด
kiliyaataaim	คี​ลิ​ยา​ทา​อิม
ndimbon	ดี​โบน
endom	เอ​โดม
endom	เอ​โดม
forngcang	ฟองธัง
mbaambilon	บา​บี​โลน
nembukatvnetvsaa	เน​บู​คัด​เน้ด​ซา
buonvguoqv	ป๊วนกั๊วะ
saenghmz	แซงฮม์
kembaa	เค​บา
yaaaasanyaa	ยา​อา​ซัน​ยา
luijuoqv	ลุยจั๊วะ
oholaa	โอ​โฮ​ลา
oholimbaa	โอ​โฮ​ลี​บา
etiobie	เอ​ที​โอ​เปีย
saengcietv	แซงเธี้ยด
mievciangv	เมี้ยเธี้ยง
home	โฮ​เม
ndaanien	ดา​นี​เอน
mbentesatvsaa	เบน​เท​ซัด​ซา
satvlakv	ซัด​ลัก
mesaakv	เม​ซ้าก
aambetcnego	อา​เบด​เน​โก
aambetcnego	อา​เบด​เน​โก
mbensatvsaa	เบน​ซัด​ซา
mene	เม​เน
teken	เท​เคน
baasin	ปา​ซิน
gaambelien	กา​เบ​เลียน
hoseyaa	โฮ​เซ​ยา
aamotv	อา​โม้ด
aamotv	อา​โม้ด
keliotc	เค​ลิ​โอด
gingaan	กิน​กาน
finisie	ฟี​นี​เซีย
saaxlefatv	สา​เล​ฟัด
yonaa	โย​นา
yonaa	โย​นา
ninaawe	นิ​นะ​เว
bieivzeiv	เปย๊ยเฒ้ย
naahum	นา​ฮูม
limbie	ลิ​เบีย
haambaagukc	ฮา​บา​กุก
kusi	คู​ซี
minkom	มิน​โคม
jaaihorngc	จายห่อง
njanglaangc	ฌังหล่าง
yosuwaa	โย​ซู​วา
caidoix	ไธต๋อย
beletv	เป​เล้ด
hetvlon	เฮ้ด​โลน
mboaatc	โบ​อาด
jetcsi	เจียด​ซี
eliyaakim	เอ​ลี​ยา​คิม
yosepv	โย​เซ้บ
maaliyaa	มา​ลี​ยา
maaliyaa	มา​ลี​ยา
yesu	เย​ซู
yesu	เย​ซู
giduc	กี​ตู่
yesu	เย​ซู
imaanuen	อี​มา​นู​เอน
helotv	เฮ​โล้ด
yundie	ยู​เดีย
naasaaletv	นา​ซา​เล้ด
naasaaletv	นา​ซา​เล้ด
yohan	โย​ฮัน
yohan	โย​ฮัน
yohan	โย​ฮัน
dornhnamv	ตอน
sembendi	เส​เบ​ดี
yaagorpc	ยา​กอบ
totvmbuli	โท้ด​บุ​ลี
gilo	กี​โล
filipv	ฟี​ลิบ
mbaatolomiu	บา​โท​โล​มิว
tomatv	โท​มัด
matvtaai	มัด​ทาย
anfeatc	อัน​เฟ​อัด
tatvndeatc	ทัด​เด​อัด
simon	ซี​โมน
yundaatc	ยู​ดาด
isaakaaliotc	อิ​สะ​คา​ลิ​โอด
faalisi	ฟา​ลิ​สี
faalisi	ฟา​ลิ​สี
mbeensembun	เบ​เอน​เซ​บูน
saadaan	ซา​ตาน
helondietc	เฮ​โล​เดียด
yesu	เย​ซู
mbiauzdorn	เบย์าตอน
saandusi	สะ​ดู​สี
saandusi	สะ​ดู​สี
bide	ปี​เต
bide	ปี​เต
saigorx	ไซ
mbetaani	เบ​ทา​นี
sisaa	ซี​ซา
giduc	กี​ตู่
kaayaafaatv	คา​ยา​ฟ้าด
bide	ปี​เต
lomaa	โล​มา
bilaatv	ปี​ล้าด
yundaatc	ยู​ดาด
bilaatv	ปี​ล้าด
bilaatv	ปี​ล้าด
mbaalapvmbatc	บา​ลับ​บัด
mbaalapvmbatc	บา​ลับ​บัด
sailin	ไซ​ลีน
simon	ซี​โมน
eli	เอ​ลี
laamaasaambakctaani	ลา​มา​ซา​บัก​ทา​นี
makvndaalaa	มัก​ดา​ลา
anndaalu	อัน​ดา​ลู
kaabenaaum	คา​เป​นา​อุม
yesu	เย​ซู
helotv	เฮ​โล้ด
mbetcsaindaa	เบด​ไซ​ดา
mose	โม​เซ
hosaanaa	โฮ​ซา​นา
lomaa	โล​มา
aalekvsaannde	อา​เล้ก​ซาน​เด
lufatv	ลู​ฟัด
matvtatv	มัด​ทัด
matvtatv	มัด​ทัด
menki	เมน​คี
menki	เมน​คี
matvtaatiatc	มัด​ทา​ที​อัด
matvtaatiatc	มัด​ทา​ที​อัด
eaa	เอ​อา
simeon	สิ​เม​โอน
apclaaham	อับ​ลา​ฮัม
naaho	นา​โฮ
selukv	เส​ลุก
leu	เล​อู
belekv	เป​เล้ก
embe	เอ​เบ
aanfaasatv	อาน​ฟา​ซัด
laamekv	ลา​เม้ก
yaaletv	ยา​เล้ด
enotv	เอ​โน้ด
aandam	อา​ดัม
gelaasaa	เก​ลา​ซา
yailatv	ไย​ลัด
saamaalie	สะ​มา​เลีย
biauvziouv	เปย๊าเฒี้ยว
maataa	มา​ทา
gaalili	กา​ลิ​ลี
siloam	สี​โล​อัม
zaeqvdaan	แฒะตาน
laasaalatv	ลา​ซา​ลัด
sakckietv	สัก​เคี้ยด
helotv	เฮ​โล้ด
filipv	ฟี​ลิบ
naataanaaen	นา​ทา​นา​เอน
nikondematv	นี​โค​เด​มัด
yiutai	ยิว​ไท
kaanaa	คา​นา
laasaalatv	ลา​ซา​ลัด
laasaalatv	ลา​ซา​ลัด
maataa	มา​ทา
yundaatc	ยู​ดาด
annaatv	อัน​น้าด
aanaanie	อา​นา​เนีย
aanaanie	อา​นา​เนีย
saatefen	สะ​เท​เฟน
antiokc	อัน​ที​โอก
nikolau	นี​โค​เลา
saulo	เซา​โล
aineatc	ไอ​เน​อัด
litvndaa	ลิด​ดา
koneliatc	โค​เน​ลิ​อัด
koneliatc	โค​เน​ลิ​อัด
sisaaliyaa	ซี​ซา​ลี​ยา
mbaanaambatc	บา​นา​บัด
mbaanaambatc	บา​นา​บัด
taasatv	ทา​ซัด
maako	มา​โค
baulo	เปา​โล
baulo	เปา​โล
ikoniyum	อี​โค​นี​ยูม
hemetv	เฮ​เม้ด
begaa	เป​กา
silaa	ซี​ลา
maasindonie	มา​ซี​โด​เนีย
baulo	เปา​โล
silaa	ซี​ลา
tesaalonigaa	เท​สะ​โล​นิ​กา
yaasonx	ยา​โสน
aaten	อา​เทน
timotai	ทิ​โม​ไท
kolinto	โค​ลิน​โท
kaalitvbatc	คะ​ลิด​ปัด
ganlio	กัน​ลิ​โอ
aakaayaa	อา​คา​ยา
efeso	เอ​เฟ​โซ
bitcsinxlaa	ปิด​สิน​ลา
aakuinlaa	อา​ควิน​ลา
aaborlo	อา​ปอ​โล
aantemitv	อาน​เท​มิด
esie	เอ​เซีย
ndemetvliatc	เด​เม้ด​ลิ​อัด
mbeloaa	เบ​โล​อา
aalitvtaakatv	อา​ลิด​ทา​คัด
gaaiatc	กาย​อัด
tikigatc	ที​คิ​กัด
dofimatv	โต​ฟี​มัด
doatc	โต​อัด
silisie	ซี​ลี​เซีย
felikv	เฟ​ลิก
felikv	เฟ​ลิก
kaalaaundiatc	คา​ลาว​ดิ​อัด
lisietv	ลี​เซี้ยด
fesaatatv	เฟ​สะ​ทัด
fesaatatv	เฟ​สะ​ทัด
aanqipaa	อา​ฆี​พา
aanqipaa	อา​ฆี​พา
apclaaham	อับ​ลา​ฮัม
giduc	กี​ตู่
saaben	สะ​เปน
lusiatc	ลู​สิ​อัด
saatefaanatv	สะ​เท​ฟา​นัด
aaborlo	อา​ปอ​โล
maasindonie	มา​ซี​โด​เนีย
giduc	กี​ตู่
tidatc	ทิ​ตัด
tidatc	ทิ​ตัด
ebaafaa	เอ​ปา​ฟา
laundisie	เลา​ดี​เซีย
himeneatc	ฮี​เม​เน​อัด
ndemaatv	เด​ม้าด
gaalaatie	กา​ลา​เทีย
lugaa	ลู​กา
onesifolatv	โอ​เน​สิ​โฟ​ลัด
elatvtatv	เอ​ลัด​ทัด
miletatv	มิ​เล​ทัด
filemon	ฟี​เล​โมน
onesimatv	โอ​เน​สิ​มัด
saalem	ซา​เลม
mose	โม​เซ
mbaalaaam	บา​ลา​อัม
kaain	คา​อิน
kolaa	โค​ลา
ndiangxnormh	เดี๋ยงน่อม
liangxndeic	เหลียงเด่ย
ongtaaixngaeqv	องถายแงะ
ongtaaixngaeqv	องถายแงะ
faambaeqv	ฟามแป๊ะ
faambaeqv	ฟามแป๊ะ
gongbou	กงโปว
dozmienh	โต์เมี่ยน
hnamvnzuonx	ฮนั้มหฑวน
auvjueiv	เอ๊าเจว๊ย
dornmbuangz	ตอนบวั์ง
wuomminc	ววมหมิ่น
nzangvliuh	ฑั้งลิ่ว
dornmbuangz	ตอนบวั์ง
camvfingx	ธั้มฝีง
wuomsuiv	ววมซุ้ย
baeqvfun	แป๊ะฟุน
camvfingx	ธั้มฝีง
ndiangxgorn	เดี๋ยงกอน
fiuvmungv	ฟิ้วมู้ง
douzsiouxdon	โต์วเสียวตน
cutvcutv	ธุดๆ
sieqvhlo	เซียะโฮล
dornmaac	ตอนหม่า
saaziou	ซาเฒียว
auvdorn	เอ๊าตอน
hnievdaauh	เฮนี้ยต้าว
lozdeicbung	โล์เต่ยปูง
cinmaanc	ธินหม่าน
sieqvfun	เซียะฟุน
suqvsuqv	ซุๆ
ndopvlui	ด๊บลุย
sunggouv	ซูงโก๊ว
sunggouv	ซูงโก๊ว
korvfiqv	ค้อฟิ
sunggouv	ซูงโก๊ว
camvnorm	ธั้มนอม
jangjang	จังๆ
mbiungcsuiv	บยู่งซุ้ย
auvfaam	เอ๊าฟาม
cingjaahnaangx	ธีงจาหฮนาง
buonvdeicbung	ป๊วนเต่ยปูง
nguaazgorn	งว์ากอน
wuomjorm	ววมจอม
luimueiz	ลุยเมว์ย
luimueizndaauv	ลุยเมว์ยด๊าว
ndiangxzung	เดี๋ยงฒูง
ndiendaang	เดียดาง
luimueizndaauv	ลุยเมว์ยด๊าว
biauvziouv	เปย๊าเฒี้ยว
hnyangxzingh	หฮญังฒี่ง
muozdorn	มั์วตอน
ndaamvjauv	ด๊ามเจ๊า
muozdorn	มั์วตอน
ndaamdaauh	ดามต้าว
dornfun	ตอนฟุน
wuomseix	ววมเสย
ndiesai	เดียไซ
ndiewuom	เดียววม
ndiesai	เดียไซ
zouvmouh	โฒ้วโม่ว
ndiewuom	เดียววม
kouvzingh	โค้วฒี่ง
ndiangxdornfomv	เดี๋ยงตอนฟ้ม
ndiangxdornfomv	เดี๋ยงตอนฟ้ม
gongboubieiv	กงโปวเปย๊ย
kouvlatc	โค้วหลัด
kouvlatc	โค้วหลัด
jauvdingh	เจ๊าตี้ง
naangdueiv	นางเตว๊ย
naangdueiv	นางเตว๊ย
luigem	ลุยเกม
luigem	ลุยเกม
luigem	ลุยเกม
luigem	ลุยเกม
gongboubieiv	กงโปวเปย๊ย
gongboubieiv	กงโปวเปย๊ย
guaigorqv	ไกวเก๊าะ
gaengvdaic	แก๊งไต่
nduindui	ดุยๆ
gaengmbung	แกงบูง
gaengmbung	แกงบูง
gaengmbung	แกงบูง
gaengmbung	แกงบูง
gaengmbung	แกงบูง
niembungmuonc	เนียบูงหม่วน
koivsiqv	ค้อยซิ
sianghnyangx	เซียงหฮญัง
laiim	ไลอิม
njuovnyiemz	ฌั้วเญี์ยม
mbuonxndiouh	บ๋วนเดี้ยว
douzndiouh	โต์วเดี้ยว
jauvnqaai	เจ๊าฆาย
jauvnqaai	เจ๊าฆาย
faixfiuv	ไฝฟิ้ว
faixfiuv	ไฝฟิ้ว
mbongnqenx	บงเหฆน
daansin	ตานซิน
daansin	ตานซิน
auvhlo	เอ๊าโฮล
auvhlo	เอ๊าโฮล
baacbaac	ป่าๆ
kuotvziouv	ค้วดเฒี้ยว
janxzaqc	จั๋นหฒะ
njimvmbiorqc	ฌิ้มเบยาะ
winjaa	วินจา
mueiznjeiv	เมว์ยเฌ้ย
jiemkuing	เจียมควีง
faangzaux	ฟางเหฒา
jiemkuing	เจียมควีง
dangjaax	ตังจ๋า
dangsin	ตังซิน
dangsin	ตังซิน
dangsin	ตังซิน
caaxcaax	หธาๆ
dangjaax	ตังจ๋า
dangsin	ตังซิน
kuaaivkuaaiv	คว้ายๆ
ndiembuov	เดียบั๊ว
ndiehlen	เดียเฮลน
kuaaivkuaaiv	คว้ายๆ
ndiehlen	เดียเฮลน
njongclaan	หฌ่งลาน
njongclaan	หฌ่งลาน
jiemlingh	เจียมลี่ง
buozzaux	ปั์วเหฒา
jiexlouh	เจี๋ยโล่ว
ndiangxndopv	เดี๋ยงด๊บ
jiemdang	เจียมตัง
jiemdang	เจียมตัง
siangmbiauh	เซียงเบย้า
hnyangxdueiv	หฮญังเตว๊ย
gaengzuangx	แกงหฒวัง
paaivpoux	พ้ายโผว
dangzaanv	ตังฒ้าน
wuomndaang	ววมดาง
hnievdaauh	เฮนี้ยต้าว
jiemdangjaax	เจียมตังจ๋า
jiemdieh	เจียมเตี้ย
ziecdorngh	เหฒี่ยต้อง
zauxzuih	เหฒาฒุ่ย
youzdiex	โย์วเตี๋ย
baeqvmuozdoic	แป๊ะมั์วต่อย
jaangvngongh	จ๊างง่ง
jaangvmbuov	จ๊างบั๊ว
jaangvdueivndaauv	จ๊างเตว๊ยด๊าว
jaangvjieqv	จ๊างเจี๊ยะ
jaangvnorqc	จ๊างเหนาะ
jaangvyangh	จ๊างยั่ง
gaengtiux	แกงถิว
jopvdorn	จ๊บตอน
zauxbenv	เหฒาเป๊น
saengkuvdaic	แซงคู้ไต่
orvsiqv	อ๊อซิ
orvlunx	อ๊อหลุน
orvlunx	อ๊อหลุน
orvlunx	อ๊อหลุน
orvlunx	อ๊อหลุน
goumaac	โกวหม่า
muocmaac	หมั่วหม่า
nziezmaac	เฑี์ยหม่า
baeqvdiex	แป๊ะเตี๋ย
nziezmaac	เฑี์ยหม่า
auvnzaengbuang	เอ๊าแฑงปวัง
ndeichlen	เด่ยเฮลน
buonvsin	ป๊วนซิน
muozmaac	มั์วหม่า
gorqvmienh	เก๊าะเมี่ยน
hnyangxsoux	หฮญังโสว
ndaauvdaauh	ด๊าวต้าว
baeqvmuoz	แป๊ะมั์ว
hnyangxsoux	หฮญังโสว
hnyangxsoux	หฮญังโสว
hnyangxsoux	หฮญังโสว
hnyangxsoux	หฮญังโสว
hnyangxsoux	หฮญังโสว
biouvndeic	เปี๊ยวเด่ย
lozmbiauh	โล์เบย้า
faamzinh	ฟามฒิ่น
buonvzinh	ป๊วนฒิ่น
buonvzinh	ป๊วนฒิ่น
buonvzinh	ป๊วนฒิ่น
buonvzinh	ป๊วนฒิ่น
ndiesiqv	เดียซิ
ndiembuov	เดียบั๊ว
ndieluoqc	เดียหลัวะ
zauxmbiec	เหฒาเบี่ย
niebaengh	เนียแป้ง
wuomim	ววมอิม
guaawuom	กวาววม
guaadomx	กวาต๋ม
janxkaeqv	จั๋นแคะ
waacmeiv	หว่าเม้ย
luigorqv	ลุยเก๊าะ
finkouv	ฟินโค้ว
douzmbietc	โต์วเบียด
mbaengxningv	แบ๋งนี้ง
mievndaang	เมี้ยดาง
buozzaangvtaatv	ปั์วฒ้างท้าด
siangmbiauh	เซียงเบย้า
koivsiqv	ค้อยซิ
koivdaic	ค้อยไต่
koivdaic	ค้อยไต่
mievciangv	เมี้ยเธี้ยง
mievciangv	เมี้ยเธี้ยง
ndiangxjaasic	เดี๋ยงจาสี่
buozjuonh	ปั์วจ้วน
camvhnoi	ธั้มฮนอย
douzsioux	โต์วเสียว
dozleiz	โต์เล์ย
wuommbeux	ววมเบ๋ว
ndaubeih	เดาเป้ย
zorngzengx	ฒองเหฒง
siangbiauv	เซียงเปย๊า
ndaamdorng	ดามตอง
luisiaamjieqv	ลุยซยามเจี๊ยะ
siangauv	เซียงเอ๊า
nziangdorh	เฑียงต้อ
sekvsekv	เซ้กๆ
ndaudeic	เดาเต่ย
gapvnqenx	กั๊บเหฆน
maadiev	มาเตี๊ย
hmeivndaan	เฮม้ยดาน
hmeivndaan	เฮม้ยดาน
hmienmueic	เฮมียนเหมว่ย
mbiungcmbuonv	บยู่งบ๊วน
mievlunx	เมี้ยหลุน
mbiungcgorng	บยู่งกอง
mievnyiemz	เมี้ยเญี์ยม
duqveix	ตุ๊เอ๋ย
daaulomc	ตาวหล่ม
jauvbouc	เจ๊าโป่ว
hlaangsiqv	ฮลางซิ
hlaangsiqv	ฮลางซิ
douzsioux	โต์วเสียว
lozheh	โล์เฮ่
lozluihoux	โล์ลุยโหว
baengmaanh	แปงม่าน
horngzhlen	ฮ์อง
mbonghlen	บงเฮลน
wuomzingv	ววมฒี้ง
hlieqvcie	เฮลียะเธีย
hlieqvmaazcie	เฮลียะม์าเธีย
nyorxmbuoqc	หญอบัวะ
jauvdorn	เจ๊าตอน
jauvnjuotv	เจ๊าฌ้วด
nyorxnjietc	หญอเหฌียด
cieyienh	เธียเยี่ยน
juangnyouz	จวังโญ์ว
buozndiev	ปั์วเดี๊ย
junzeiv	จุนเฒ้ย
douzbaav	โต์วป๊า
wuombouc	ววมโป่ว
njimvcou	ฌิ้มโธว
njimvmuonc	ฌิ้มหม่วน
junbaeng	จุนแปง
njimvcou	ฌิ้มโธว
njimvmuonc	ฌิ้มหม่วน
ndiangxfomv	เดี๋ยงฟ้ม
waacmaux	หว่าเหมา
sieqvdorndoic	เซียะตอนต่อย
mbongaivdorngx	บงไอ๊ต๋อง
sieqvdorndoic	เซียะตอนต่อย
waacormv	หว่าอ๊อม
waacormv	หว่าอ๊อม
sianghlaang	เซียงฮลาง
mbiencbuoz	เบี่ยนปั์ว
ceuvfaanh	เธ้วฟ่าน
biauvdungz	เปย๊าตู์ง
biauvdungz	เปย๊าตู์ง
faamlungz	ฟามลู์ง
nziouvnziouv	เฑี้ยวๆ
mbuangzmaac	บวั์งหม่า
maabuoc	มาปั่ว
maabuoc	มาปั่ว
maabuoc	มาปั่ว
enzingh	เอนฒี่ง
siangluindaauv	เซียงลุยด๊าว
junzeiv	จุนเฒ้ย
ongbuoc	องปั่ว
jiemnaauz	เจียมน์าว
jiemzueih	เจียมเฒว่ย
lozhnoi	โล์ฮนอย
jangjang	จังๆ
siangmienh	เซียงเมี่ยน
deicbung	เต่ยปูง
hlieqvzaangc	เฮลียะหฒั่ง
mbongqangx	บงฉัง
mbaengxcitv	แบ๋งธิด
mbaengxcitv	แบ๋งธิด
hmiensetv	เฮมียนเซ้ด
cangbaengx	ธังแป๋ง
dornlaai	ตอนลาย
dornlunx	ตอนหลุน
hlieqvlui	เฮลียะลุย
jaixzueiv	ไจ๋เฒว้ย
nzomzdauh	ฑ์มเต้า
butvndin	ปุ๊ดดิน
juvdaic	จู๊ไต่
juvmuo	จู๊มัว
fiemfingx	เฟียมฝีง
sinhlen	ซินเฮลน
waancwaanc’	หว่านๆ’
ndaunjang	เดาฌัง
hnyangxbienx	หฮญังเปี๋ยน
siangngongh	เซียงง่ง
siangcie	เซียงเธีย
nzauvhorngz	เฑ้าฮ์อง
ndaamvguh	ด๊ามกู้
kuotvnorm	ค้วดนอม
gingzingh	กีงฒี่ง
sianghungh	เซียงฮู่ง
jiepvnyeiz	เจี๊ยบเญ์ย
suangxdimc	สวังติ่ม
baengbieiv	แปงเปย๊ย
hengheng	เฮงๆ
wuomlaangc	ววมหล่าง
wuomndo	ววมโด
wuombamc	ววมปั่ม
sieqvnzueic	เซียะเหฑว่ย
korxzinh	ขอฒิ่น
maazlaanh	ม์าล่าน
maazsiepv	ม์าเซี้ยบ
gaengmau	แกงเมา
douzlouh	โต์วโล่ว
nzangvnouh	ฑั้งโน่ว
nzangvnouh	ฑั้งโน่ว
lozbenv	โล์เป๊น
zaangznyaah	ฒ์างญ่า
zaangznyaah	ฒ์างญ่า
mbingjieqv	บีงเจี๊ยะ
sianglui	เซียงลุย
sianglui	เซียงลุย
dozleiz	โต์เล์ย
buozndoqvdorn	ปั์วโด๊ะตอน
jiemngongh	เจียมง่ง
jiemngongh	เจียมง่ง
ziecdorngc	เหฒี่ยต่อง
ndiangxfangx	เดี๋ยงฝัง
cangnangv	ธังนั้ง
mienvmienv	เมี้ยนๆ
ndopvhlaang	ด๊บฮลาง
siangnzormc	เซียงหฑ่อม
ndiedoqc	เดียโตะ
hlieqvbouv	เฮลียะโป๊ว
nuqvnuqv	นุๆ
cungen	ธุนเกน
lozleiz	โล์เล์ย
guaengvmbaaix	แกว๊งบ๋าย
waacnziaaux	หว่าหฑยาว
mievyaang	เมี้ยยาง
sinhlen	ซินเฮลน
qongxqongx	ฉงๆ
junzeiv	จุนเฒ้ย
ndoqvhlen	โด๊ะเฮลน
baengguanh	แปงกวั้น
zauxndoqv	เหฒาโด๊ะ
hlieqvnjapv	เฮลียะฌับ
gongbuonc	กงป่วน
jiemjaadorngx	เจียมจาต๋อง
jiemcie	เจียมเธีย
gongmienh	กงเมี่ยน
ciqvcunx	ธิหธุน
ciqvcunx	ธิหธุน
jiemding	เจียมตีง
douztaanx	โต์วถาน
jiemgaengh	เจียมแก้ง
bieivzeiv	เปย๊ยเฒ้ย
gongbouhniev	กงโปวเฮนี้ย
nzangvjien	ฑั้งเจียน
nzangvjien	ฑั้งเจียน
jiemzinh	เจียมฒิ่น
fiuvtorngvbaaih	ฟิ้วท้องป้าย
horngzkuv	ฮ์องคู้
junbaengbieiv	จุนแปงเปย๊ย
maazgaengh	ม์าแก้ง
horngzgaengh	ฮ์องแก้ง
ndoqvdorn	โด๊ะตอน
camvnyungc	ธั้มหญู่ง
fiuvbaengbieiv	ฟิ้วแปงเปย๊ย
jiembunh	เจียมปุ้น
jiemnzormc	เจียมหฑ่อม
zeivfun	เฒ้ยฟุน
zeivfun	เฒ้ยฟุน
doicdoic	ต่อยๆ
lozjauv	โล์เจ๊า
jiemzaangc	เจียมหฒั่ง
wuomgaengh	ววมแก้ง
jiemzaangc	เจียมหฒั่ง
ndaubuonc	เดาป่วน
nzuncnzunc	หฑุ่นๆ
nzuncnzunc	หฑุ่นๆ
zeivfun	ยฟุน
ndiangxpaangh	เดี๋ยงพ่าง
saengnyeic	แซงเหญ่ย
douzndiouh	โต์วเดี้ยว
jienmengh	เจียนเม่ง
maazsiepv	ม์าเซี้ยบ
fiuvjien	ฟิ้วเจียน
mbuonxhoz	บ๋วนโฮ์
qiexndoqc	เฉียโดะ
sinbiei	ซินเปยย
tinbaengh	ทินแป้ง
forngcang	ฟองธัง
ndoqvzuonx	โด๊ะหฒวน
buozndiev’	ปั์วเดี๊ย’
wuomnzuih	ววมฑุ่ย
gaengnyorc	แกงหญ่อ
nyorxhmeingaengc	หญอเฮมยแหง่ง
siangjunbaeng	เซียงจุนแปง
camvbung	ธั้มปูง
waacpuix	หว่าผุย
hlaaxsoux	หฮลาโสว
ndiangxlunx	เดี๋ยงหลุน
orvjunc	อ๊อจุ่น
buvjaa	ปู๊จา
buvjaa	ปู๊จา
zauxnqo	เหฒาโฆ
zauxnqo	เหฒาโฆ
hmeivnauv	เฮม้ยเน้า
fuqvloqc	ฟุโหละ
hlieqvjaasic	เฮลียะจาสี่
mbungvfim	บู๊งฟิม
tinbaeng	ทินแปง
naangnzung	นางฑูง
haavhaav	ฮ้าๆ
mbiungcsuiv	บยู่งซุ้ย
qaqvleqc	ชะเหละ
mievnzungh	เมี้ยฑู่ง
ndiangxnzungh	เดี๋ยงฑู่ง
ndaukuotv	เดาค้วด
nziuvnziuv	ฑิ้วๆ
luijaang	ลุยจาง
faanfei	ฟานเฟย
ndauzuonx	เดาหฒวน
lozndauziouv	โล์เดาเฒี้ยว
mievzueix	เมี้ยเหฒวย
wuomndiepv	ววมเดี๊ยบ
wuomtaan	ววมทาน
zongczongc	หฒ่งๆ
koivndoqv	ค้อยโด๊ะ
mievmaeng	เมี้ยแมง
faamcing	ฟามธีง
wuomongx	ววมอ๋ง
niendunh	เนียดุ้น
gonghniev	กงเฮนี้ย
ciouvciouv	เธี้ยวๆ
hlieqvbiaav	เฮลียะปย๊า
ndiangxnjimv	เดี๋ยงฌิ้ม
suivliemh	ซุ้ยเลี่ยม
douzfing	โต์วฟีง
orvnziu	อ๊อฑิว
ndiangxlatv	เดี๋ยงลัด
lozgaeng	โล์แกง
kamxbui	ขัมปุย
jaanghoh	จางโฮ่
sinsei	ซินเซย
nziaauxjorm	หฑยาวจอม
faambung	ฟามปูง
fiuvnzaeng	ฟิ้วแฑง
jauvbaengh	เจ๊าแป้ง
singqiex	ซีงเฉีย
gingdongz	กีงต์ง
doixdekc	ต๋อยเตก
paanpaan	พานๆ
puoqvpuoqv	พัวะๆ
paanpaan	พานๆ
puoqvpuoqv	พัวะๆ
huaanghuaang	ฮวางๆ
zaangzaang	ฒางๆ
ndaatvndiev	ด๊าดเดี๊ย
feifangv	เฟยฟั้ง
siousengh	เซียวเซ่ง
jaangndiev	จางเดี๊ย
fiuvmbong	ฟิ้วบง
jiemlimc	เจียมหลิ่ม
dorziec	ตอเหฒี่ย
waacmaux	หว่าเหมา
waacgaam	หว่ากาม
cuqvmaux	ธุเหมา
faangbuangh	ฟางปวั้ง
zienzien	เฒียนๆ
muonzzanc	ม์วนหฒั่น
siangyouh	เซียงโย่ว
zozzoz	โฒ์ๆ
ndaamvseix	ด๊ามเสย
winjaa	วินจา
jauvzaqc	เจ๊าหฒะ
yiemyiem	เยียมๆ
hlieqvgaengh	เฮลียะแก้ง
ndaujunc	เดาจุ่น
torngvbaaih	ท้องป้าย
njimvlomc	ฌิ้มหล่ม
dorziec	ตอเหฒี่ย
feifangv	เฟยฟั้ง
feifangv	เฟยฟั้ง
diucdiuc	ติ่วๆ
hlieqvnqaiv	เฮลียะไฆ้
ndoqvnzuonx	โด๊ะหฑวน
biauvgorqv	เปย๊าเก๊าะ
hlieqvlimc	เฮลียะหลิ่ม
qomqaau	ชมชาว
jaaidaauh	จายต้าว
gorngvnjaaux	ก๊องหฌาว
jauvcaax	เจ๊าหธา
hlaaxjunh	หฮลาจุ้น
jaapvmaaz	จ๊าบม์า
koivminc	ค้อยหมิ่น
njienyouh	เฌียนโย่ว
dangvdorh	ตั๊งต้อ
nziangxdorh	เหฑียงต้อ
gorngvbaeqc	ก๊องแปะ
waaclongx	หว่าหลง
mueizdorngh	เมว์ยต้อง
wuomnamx	ววมหนัม
wuomnyuonh	ววมญ่วน
mievnqaai	เมี้ยฆาย
buozzaangvor	ปั์วฒ้างออ
wuombiom	ววมปยม
jaigorngx	ไจก๋อง
luisiouv	ลุยเซี้ยว
wuomnjaangh	ววมฌ่าง
hlaangsietv	ฮลางเซี้ยด
njimvnyang	ฌิ้มญัง
waacfaix	หว่าไฝ
hnyangxjeiv	หฮญัง
wuomkuotvnzuih	ววมค้วดฑุ่ย
camvdiuh	ธั้มติ้ว
dungzhaengh	ตู์งแฮ่ง
mbongcitv	บงธิด
wuomnyuonh	ววมญ่วน
suangsuiv	ซวังซุ้ย
gaengsorn	แกงซอน
baetvbaetv	แป๊ดๆ
gorqvjang	เก๊าะจัง
sungdorn	ซูงตอน
muocfaix	หมั่วไฝ
diuvkuv	ติ๊วคู้
mbonghlang	บงฮลัง
pouxpoux	โผวๆ
douztaanx	โต์วถาน
douztaanx	โต์วถาน
waacnjomc	หว่าหฌ่ม
laengclaengc	แหล่งๆ
deixdeix	เต๋ยๆ
lomcndiev	หล่มเดี๊ย
ndiangxndonx	เดี๋ยงด๋น
mbongnjang	บงฌัง
juvben	จู๊เปน
lomcmbiorqc	หล่มเบยาะ
gogo	โกๆ
mbieqvcou	เบี๊ยะโธว
gorxyouz	ก๋อโย์ว
wuomzuonx	ววมหฒวน
forvzeih	ฟ้อเฒ่ย
ndiangxding	เดี๋ยงตีง
fiuvjaadorngx	ฟิ้วจาต๋อง
diuvgorngc	ติ๊วก่อง
zauxcaaiv	เหฒาธ้าย
horngzdaauh	ฮ์องต้าว
ndaujunc	เดาจุ่น
ndaulongx	เดาหลง
ndaulongx	เดาหลง
ndaulongx	เดาหลง
ndauyouh	เดาโย่ว
caux	ปูงฮวาง
hlanghlang	ฮลังๆ
aivaiv	ไอ๊ๆ
buoznaamx	ปั์วหนาม
tinbaengh	ทินแป้ง
hleixguanh	เหฮลยกวั้น
kungxnziaaux	ขูงหฑยาว
hlieqvzueih	เฮลียะเฒว่ย
sungsung	ซูงๆ
jaandaangc	จาด่าง
junghungh	จูงฮู่ง
camvguoqv	ธั้มกั๊วะ
ndiangxkounqaai	เดี๋ยงโควฆาย
siangceix	เซียงเหธย
hlieqvjaapv	เฮลียะจ๊าบ
hlieqvmuoc	เฮลียะหมั่ว
nzangvguanh	ฑั้งกวั้น
siangmbuox	เซียงบั๋ว
siangndau	เซียงเดา
hlieqvndiouh	เฮลียะเดี้ยว
saibatckoivnzou	ไซ​ปัดค้อยโฑว
siangzoux	เซียงโหฒว
deicbung’	เต่ยปูง’
kungxkungx	ขูงๆ
mbongdorn	บงตอน
fiouxzoih	เฝียวฒ่อย
siangziouv	เซียงเฒี้ยว
wuomdoqc	ววมโตะ
maaznyienh	ม์าเญี่ยน
hlieqvlouh	เฮลียะโล่ว
jaaihorngc	จายห่อง
camvnzunc	ธั้มหฑุ่น
sianggaengh	เซียงแก้ง
hlieqvgaaz	เฮลียะก์า
lozmbong	โล์บง
siangngaengc	เซียงแหง่ง
gorqvgaengh	เก๊าะแก้ง
ndausou	เดาโซว
ndausou	เดาโซว
ndausou	เดาโซว
nieongx	เนียอ๋ง
ndausou	เดาโซว
diuvzaa	ติ๊วฒา
juangzinx	จวังหฒิน
ndielaangh	เดียล่าง
saengvziouv	แซ้งเฒี้ยว
nzormcfaix	หฑ่อมไฝ
huaanghuaang	ฮวางๆ
niendui	เนียดุย
jiepvdaamv	เจี๊ยบต๊าม
niemor	เนียมอ
douzmiec	โต์วเหมี่ย
youcyouc	โหย่วๆ
yienvbienx	เยี้ยนเปี๋ยน
huibaeqc	ฮวุยแปะ
huibaeqc	ฮวุยแปะ
buozkou	ปั์วโคว
buozkou	ปั์วโคว
douzganx	โต์วกั๋น
nziaamvndorngh	ฑย้ามด้อง
deicbung	เต่ยปูง
ndaamdorng	ดามตอง
sianghnyouv	เซียงเฮญี้ยว
sianglingh	เซียงลี่ง
hmeimaac	เฮมยหม่า
maazgouv	ม์าโก๊ว
buozzuih	ปั์วฒุ่ย
maazbaeng	ม์าแปง
ndiembuangh	เดียบวั้ง
nyei	ฑั้งเฒ่ย
saibatc	ค้อยโฑว
nzangvpaangh	ฑั้งพ่าง
ndiangxjieqv	เดี๋ยงเจี๊ยะ
maazgeh	ม์าเก้
wuomnzang	ววมฑัง
fiuvmbong	ฟิ้วบง
mbungvnqaai	บู๊งฆาย
zeivfaqv	เฒ้ยฟะ
kungxdorngx	ขูงต๋อง
zauxmueic	เหฒาเหมว่ย
ndoqvhlen	โด๊ะเฮลน
wuomnzaaih	ววมฑ่าย
wuomzaamv	ววมฒ้าม
wuombaeqc	ววมแปะ
sounzaangc	โซวหฑั่ง
guaiqaauv	ไกวช้าว
guaiqaauv	ไกวช้าว
guaiqaauv	ไกวช้าว
guaiqaauv	ไกวช้าว
guaiqaauv	ไกวช้าว
guaiqaauv	ไกวช้าว
guaiqaauv	ไกวช้าว
guaiqaauv	ไกวช้าว
kuotvndoqv	ค้วดโด๊ะ
ndaamvcaamx	ด๊ามหธาม
ciougen	เธียวเกน
ndiangxpeixzaa	เดี๋ยงเผยฒา
donggen	ตงเกน
biauvdorn	เปย๊าตอน
mbaengxqangx	แบ๋งฉัง
njimvmbiorngz	ฌิ้มบย์อง
ndenzndenz	เด์นๆ
nzauvkuotv	เฑ้าค้วด
dangzaanv	ตังฒ้าน
danggunv	ตังกุ๊น
maazjieqv	ม์าเจี๊ยะ
maazbaeqc	ม์าแปะ
jieqvbaeqc	เจี๊ยะแปะ
wuomkuotvnqaai	ววมค้วดฆาย
ndaudongz	เดาต์ง
korvlienh	ค้อเลี่ยน
fusux	ฟูสู
dungzndin	ตู์งดิน
baengcmbai	แป่งไบ
baengcmbai	แป่งไบ
butvbaengc	ปุ๊ดแป่ง
siangndie	เซียงเดีย
lozlui	โล์ลุย
siangndie	เซียงเดีย
ndeicziouv	เด่ยเฒี้ยว
ndeicziouv	เด่ยเฒี้ยว
ndeicziouv	เด่ยเฒี้ยว
laijaaix	ไลจ๋าย
waizwaiz	ไว์ๆ
wuomminc	ววมหมิ่น
eidouh	เอยโต้ว
eidouh	เอยโต้ว
eidouh	เอยโต้ว
saidiex	ไซเตี๋ย
nzauz	หฮนางเฮม้ย
camvdiuc	ธั้มติ่ว
simmbiuic	ซิมบยุ่ย
gonghnoi	กงฮนอย
ndiangxnormh	เดี๋ยงน่อม
cingjaahnaangx	ธีงจาหฮนาง
saidiex’	ไซเตี๋ย’
luindaauvsiqv	ลุยด๊าวซิ
luindaauvsiqv	ลุยด๊าวซิ
zouvgaengh	โฒ้วแก้ง
naucnauc	เหน่าๆ
siangnjaaux	เซียงหฌาว
lozndie	โล์เดีย
couxndiev	โหธวเดี๊ย
laijaaix	ไลจ๋าย
nyietvhnoi	เญี้ยดฮนอย
torqvsienx	เทาะเสียน
ndeicliuh	เด่ยลิ่ว
ndeicliuh	เด่ยลิ่ว
caengyienv	แธงเยี้ยน
mbiangxnziaaux	เบี๋ยงหฑยาว
gaengmau	แกงเมา
lozauv	โล์เอ๊า
siangnqox	เซียงโหฆ
auvguaavjomc	เอ๊ากว๊าจ่ม
ndielaengc	เดียแหล่ง
zioudingh	เฒียวตี้ง
kamxmbaang	ขัมบาง
zuizmienh	ฒุ์ยเมี่ยน
njimvlomc	ฌิ้มหล่ม
sieqvndoqc	เซียะโดะ
lozbiuv	โล์ปิ๊ว
lozbiauv	โล์เปย๊า
lozbiauv	โล์เปย๊า
baengcfouh	แป่งโฟ่ว
fiuvjauv	ฟิ้วเจ๊า
ndaamvjung	ด๊ามจูง
hnaangxhmeivndortv	หฮนางเฮม้ยด๊อด
mbienvmbeux	เบี๊ยนเบ๋ว
gornnyuonh	กอนญ่วน
ndiangxgorn	เดี๋ยงกอน
faauxfaaux	ฝาวๆ
njiecnjiec	เหฌี่ยๆ
ongxnzuih	อ๋งฑุ่ย
cingsuiv	ธีงซุ้ย
hlaangbin	ฮลางปิน
siangyungz	เซียงยู์ง
siangyungz	เซียงยู์ง
siangyungz	เซียงยู์ง
saigorx	ไซก๋อ
gornnyuonh	กอนญ่วน
ndaamvdingh	ด๊ามตี้ง
janxgikc	จั๋นกีก
sianglingc	เซียงหลี่ง
nzangvhlen	ฑั้งเฮลน
hiaangbung	ฮยางปูง
hiaangbung	ฮยางปูง
ndiedamh	เดียตั้ม
butvbaengc	ปุ๊ดแป่ง
siangmaengc	เซียงแหม่ง
ngaauvngaauv	ง้าวๆ
ndopvzaangc	ด๊บหฒั่ง
ndopvzaangc	ด๊บหฒั่ง
nzaengngaengc	แฑงแหง่ง
fiuvcongx	ฟิ้วหธง
ndapvornx	ดั๊บอ๋อน
siangleiz	เซียงเล์ย
faatvsou	ฟ้าดโซว
ceuvceuv	เธ้วๆ
teigorn	เทยกอน
teidaauh	เทยต้าว
baengbieiv	แปงเปย๊ย
nzangvdorn	ฑั้งตอน
nzangvdorn	ฑั้งตอน
kaeqvbiauv	แคะเปย๊า
waacdoqc	หว่าโตะ
siangziangh	เซียงเฒี่ยง
lozhnyouv	โล์เฮญี้ยว
korvlienh	ค้อเลี่ยน
gingsou	กีง
dornhnamv	ตอนฮนั้ม
lozbingv	โล์ปี๊ง
lozbingv	โล์ปี๊ง
finkouv	ฟินโค้ว
gitvgitv	กิ๊ดๆ
siangngaengc	เซียงแหง่ง
siangzeix	เซียงเหฒย
hnamvnzuonx	ฮนั้มหฑวน
doixdangc	ต๋อยตั่ง
gongzoh	กงโฒ่
waacmaux	หว่าเหมา
zeivfun	เฒ้ยฟุน
hmienminc	เฮมียนหมิ่น
zeivfun	เฒ้ยฟุน
dingczinh	ตี่งฒิ่น
hmienbeih	เฮมียนเป้ย
lozmaengc	โล์แหม่ง
lozmaengc	โล์แหม่ง
lozmaengc	โล์แหม่ง
dangxdouh	ตั๋งโต้ว
siangmaengc	เซียงแหม่ง
zeivzeiv	เฒ้ยๆ
nzaangcwaeqc	หฑั่งแหวะ
siangsienx	เซียงเสียน
auvguaavlunx	เอ๊ากว๊าหลุน
doucdouc	โต่วๆ
mbungvdaaux	บู๊งต๋าว
paanpei	พานเพย
mbiungcwuom	บยู่งววม
lozleizlatc	โล์เล์ยหลัด
siangjauv	เซียงเจ๊า
hnaangxdonx	หฮนางต๋น
hlaangkouv	ฮลางโค้ว
nzangvmbietc	ฑั้งเบียด
jienfouv	เจียนโฟ้ว
taaixbaeqc	ถายแปะ
wuomzingvnqaai	ววมฒี้งฆาย
siangyelusaalem	เซียงเย​ลู​ซา​เลม
luihouxbaeqc	ลุย
jiemningv	เจียมนี้ง
maazsiqv	ม์าซิ
maenglunx	แมงหลุน
luindaauvbaeqc	ลุยด๊าวแปะ
junghungh	จูงฮู่ง
junghungh	จูงฮู่ง
douzkoiv	โต์วค้อย
lozlungh	โล์ลู่ง
lozndau	โล์เดา
jiembiaavndorqc	เจียมปย๊าเดาะ
b	ป
b	ธ
d	ต
g	ก
hi	ฮย
hl	ฮล
hm	ฮม
hn	ฮนhn
hng	ฮง
hny	ฮญ
hu	ฮว
j	จ
l	ล
m	ม
mb	บ
n	น
nd	ด
ng	ง
nj	ฌ
nq	ฆ
ny	ญ
nz	ฑ
w	ว
y	ย
z	ฒ
a	า
aa	อา
e	เ
i	อี
o	โ
u	อู
ae	แ
aeq	แอ๊ะ
aet	แอ๊ด
ak	อัค
am	อัม
an	อัน
ang	อัง
ap	อับ
at	อัท
iaa	อีอา
iaai	อีอาย
iaam	อีอาม
iaan	อีอาน
iaau	อีอาว
iang	เอียง
iau	อีเอา
ie	เอีย
iei	เอย
iem	เอียม
ien	เอียน
iep	เอียบ
ieq	เอียะ
iet	เอียท
ik	อิค
im	อิม
in	อิน
ing	อิง
iorng	อีออง
ok	โอค
uan	อัน
uang	อัง
uat	อัท
uen	อีเอน
ui	อุย
uin	อุยน
un	อุน
iang	เอียง
ung	อูง
uo	อัว
uom	อวม
uon	อวน
uoq	อัวะ
uot	อวท
uq	อุ
ut	อุท
iorng	อีออง
ing	อิง
in	อิน
iorp	โออบ
iorq	อีเอาะ
iort	อียอด
iou	เอียว
ip	อิบ
iq	อิ
it	อิท
iu	อิว
iui	อีอุย
faanx	ฝาน
hnaav	ฮน้า
nqingh	ฆีง
nquaiz	ไฆว์ย
njaeh	แฌ่
