yesu	Yesu
yesu	Yesu
Ravg	nzaangc
tovb	dongh
Zx	cor
Tinb huvb	TinHungh
zeij	zeix
luvb	lungh
Dau	ndau
Zauj	caux
maang	maanc
mwrtg	muotc
Navq	hnangv
naaiq	naaiv
nx	nor
zyavj	ziangx
Revg	nzengc
aq	aqv
Tauj	taux
taZyetq	dacietv
Nxi	hnoi
zruj	zoux
ninb	ninh
Eei	nyei
kov	gong
zyrug	ziouc
tivb	dingh
hitq	hitv
Kwrnj	kuonx
Zwrtq	cuotv
Zeij	ceix
fuq	fuqv
pun	bun
uaq	wuov
nxm	norm
penj	benx
Revg	cingnzengc
weig	weic
zug	zuqc
yaag	yaac
Wivj	huingx
lrug	jauvlouc
se	se
zyruq	Ziouv
zang	zanc
maiq	maiv
kcvb	gaengh
maaib	maaih
haiq	haaix
Euvg	nyungc
miaq	miev
Dyavj	ndiangx
Kuvj	kungx
uam	wuom
yem	yiem
saamj	saamx
taaib	daaih
Dxn	ndorn
kxmj	gormx
cvj	aengx
zxq	zorqv
teij	deix
Buv	niembung
nanq	nanv
taub	dauh
myenb	mienh
pyomq	biomv
mcvg	maengc
Qiaj	qiex
piag	bieqc
Bazxv	mbazorng
tov	dong
puv	bung
kaEuad	nyuoz
Diaq	ndiev
maanb	maanh
Jiad	jiez
kxn	gorn
Yaavj	hiaangx
Jyenq	jienv
faauj	faaux
yuvd	yungz
tuq	duqv
siaq	sieqv
kxvq	gorngv
Buaj	mbuox
meib	meih
meib	meih
yetg	yietc
pyauq	biauv
Mwavq	hmuangv
txig	doic
xij	oix
Ravq	nzangv
Jaaj	jaax
yia	yie
pwatg	buatc
kanb	ganh
hxpg	horpc
Hruq	hnyouv
tafaanb	Dafaanh
wij	uix
Kuq	saengkuv
txb	dorh
siag	siec
txij	doix
kruq	gouv
Eeid	nyeiz
nxg	norqc
siaj	Siex
trug	douc
pwrnq	buonv
zuvq	zungv
laKuq	kuqv
Yiab	hieh
zxib	zoih
pwav	buang
waag	waac
txn	dorn
Bua	mbuo
Jweiq	dornjueiv
faq	funfaqv
pwavq	buangv
Tinb	tin
teig	Deic
trub	douh
Daub	ndaubeih
Exv	nyorng
kanaaiq	ganaaiv
Kxiq	koiv
Byaud	mbiauz
kamb	gamh
Riaj	nziex
Jiu	jiu
kunq	gunv
haib	haih
tovd	dongz
Eang	nyanc
hopq	hopv
ib	ih
Euvg	nyungcnyungc
zinb	zinh
Daavg	ndaangc
mivb	mingh
sem	Sem
haam	Haam
zeib	zeivfun
yemj	yiemx
liud	liuz
Gahaaq	nqa
pua	buo
Dug	nduqc
fib	fih
fivj	fingx
Lo	hlo
mevb	mengh
hog	hoc
zyruj	zioux
fivj	fingxfingx
myenb	mienh
ziuj	ziux
Jauq	jauv
lotq	Lotv
Zyetq	cietv
zyepg	ziepc
Mmd	hmz
Havj	hnyangx
auq	auv
fun	fun
lyemb	liemh
zxng	zornc
taub	dauh
puv	deicbung
mig	mi
kan	gan
Jiaj	jiex
zivb	zingh
tiub	diuh
tomb	domh
Baov	mbaong
zwei	zuei
hing	hinc
naaiq	Naaiv
ziab	ziecdorngh
ziag	ziec
huvb	hungh
Havb	hnyangxjeiv
Juaq	juov
yia	yie
nrnb	Nernh
mwavj	muangx
zang	zanczanc
lamb	lamh
Gemb	nqemh
txvj	dorngx
zweid	zueiz
liub	ndopvliuh
kaub	gauh
yuaq	yuoqv
zyavb	ziangh
seij	seix
zavg	zaangc
pcq	baeqv
Eig	nyic
Lav	hlang
koj	gox
haig	haic
lovg	longc
heug	heuc
Fiag	njiec
tivb	jaadingh
Ripg	nzipc
zeiq	zeiv
pwavb	buangh
Rung	nzunc
Waav	huaang
vxg	ngorc
lomb	lomchuaang
kwanb	guanh
paki	ba
yuvb	yungh
pweij	bueix
kaLen	gahlen
myenb	finmienh
pcv	baeng
fai	fai
Zyavq	ciangv
Paaiq	paaiv
fyenj	fienx
lxd	lorz
kxj	gorx
Faauj	njaaux
kau	gau
feij	feix
Gxi	nqoi
fuJweiq	fujueiv
i	i
nrub	nouh
peid	beiz
Puaq	puoqv
Zivj	cingx
fatq	fatv
mq paag	mv baac
Tiuj	tiux
zipq	zipv
Qam	qam
zom	zom
msiaq	m
Ryaaug	nziaauc
haid	haiz
Namq	hnamv
lovj	longx
Duaq	nduov
swiq	suiv
miub	miucfangx
kwavg	guangc
saaj	saax
yeng	yienc
hruj	luihoux
Zxg	corc
tia	die
lunj	lunx
leib	leih
pyauj	biaux
sin	sin
taEeig	danyeic
Tevj	tengx
mavg	mangc
waaig	waaic
taig	daic
Zaamj	caamx
prub	bouh
avung	angunc
tiuq	diuv
Jyen	jien
Fuaq	njuov
txvg	dorngc
tiaj	diex
kruj	goux
ting	dinc
pcvb	baengbieiv
wrnj	wuonx
lob	loh
laub	lauh
Beij	mbeix
sruq	souv
Daaib	Ndaaih
Len	hlen
yavb	yangh
vovb	ngongh
Rweig	nzueic
Jung	junc
luag	luoqc
tig	diqc
nxmb	normh
Byaub	mbiauh
maaid	maaiz
Naavj	hnaangx
taig	daic
Kruq	kouv
zaanq	zaanv
Eaanb	nyaanh
tapq	dapv
Buag	mbuoqc
Rwib	nzuih
pru	bou
ei	ei
Dxm	ndorm
Ryruq	nziouv
Fav	njang
fuvj	fungx
lxb	lorh
Rwrnj	nzuonx
zig	ziqc
navg	nangc
ko	go
kaanq	gaanv
zung	zunc
zaaig	zaaic
naaig	naaic
kaaj	gaax
tiug	diuc
Bua	mbuo
Eyend	nyienz
peq	beqv
hiuq	hiuv
Rxib	nzoih
kapq	gapv
zunq	zunv
hivq	hingv
sig	sic
aag	aac
Qaq	qaqv
taaub	daauh
muad	muoz
Rug	nzuqc
Daauq	ndaauv
tog	doqc
uag	wuoqc
king	ginc
taaq	daav
zaeij	zaeix
Zaavb	caangh
laavb	laangh
taij	daix
sweib	sueih
eij	eix
Vaq	hngaqv
lwavg	luangc
Jaan	jaan
tavj	dangx
laaij	laaix
Zyruq	ciouv
Zev	ceng
puad	buoz
wavq	winwangv
Jaav	jaang
kweig	gueic
paaij	baaix
syenb	sienh
saauq	saauv
laaug	laauc
yaavb	yaangh
vaatg	ngaatc
xq	orv
Baapq	mbaapv
kaamq	gaamv
hcq	haeqv
Eia	nyie
Dob	ndoh
Mei	hmei
Gwaab	nquaah
Roj	nzox
siq	siqv
Ryaamq	nziaamv
yemg	yiemc
peiq	beiv
pyruq	biouv
Zamq	camv
Len	koivhlen
kapg	gapvjaaix
taauj	daaux
henq	henv
laanb	laanh
BuDovj	ndongx
Daan	Ndaan
pcvb	baengh
fim	fim
syemq	siemv
pcg	baeqc
naav	naang
pivj	bingx
Laaj	hlaax
Eiag	nyieqc
Bweid	mbueiz
ziaq	zieqv
zuv	zung
Lxpq	hlorpv
vwaad	gunguaaz
an	an
lomg	lomc
txg	dorc
mavg	mangc
txv	dorng
RaMyen	nzahmien
vcvg	ngaengc
hxvb	horngh
hog	jangxhoc
lob	nzamc
latg	leizlatc
Ruv	nzung
Fruj	njoux
Taaib	taaih
Bxq	mborqv
o	O
Byaaug	mbiaauc
Jiaq	jieqv
paaig	baaic
Fopg	njopc
trud	douz
puaq	buov
Qwi	qui
Gaauq	nqaauv
zwavj	zuangx
sinj	sinx
Bov	mbong
Kav	kang
lyepg	liepc
sai	sai
sij	Se
kinq	ginv
Zwrtq	Cuotv
tuvq	dungx
zyenb	zienh
leid	leiz
zag	zaqc
nimg	nimc
xij	oix
fovg	fongc
hxg	horc
Jyem	jiem
swij	suix
setq	setv
Buaq	mbuov
lamaab	lamaah
pyei	biei
tav	dang
kalanq	galanv
yrub	youh
Daav	ndaang
laapg	laapc
liug	liuc
zxpg	zorpc
xn	orn
huv	hung
Jaaij	jaaix
lcvd	laengz
faav	Faang
kaEiag	ganyiec
pin	bin
hxmb	hormh
tasuq	dasuqv
pyaa	biaa
Dxg	ndorqc
Javq	jangv
kxq	gorqv
Pycv	piaeng
nctq	naetv
pyenb	bienh
kaDiaq	gandiev
mcvj	maengx
kcv	gaeng
laatg	laatc
naamb	naamh
Bcg	mbaeqc
tovg	dongc
fai	fai
Dia	ndie
Topq	topv
Taapq	taapv
weib	weih
pyaaq	biaav
Zxv	corng
wrnq	wuonv
tivj	dingx
vau	ngau
Buaj	Mbuox
zaaj	zaax
tinb	dinh
ziag	zieqc
tiab	dieh
Jxv	jorng
kaatq	gaatv
Ziq	ciqv
lxg	lorqc
tiu	diu
pyavb	biangh
zug	zuqc
Kwaaiq	kuaaiv
penq	labieivbenv
fiaq	fiev
huq	huv
hatg	hatc
pyenj	bienx
Datq	ndatv
zuq	zuqv
sivj	Singx
fub	fusux
Japq	japv
mwrng	muonc
Jaaiq	jaaiv
yenj	yienx
zib	Zih
scvb	saengyietv
wig	wuic
maan	maan
mGxvq	mnqorngv
fiq	fiqv
zwid	zuiz
Bwrnb	mbuonvmuonc
Zag	caqvbouc
Eeig	leiznyeic
Wiv	huing
Eutg	nyutc
peu	beu
nitq	nitv
pivq	bingv
tapetq	dabetv
kxg	gorqvmienh
huvb	hunglouh
Yetq	hietv
teib	deih
Baaij	mbaaix
Levj	hlengx
faan	faan
mJavg	mjangc
zcq	zaeqv
Raauj	nzaaux
Mwavj	hmuangx
muaq	muoqv
keb	geh
Byenq	mbienv
Myen	hmien
Pai	pai
Zyen	cien
maag	maac
naaiq	naaiv
tivg	dingc
zunb	zunh
Eeig	nyeic
ziaj	ziex
maiq	maiv
levg	lengc
Jeiq	jeiv
keg	gec
yem	yiem
Teij	teix
zuaq	zuov
Eiag	hnoinyieqc
lyrub	liouh
Bapyei	mbabiei
syaam	siaam
Kub	kuh
sei	sei
maa	maa
yrud	youz
muag	muoc
zeib	zeih
kuaq	guoqv
sig	jaasic
Juq	juqv
Zia	cie
komq	gomv
liub	liuh
pyeiq	bieiv
Ryemb	nziemxyaangh
Ratg	nzatc
Bwi	mbui
Kutq	Kutv
suv	sung
Byaag	biaavmbiaac
Taaij	ongtaaix
Jwavg	juangc
livg	lingc
Zoq	coqv
huvj	hungx
Dopq	ndopv
Jaavb	jaangh
zovb	zongh
kwei	guei
zavj	zangx
kwaij	guaix
aNeiq	hneiv
faatq	faatv
Win	huin
livb	Lingh
mziv	mzing
Tov	tong
Yenj	hienx
yuag	yuoqc
pcvg	wuonbaengc
pwrng	buonc
tayetq	da
hrud	houz
hruq	houv
Dxtq	ndortv
Goj	nqox
zakevb	za
lakwaib	fai
paag	baac
Jaa	jaa
Jaauq	jaauv
win	win
kaatg	Gaatc
Diaq	buozndiev
okg	Okc
faij	faix
Javj	jangx
lapyeiq	labieiv
Erud	nyouz
Raub	nzauh
Eyemq	nyiemv
Juv	jung
Faib	njaih
mrud	mouz
maanb	maanzhmuangx
muvq	Mungv
favj	fangx
yruj	youx
Riaq	nziev
hang	hanc
laavd	laangz
kxij	goix
fevj	fengx
pruq	bouv
Dutq	ndutv
zei	zei
cq	aeqv
palag	balaqc
Zapq	capv
maad	maaz
Zia	maazcie
og	oc
hxvd	horngz
laib	laih
Doq	ndoqv
nauq	nauv
yrud	gorxyouz
naab	naah
kwen	guen
lwi	lui
Dxpg	ndorpc
laud	lauz
puag	buoc
Jauj	jaux
txvb	dorngh
zig	zic
sruj	soux
mrug	mouc
syru	siou
Txvj	torngx
Zunb	cungaeng
ton	don
Wi	hui
zuaq	zuoqv
Raanj	nzaanx
mnxmb	mnormh
paamb	baamh
ken	gen
Toq	Tov
Einb	nyinh
pxvb	borngbuoz
nun	Nun
Gaai	nqaai
BaRiu	mbanziu
yug	yuqc
kwrn	guon
maiq	Maiv
ai	Ai
Zaavq	caangv
zuaq	zuov
waang	waanc
mwrnd	muonz
aiq	mbongaiv
hivb	hingh
Rcv	nzaeng
Duab	nduoh
puvb	bungh
zivq	wuomzingv
Zcvj	caengx
zevg	zengc
Daaub	ndaauh
Kauj	kaux
nipg	nipc
fivj	ndaamvfingx
nxmb	normnorm
Kauq	kauv
hod	hoz
paauj	baaux
Bxq	mborqv
tau	dau
fuvg	fungc
sig	sic
Raud	nzauz
kcq	gaeqv
zeid	zeiz
maaig	maaic
zaab	zaah
mivb	mingh
putq	butv
scvq	Saengv
Kwinj	kuinx
tafeij	dafeix
Eang	nyanc
tavb	dangh
Zeq	cienceqv
Bwavd	mbuangz
kanaaib	ganaaivcenv
Ryaauj	nziaaux
aanj	aanx
pavg	bangc
sru	sou
faq	faqv
supg	Supc
zyen	zien
Baib	mbaih
swei	suei
Zin	cin
kub	gu
vwaaig	nguaaic
Kitq	Kitv
Dovg	ndongc
Bcvg	mbaengc
Bataub	mbadauh
toj	dox
kikg	Gikc
pxq	borqv
kunq	gunv
Ziv	cing
Toq	tov
Jaiq	jaiv
zinj	juangzinx
pcv	junbaeng
mweig	mueic
Zavj	cangx
heij	heix
Fyenb	njienyouh
Rod	nzoz
Patq	patv
taanb	daanh
paab	baah
ping	binc
ninb	ninh
Euvg	haaix
puvj	bungx
xq	orqv
myenq	mienv
mxb	morh
Rav	nzang
Zav	cang
piu	biu
Ropq	nzopv
Fovg	njongc
tiv	ding
Jyenq	jienv
simq	simv
nopq	Nopv
zinj	zinx
katg	Gatc
zov	zong
Qyemj	qiemx
Do	ndo
zruq	zouv
Gaav	nqaang
hei	hei
tafaam	dafaam
taMmd	Dahmz
taluag	Daluoqc
mtaaib	mdaaih
Jwavg	juangc
Buvq	mbungv
hxig	hoic
maaib	maaih
winb	winh
en	en
ninb	ninh
maaib	Maaih
Jomg	jomc
mevb	congmengh
Raatq	nzaatv
Ken	ken
pwig	buic
Tx	tor
Dunb	ndunh
kxv	gorng
timq	dimv
Zuaq	cuoqv
mweid	mueiz
homg	homc
swavj	suangx
syruq	siouv
aapq	aapv
myenb	gongmienh
Jwav	juang
zuag	zuoqc
wib	wuih
faam	faam
kemb	gemh
faab	faah
lyrud	liouz
Dyrub	ndiouh
hcvb	haengh
Byxq	Mbiorv
funj	funx
ag	aqc
Txb	torh
zuq	zorngzuqv
Peij	peix
fug	fuc
syenj	sienx
uaq	Wuov
yetq	yietv
pcvg	baengc
zxv	zorng
pcvb	baengguanh
komb	gomh
hepg	hepc
Qovj	qongx
paamd	baamz
petq	betv
naang	naanc
Eaiq	nyaiv
Fung	njunc
taJuaq	dajuov
scvb	saengziepc
kwaatq	guaatv
taan	daan
Yetg	hietc
Rru	nzou
zaavq	zaangv
yem	Yiem
tunj	dunx
Zalevg	calengc
fiub	fiuvdaanh
Gaapq	nqaapv
Zaaub	caauh
hog	hoqc
panb	banh
zeig	zeic
Liaq	hlieqv
pen	ben
kevj	gengx
tauj	daux
kauj	gaux
laavg	njanglaangc
Jruj	joux
Pxq	porv
Buvb	mbungh
zwrtg	zuotc
Rxv	nzorng
nrud	nouz
zxg	zorc
Havb	hnyangxhnyangx
syepq	siepvsiepv
Beng	mbenc
pxvd	borngz
laaub	laauh
Kxi	koi
Zcq	caeqv
myetg	mietc
zaaij	zaaix
kxiq	goiv
fyruj	fioux
Jxm	jorm
tevq	dengv
BaNxi	mbahnoi
lapq	lapv
Genj	nqenx
Wrtq	huotv
vopq	ngopv
kaQiaj	gaqiex
fiu	fiu
Fxmb	njormh
Tiuq	tiuv
yopq	Yopv
feij	feix
faanb	faanh
Ryav	nziang
paamb	Baamh
kovb	gongzinh
Pyen	pien
zivj	zingx
lod	loz
aNxi	ahnoi
Koq	koqv
linb	linh
kxvq	gorngv
kwai	guai
aiq	aiv
myenb	Mienh
zog	zoqc
wrnb	wuonh
zaav	zaang
tavq	dangv
mxg	morc
navq	nangv
paaq	baav
lxg	ornlorqc
Baav	mbaang
naug	nauc
Eitg	nyitc
Kuq	kuv
lcvb	laengh
kcvq	gaengv
om	om
xg	orqc
kevb	gengh
zyavq	ziangv
mun	mun
wetq	wetv
tiaq	diev
Jaaq	jaav
tunb	dunh
yunb	yunh
syrug	siouc
Piaj	piex
zung	nziaauxzunc
Doq	gornndoqv
Laav	hlaang
Daub	ndauhuaang
Zunj	cunx
Kwavj	kuangx
eij	saengeix
Zovb	Congmengh
aaj	aax
sekq	sekv
Vovj	hngongx
prug	bouc
mau	mau
Pwij	puix
twib	duih
sxv	sorng
zauj	zaux
Bai	mbai
Diuj	ndiux
Fimq	njimv
Eiag	nyiec
Tipq	tipv
kxvb	gorngvbaeqc
Jyetq	jatv
zxi	zoi
laaib	laaih
lwig	luic
lovj	longx
Eau	nyau
Yenq	hienv
Niaq	hniev
vatq	ngatv
myenb	mienh
leid	leiz
muvd	mungz
zweij	zueix
tiq	diqv
Kwrtq	kuotv
Exq	nyorqv
Piq	piqv
zeg	zeqc
Bwrnj	mbuonx
paq	baqv
Exj	nyorx
heb	heh
Zamb	camh
zwib	zuih
Junb	junh
hrub	houh
scv	saeng
syruj	sioux
Ruvb	nzungh
Gwaaq	nquaav
zatq	zatv
Jyepq	jiepv
lyenb	korvlienh
vaang	ngaanc
Daatq	ndaatv
Eeig	jopvnyeic
yenb	yienh
syepq	siepv
lwib	luih
Qru	qouqou
Gwin	nquin
Dovj	ndongx
kwcvq	guaengv
mwrtq	muotv
Zai	cai
fim	gongfim
piuj	biux
Zau	cau
nivq	ningv
Dwi	ndui
Gwaab	ndiangxnquaah
Bweij	mbueix
zyruq	Ziouv
Luvb	hlungh
Lwrtq	hluotv
zweib	zueih
haand	haanz
pyopq	biopv
Gaiq	nqaiv
pctq	baetv
luq	luv
Dyavb	ndiangxgaaz
Jyenq	gaaz
Fung	sounjunc
limg	limc
Fwrtq	njuotv
mcq	maeqv
fxv	forng
Zunq	cunv
Deig	ndeic
yrug	youc
Jaub	jauh
Zeuj	ceux
lung	lunc
laKwrtq	lakuotv
Riad	nziez
Ziaq	ciev
tazyepg	daziepc
Tiv	ting
Zivb	cingh
Bxg	mborqc
tonj	donx
Zruj	coux
Rutq	nzutv
uaq	Wuov
zcv	zaeng
syem	siem
mauj	maux
zevj	zorngzengx
Diq	ndiqv
zuvb	zungh
kasia	gasie
Eyemg	nyiemc
Funb	njunh
Juq	juv
Daij	ndaix
kweij	gueix
Byuvg	mbiungc
samj	samx
Leij	hleix
sia	sie
swrng	suonc
Pruj	poux
BaNxi	dau
aaq	aav
Lxvj	hlorngx
Tov	poutong
Zivq	cingv
nxig	noic
Duaq	nduov
mcvb	maengh
tweiq	dueiv
kitq	gitv
Twij	tuix
Rov	nzong
tod	doz
Janj	Janx
kuq	guv
zuvj	zungx
Byenj	mbienx
Rru	koivnzou
Jwavq	juangv
taaij	daaix
lwrnj	luonx
hxvg	horngc
lyrug	liouc
tonq	donv
Byxvd	mbiorngz
peig	beic
navb	nangh
Jiuq	jiuv
saaij	saaix
kauq	gauv
Daam	ndaam
Byaavj	mbiaangx
Zru	cou
siaq	siev
mauq	mauv
Kwanq	kuanv
Pali	pali
Palaaij	palaaix
kwaaj	guaax
Jrub	jouh
zanj	zanx
kem	gem
Byaavg	mbiaangc
kxb	Gorxyouz
hemj	hemx
laEauq	lanyauv
Druq	ndouv
lovj	longxlongx
haab	haah
Ki	ki
zivb	enzingh
zanq	zanv
laavg	laangc
Qavj	qangx
Eung	nyunc
hevj	hengx
nxb	norh
zwid	zuiz
ninb	taux
Nxi	lozhnoi
Kcq	kaeqv
taaib	daaih
pyxvb	biorngh
Riag	nzieqc
mrub	mouh
syavb	siangnzung
punb	bunh
levb	lengh
Jaig	jaic
im	im
toq	dov
Zamj	camx
Qxv	qorng
fov	fong
mwrnb	muonh
maab	maah
setg	Setc
paatg	baatc
Jxib	joih
Gwaq	nquaqv
Dipg	ndipc
saaiq	saaiv
Yaamj	hiaamx
aab	aah
meij	meix
puq	buv
lovb	longh
Kruj	koux
kaaq	gaav
zyruq	zaeqvziouv
Bruq	mbouv
peuq	beuv
Txvq	torngv
Nxib	hnoihnoi
zyemj	ziemx
Ravb	nzangh
saab	saah
peib	beih
nia	nie
aaDam	Aandam
haawaa	Haawaa
Kaain	Kaain
aaBcn	Aambaen
Txi	toi
Zaa	caa
nyaa	niaa
mxvj	morngx
naq	naqv
Frub	njouh
Waaj	huaax
tov	Enden
enokq	Enokv
laamekq	Laamekv
aaDaa	Aandaa
syav	siang
tiq	div
zwavq	zuangv
enotq	Enotv
Kenan	Kenan
maahaalaalen	Maahaalaalen
yaaletq	Yaaletv
meTusejlaa	Metuselaa
noyaa	Noyaa
yaafetq	Yaafetv
aa	Aa
haapq	haapv
Go	nqo
Kaanaaan	Kaanaaan
kome	Gome
maakokg	Maagokc
maaDai	Maandai
yaawaan	Yaawaan
TuBan	Tumban
mesekq	Mesekv
Tilaatq	Tilaatv
atgKenatq	Atckenatv
lifaatq	Lifaatv
Tokaanmaa	Togaanmaa
eliseaa	Eliseaa
Taansitq	Taansitv
KitqTim	Kitvtim
loDaanim	Londaanim
iyipq	Iyipv
Putq	Putv
sejBaa	Sembaa
haawilaa	Haawilaa
sapgTaa	Sapctaa
laaaamaa	Laaaamaa
sapgTeKaa	Sapctekaa
QeBaa	Qembaa
DeDaan	Ndendaan
nimlotq	Nimlotv
taamq	daamv
ninaawe	Ninaawe
luDim	Lundim
aanaamim	Aanaamim
lehaaBim	Lehaambim
napqTuhim	Napvtuhim
hiwai	Hiwai
aanKaa	Aankaa
sijni	Sini
elaam	Elaam
atgsu	Atcsu
aanfaasatq	Aanfaasatv
luDe	Lunde
aalam	Aalam
utg	Utc
hun	Hun
keTe	Gete
Qelaa	Qelaa
eBe	Embe
yokqTaan	Yokvtaan
anmoDatg	Anmondatc
Qelepq	Qelepv
haasaanmaawetq	Haasaanmaawetv
yelaa	Yelaa
haaDolam	Haandolam
usaan	Usaan
Dikglaa	Ndikclaa
aaBimaaen	Aambimaaen
ofi	Ofi
yoBapg	Yombapc
fanb	fanh
BaaBen	Mbaamben
pelekq	Belekv
leu	Leu
sejlukq	Selukv
naaho	Naaho
Telaa	Telaa
apglaam	Apclaam
haalaan	Haalaan
saalaai	Saalaai
minKaa	Minkaa
nekepg	Negepc
faalo	Faalo
Betgen	Mbetcen
sojDom	Sondom
komolaa	Gomolaa
atgmaa	Atcmaa
sejBoyim	Semboyim
Belaa	Mbelaa
naaiq	Naaiv
sojaa	Soaa
zivb	Zingh
Taamaa	Taamaa
aamaalekq	Aamaalekv
aamolai	Aamolai
sitgDim	Sitcndim
Daamatqkatg	Ndaamatvgatc
KeDolaaome	Kendolaaome
cvj	aengx
aane	Aane
etgKo	Etcko
mamle	Mamle
paaib	torngvbaaih
eliyese	Eliyese
apglaaham	Apclaaham
kopq	gopv
Ewrnb	nyuonh
hitqTai	Hitvtai
pelitqsi	Belitvsi
lefaaim	Lefaaim
haakaa	Haagaa
isaamaaen	Isaamaaen
saalaa	Saalaa
ni	ni
zaamg	zaamc
loq	lov
zyrug	ziouc
fovq	fongv
paan	baan
kelaaaa	Gelaaaa
aaBimelekq	Aambimelekv
isakg	Isakc
hrug	houc
Ritq	nzitv
BeeQeBaa	Mbeeqembaa
lomb	lomh
Dog	ndoqc
haaso	Haaso
BeTuen	Mbetuen
leBeKaa	Lembekaa
heBolon	Hembolon
sojhaaj	Sohaax
efolon	Efolon
zaavb	zaangh
Ko	ko
lo	lo
ov	ong
kuj	gux
laaBaan	Laambaan
Kavq	kangv
zxq	zorv
KeTulaa	Ketulaa
yokqsaan	Yokvsaan
mitqmaa	Mitvmaa
Dumaa	Ndumaa
haaDatg	Haandatc
Temaa	Temaa
yeTu	Yetu
naafitq	Naafitv
KeDemaa	Kendemaa
esaau	Esaau
yaaKopq	Yaakopv
topg	dopc
filisaatia	Filisaadie
Beeli	Mbeeli
elon	Elon
Baasejmatq	Mbaasematv
Lua	hluo
Romd	nzomz
laasen	Laasen
syavj	siangx
naud	nauz
pyetq	bietv
laaBaan	Laambaan
Pyenj	pienx
Binhaa	Mbinhaa
leaa	Leaa
lewi	Lewi
napqTaali	Napvtaali
sinjpaa	Sinxbaa
witq	witv
saau	saau
DuDaaim	ndundaaim
Jiab	jieh
Dinaa	Ndinaa
tyemq	diemv
Pwi	pui
Pyatq	piatv
isaalaaen	Isaalaaen
yosepq	Yosepv
seji	Sei
haamo	Haamo
seKem	Sekem
simeon	Simeon
pwij	buix
efaalaaTaa	Efaalaataa
Benyaamin	Mbenyaamin
aase	Aase
se	se
elifatq	Elifatv
leuen	Leuen
Temaan	Temaan
omaa	Omaa
sejfo	Sefo
naahatg	Naahatc
zelaa	Zelaa
aanaa	Aanaa
yeutg	Yeutc
yaalaam	Yaalaam
Kolaa	Kolaa
oholiBaamaa	Oholimbaamaa
tovb	dongh
eDom	Endom
holi	Holi
homam	Homam
loTaan	Lotaan
Timnaa	Timnaa
soBaan	Sombaan
maanaahaatq	Maanaahaatv
eBaan	Embaan
onam	Onam
Dison	Ndison
etgBaan	Etcmbaan
itglaan	Itclaan
Kelaan	Kelaan
ese	Ese
Disaan	Ndisaan
aalan	Aalan
siBeon	Simbeon
eDom	Endom
DinhaaBaa	Ndinhaambaa
Bosaalaa	Mbosaalaa
husaam	Husaam
BeDatg	Mbendatc
moapg	Moapc
miDyen	Mindien
aawitq	Aawitv
samjlaa	Samxlaa
lehojBotg	Lehoxmbotc
saaun	Saaun
akgBo	Akcmbo
anwaa	Anwaa
yeTetq	Yetetv
elaa	Elaa
pinon	Binon
Kenatq	Kenatv
mipqsaa	Mipvsaa
DoTaan	Ndotaan
luBen	Lumben
yuDaa	Yundaa
Quaa	Quaa
eaa	Eaa
onan	Onan
hipqlu	Hipvlu
Jei	jei
naiaa	Naiaa
txq	dorv
Eauj	nyaux
lcb	laeh
siv	sing
fivq	fingv
haanokq	Haanokv
panlu	Banlu
hetqlon	Hetvlon
Kaanmi	Kaanmi
yemuen	Yemuen
yaamin	Yaamin
ohaatg	Ohaatc
yaaKin	Yaakin
keson	Geson
Kohaatq	Kohaatv
melaali	Melaali
itgsaajKaa	Itcsaaxkaa
Tolaa	Tolaa
simlon	Simlon
sejBulun	Sembulun
sejletq	Seletv
yaaleen	Yaaleen
hakqki	Hakvgi
suni	Suni
etgBon	Etcmbon
elei	Elei
aaleli	Aaleli
imnaa	Imnaa
itgwaa	Itcwaa
itgwi	Itcwi
Beliyaa	Mbeliyaa
selaaaa	Selaaaa
heBe	Hembe
BeKe	Mbeke
atgBen	Atcmben
kelaa	Gelaa
naaaamaan	Naaaamaan
aatg	Aatc
husim	Husim
yaasien	Yaasien
kuni	Guni
yese	Yese
sinlem	Sinlem
kosen	Gosen
Eim	nyim
maanatqsej	Maanatvse
efaaim	Efaaim
Eaab	nyaah
Zei	cei
JxDcn	Jorndaen
maaKi	Maaki
mose	Mose
aalon	Aalon
zyav	ziang
lweig	lueic
lipqni	Lipvni
simei	Simei
maali	maazli
musi	Musi
itghaa	Itchaa
nefekq	Nefekv
sikgli	Sikcli
utgsien	Utcsien
misaaen	Misaaen
ensaafaan	Ensaafaan
naason	Naason
naaDapg	Naandapc
iTaamaa	Itaamaa
atgsij	Atcsi
enKaanaa	Enkaanaa
eleaasaa	Eleaasaa
finehatg	Finehatc
yaamb	yaamh
ziq	ziqv
Zaij	caix
Len	biauvhlen
faanq	faanv
Raug	douznzauc
pxg	borqc
Baali	mbaali
mapq	mapv
zyruq	Ziouv
Daamq	ndaamv
zrug	zouc
sukgKotq	Sukckotv
Zib	cih
aaBipg	Aambipc
zyetg	zietc
milyem	Miliem
xb	orqv
mxq	morqv
lefiDim	Lefindim
huaa	Huaa
yosuwaa	Yosuwaa
zutg	zutc
yeTo	Yeto
Jaavq	jaangv
sinaai	Sinaai
Bovb	Mbongningv
Genj	mbongnqenx
hanb	hanh
luvd	lungz
pwib	buih
leig	leic
wcvg	waengc
aaBihu	Aambihu
Kwiv	kuing
KeluBim	kelumbim
wcvb	waengh
lunb	lunh
nekq	nekv
Kru	kou
wrng	wuonc
efotq	efotv
Paanj	paanx
Divb	ndingh
txv	ndaamdorng
Ganj	nqanx
Ywav	hiuang
kiv	ging
Peuj	peux
uli	Uli
Besaalen	Mbesaalen
Bwrnq	mbuonv
sxtq	sortv
setq	siousetv
yeButg	Yembutc
cvq	aengv
oholiapg	Oholiapc
kuvb	gungh
kavg	gangc
Kwiv	nyatv
Jaavb	caeqvjaangh
Zaan	caan
kxg	gorqc
Kwei	kuei
Jwij	juix
Zcv	caeng
naatq	naatv
ulim	Ulim
Tummim	Tummim
puaq	buoqv
omj	omx
syetq	sietv
puab	buozzaangv
mcv	maeng
kwaaib	guaaih
laaud	laauz
molekq	Molekv
syrub	siouh
Ryepq	nziepv
Laau	hlaau
selomitq	Selomitv
fivj	buonvfingx
sujlisatqDai	Suxlisatvndai
selumien	Selumien
amminaaDapg	Amminaandapc
zuaa	Zuaa
neTanen	Netanen
helon	Helon
eliapg	Eliapc
ammihutq	Ammihutv
elisaamaa	Elisaamaa
peDaasu	Bendaasu
kaamaalien	Gaamaalien
kiDeoni	Gindeoni
aaBiDan	Aambindan
aahiyese	Aahiyese
oKaan	Okaan
paakien	Baagien
Deuen	Ndeuen
eliyaasaapg	Eliyaasaapc
enan	Enan
aahilaa	Aahilaa
amlaam	Amlaam
elisaafaan	Elisaafaan
Bxv	mborng
maanaa	maanaa
mweij	mueix
zepq	zepv
sakgke	Sakcge
sammuwaa	Sammuwaa
saafatq	Saafatv
yefunne	Yefunne
Kaalepq	Kaalepv
ikaan	Igaan
hoseyaa	Hoseyaa
miKaaen	Mikaaen
yaaug	yaauc
heg	hec
Ria	nzie
zitg	zitc
homaa	Homaa
tekg	doixdekc
DaaTaan	Ndaataan
aaBilam	Aambilam
syavb	siangsic
yemb	yiemh
lob	loh
zxvb	zorngh
meliBaa	Melimbaa
KaaDetg	Kaandetc
hoaa	Hoaa
aalaatq	Aalaatv
tog	naangdoqc
zeletq	Zeletv
sihonj	Sihonx
hetqBon	Hetvmbon
Kemotq	Kemotv
Biag	mbiec
sipgpo	Sipcbo
Baalaakq	Mbaalaakv
Baalaaam	Mbaalaaam
laaig	laaic
Baaan	Mbaaan
zevj	zengx
Beo	Mbeo
Kenai	Kenai
peo	Beo
simjli	Simxli
KotqBi	Kotvmbi
sujaa	Suxaa
otgni	Otcni
yaasupq	Yaasupv
atglien	Atclien
semiDaa	Semindaa
hefe	Hefe
sejlofehatg	Selofehatc
maahaalaa	Maahaalaa
hokqlaa	Hokvlaa
Tilaasaa	Tilaasaa
suham	Suham
kileaatg	Gileaatc
maaKile	Maakile
aaBaalim	Aambaalim
ewi	Ewi
leKem	Lekem
leBaa	Lembaa
Juvd	jungz
mikqDon	Mikvndon
lipqnaa	Lipvnaa
Taahatg	Taahatc
yotqBaaTaa	Yotvmbaataa
oBotg	Ombotc
neBo	Nembo
atgmon	Atcmon
meDitelenyen	Mendidelenien
haamatq	Haamatv
sejDatg	Sendatc
BukgKi	Mbukcki
hannien	Hannien
Kemuen	Kemuen
panTien	Bantien
aahihutq	Aahihutv
eDeni	Endeni
atgTaalotq	Atctaalotv
Baasaan	Mbaasaan
holepq	Holepv
zinb	Zinh
aanaakq	Aanaakv
yaahaatq	Yaahaatv
aankopg	Aangopc
sxn	sorn
hemon	Hemon
saiDxn	Saindorn
sejni	Seni
mru	mou
penq	benv
aalaaBaa	Aalaambaa
pitgkaa	Bitcgaa
Juaq	juoqv
Jyenb	jienh
Gcq	nqaeqv
mag	maqc
Jamq	jamv
Zaaiq	caaiv
lov	long
weig	weic
puad	kungxbuoz
Jyemj	jiemx
fin	fin
ammon	Ammon
vaib	ngaih
ling	linc
tru	dou
pcvj	baengx
Tutq	tutv
kelisim	Gelisim
Tovj	tongx
aamen	Aamen
puag	buoqc
Gaatq	nqaatv
yav	yang
laahapg	Laahapc
kinkaan	Gingaan
yeliKo	Yeliko
sapgDi	Sapcndi
aaKaan	Aakaan
Dapq	ndapv
kiBeon	Gimbeon
Beelotq	Mbeelotv
yelusaalem	Yelusaalem
yaanmutq	Yaanmutv
laaKitq	Laakitv
yaafia	Yaafie
ekglon	Ekclon
DeBi	Ndembi
aaseKaa	Aasekaa
makqKeDaa	Makvkendaa
aiyaalon	Aiyaalon
kese	Gese
yaaBin	Yaambin
maaDon	Maandon
akgsaapq	Akcsaapv
mitqpaa	Mitvbaa
Tauq	tauv
aaDunlam	Aandunlam
Tapqpuwaa	Tapvbuwaa
aafekq	Aafekv
mekitgDo	Megitcndo
KeDetg	Kendetc
Kaanmen	Kaanmen
yokqneam	Yokvneam
koyim	Goyim
kesu	Gesu
maaaaKaa	Maaaakaa
saajleKaa	Saaxlekaa
KeDemotq	Kendemotv
mefaaaatg	Mefaaaatc
Baaaalaa	Mbaaaalaa
Timnaahaa	Timnaahaa
akgsaaj	Akcsaax
otgnien	Otcnien
taand	daanz
sipgaa	Sipcaa
Telem	Telem
Beaalotq	Mbeaalotv
semaa	Semaa
molaaDaa	Molaandaa
esem	Esem
enTolatq	Entolatv
sikglaakq	Sikclaakv
matqmannaa	Matvmannaa
sojKo	Soko
BotgKaatq	Mbotckaatv
eTe	Ete
aaQan	Aaqan
atgnaa	Atcnaa
aanaapq	Aanaapv
etgTemoaa	Etctemoaa
aalapg	Aalapc
maaon	Maaon
yitqleen	Yitvleen
keDo	Gendo
aaTaalotq	Aataalotv
naaaalaa	Naaaalaa
silo	Silo
apgwim	Apcwim
ofaalaa	Ofaalaa
laamaa	Laamaa
mosaa	Mosaa
Kision	Kision
eBetg	Embetc
hammatq	Hammatv
Kinneletq	Kinneletv
sojlaa	Solaa
etgTaaon	Etctaaon
eKolon	Ekolon
enTeKe	Enteke
kipgBeTon	Gipcmbeton
Baaaalatq	Mbaaaalatv
Besekq	Mbesekv
sesai	Sesai
aahimaan	Aahimaan
Tanmai	Tanmai
akgsipq	Akcsipv
lehopg	Lehopc
ehutq	Ehutv
Byeng	mbienc
aanaatq	Aanaatv
samkaa	Samgaa
DeBolaa	Ndembolaa
aaBinoam	Aambinoam
TaaBo	Taambo
sisejlaa	Siselaa
timg	dimc
Eomg	nyomc
Zovj	congx
kiDeon	Gindeon
yoaatg	Yoaatc
uamb	wuomhlen
Byetg	mbietc
aaBiyese	Aambiyese
zeBaa	Zembaa
sanjmunnaa	Sanxmunnaa
penuen	Benuen
heletq	Heletv
kaam	gaam
yoTaam	Yotaam
Bee	Mbee
sejBun	Sembun
kaaan	Gaaan
Kiv	king
Rauq	nzauv
haad	haaz
TeBetg	Tembetc
saami	Saami
Jaai	Jaai
yepqTaa	Yepvtaa
aaloe	Aaloe
Betglehem	Mbetclehem
pilaaTon	Bilaaton
apgDon	Apcndon
maanoaa	Maanoaa
scmsanj	Saemsanx
kwcvj	guaengx
kaasaa	Gaasaa
Delilaa	Ndelilaa
Gamq	nqamv
miKaa	Mikaa
laaitg	Laaitc
kiBeaa	Gimbeaa
uaq	Wuov
naaomi	Naaomi
elimelekq	Elimelekv
luTe	Lute
maalon	Maalon
Kilion	Kilion
Eaam	Nyaam
Juab	juoh
Niaq	hnievhniev
maalaa	Maalaa
Boaatg	Mboaatc
ovj	ongx
Zamq	camvcamv
Ryen	nzien
Tovq	tongv
laam	Laam
sanjmon	Sanxmon
oBetg	Ombetc
Jyetgsi	Jetcsi
Daawitq	Ndaawitv
Eei	buonvzingh
eli	Eli
peninnaa	Beninnaa
hannaa	Hannaa
yuvd	saengyungz
saamuen	Saamuen
atgDotg	Atcndotc
txvj	lozdorngx
aaBinaaDapg	Aambinaandapc
Damq	ndamv
saulo	Saulo
zrub	zouh
fwij	fuix
yaaBetg	Yaambetc
naahaatg	Naahaatc
mikqmaatq	Mikvmaatv
suan	Suan
yonaaTaan	Yonaataan
aahiyaa	Aahiyaa
apgne	Apcne
ne	Ne
aaBien	Aambien
suwaa	Suwaa
aakakg	Aagakc
sammaa	Sammaa
Myenb	hmienfangx
koliatg	Goliatc
naamj	naamx
saaaalaaim	Saaaalaaim
siag	Sieqvhlo
heug	Melaapv
miKaan	Mikaan
naayotq	Naayotv
aahimelekq	Aahimelekv
aaKitq	Aakitv
Doekg	Ndoekc
aahiTupq	Aahitupv
aaBiyaaTaa	Aambiyaataa
Keilaa	Keilaa
naaBaan	Naambaan
aaBikaayin	Aambigaayin
aahinoam	Aahinoam
sejluyaa	Seluyaa
yoaapg	Yoaapc
aaBiQai	Aambiqai
sunem	Sunem
kinBoaa	Ginmboaa
poj	box
tyen	dien
KeleTi	Keleti
yiaq	yieqv
laamotq	Laamotv
yaatqTi	Yaatvti
yelaameen	Yelaameen
xpq	orpv
Jyemb	jiemh
yaasaa	Yaasaa
itgBosetq	Itcmbosetv
maahaanaaim	Maahaanaaim
Faavb	njaangh
aasaajhen	Aasaaxhen
amnon	Amnon
aaDoniyaa	Aandoniyaa
hakqkitg	Hakvgitc
sefaaTiyaa	Sefaatiyaa
kitgTaaim	Gitctaaim
limmon	Limmon
leKaapq	Lekaapv
Baaaanaa	Mbaaaanaa
minlo	Minlo
naaTan	Naatan
saalomxn	Saalomorn
ipghaa	Ipchaa
elisuwaa	Elisuwaa
eliyaaDaa	Eliyaandaa
elifeletq	Elifeletv
keBaa	Gembaa
utgsaa	Utcsaa
wivg	wingc
laamj	laamx
sijDaa	sindaa
sojBaa	Sombaa
haaDatgese	Haandatcese
yufetitg	Yufeditc
silia	Silie
yehoyaaDaa	Yehoyaandaa
Benaiyaa	Mbenaiyaa
Peletq	Peletv
siBaa	Simbaa
mefiBosetq	Mefimbosetv
haanun	Haanun
BatgQeBaa	Mbatcqembaa
uliaa	Uliaa
lapqBaa	Lapvmbaa
apgsaalom	Apcsaalom
yonaaDapg	Yonaandapc
TeKoaa	Tekoaa
itgTai	Itctai
saajDokg	Saaxndokc
aahimaaatg	Aahimaaatc
aahiTofen	Aahitofen
husai	Husai
Baasinlai	Mbaasinlai
aamaasaaj	Aamaasaax
Bikgli	Mbikcli
ilaa	Ilaa
aiaa	Aiaa
litqpaa	Litvbaa
simehaa	Simehaa
Reng	nzenc
Gcvg	nqaengc
taub	Dauh
aahojhai	Aahoxhai
DoDo	Ndondo
haalaa	Haalaa
enhaanan	Enhaanan
haalotq	Haalotv
heletqTe	Heletvte
ikgKetg	Ikcketc
aanaaTotq	Aanaatotv
husaa	Husaa
neTofaa	Netofaa
maahaalai	Maahaalai
liBai	Limbai
kaaatg	Gaaatc
Baahulim	Mbaahulim
atgmaawetq	Atcmaawetv
aahiyam	Aahiyam
kilon	Gilon
hetqlo	Hetvlo
Baani	Mbaani
sejlekq	Selekv
naahaalai	Naahaalai
itglai	Itclai
kaalepq	Gaalepv
uliyaa	Uliyaa
yaase	Yaase
aalaaunaa	Aalaaunaa
ninb	Ninh
aaBiQaakq	Aambiqaakv
aasaaliyaa	Aasaaliyaa
aahilutq	Aahilutv
itgDo	Itcndo
yehosaafatq	Yehosaafatv
Jai	jai
hilaam	Hilaam
leBaanxn	Lembaanorn
aaDonilam	Aandonilam
lxvj	lorngx
Tei	tei
penq	ndiangxbenv
taau	daau
Ripq	nzipv
ywrnb	yuonh
Tailaq	Tailaqv
lovd	longz
sevb	sengh
Rxmg	nzormc
sion	Sion
kaalili	Gaalili
Taapenetq	Taabenetv
yeloBoam	Yelomboam
lehojBoam	Lehoxmboam
zyruq	lozziouv
aaBiyaa	Aambiyaa
Daavg	jaandaangc
sisakq	Sisakv
neBatg	Nembatc
aaBiyam	Aambiyam
aaBiQaalom	Aambiqaalom
aasaaj	Aasaax
BaaaaQaa	Mbaaaaqaa
omli	Omli
saamaalia	Saamaalie
aahapg	Aahapc
aaselaa	Aaselaa
eliyaa	Eliyaa
oBaaDi	Ombaandi
yeseBen	Yesemben
Kison	Kison
yehu	Yehu
elisaa	Elisaa
haasaaen	Haasaaen
naaBotg	Naambotc
imlaa	Imlaa
miKaayaa	Mikaayaa
aahatgyaa	Aahatcyaa
sinhi	Sinhi
aasuBaa	Aasumbaa
yolam	Yolam
yeholam	Yeholam
saib	SaiDiex
oq	Ov
kehaasi	Gehaasi
tong	donc
fai	fai
sib	sih
aannon	Aannon
yehoaahaatg	Yehoaahaatc
aaTaaliyaa	Aataaliyaa
lwrnb	luonh
Baij	mbaix
tavb	njapv
Fiuq	njiuv
yehoaatg	Yehoaatc
aamaasiyaa	Aamaasiyaa
Daau	ndaau
sejKaaliyaa	Sekaaliyaa
sanlum	Sanlum
utgsiyaa	Utcsiyaa
kaaDi	Gaandi
menaahem	Menaahem
atgsilia	Atcsilie
peKaahiyaa	Bekaahiyaa
lemaaliyaa	Lemaaliyaa
peKaa	Bekaa
aahatg	Aahatc
lesin	Lesin
Kiaa	Kiaa
miDia	Mindie
BaaBilon	Mbaambilon
sejfaanwaaim	Sefaanwaaim
heseKiyaa	Hesekiyaa
sennaaKelipq	Sennaakelipv
isaayaa	Isaayaa
aanpatg	Aanbatc
henaa	Henaa
ipgwaa	Ipcwaa
opq	opv
aamon	Aamon
yosiyaa	Yosiyaa
aaDaayaa	Aandaayaa
mesunlaam	Mesunlaam
aasaalaiyaa	Aasaalaiyaa
saafaan	Saafaan
hinKiyaa	Hinkiyaa
aahiKam	Aahikam
aasaajyaa	Aasaaxyaa
hunDaa	Hunndaa
Kitglon	Kitclon
sin	buonvsin
haamuTaan	Haamutaan
yelemi	Yelemi
lipqlaa	Lipvlaa
yehoyaaKim	Yehoyaakim
peDaayaa	Bendaayaa
yehoyaaKin	Yehoyaakin
ennaaTan	Ennaatan
sejDeKiyaa	Sendekiyaa
aanwatq	Aanwatv
matqsaaj	Matvsaax
kaaTaam	Gaataam
mitqsaa	Mitvsaa
anwaan	Anwaan
Binhaan	Mbinhaan
saajwaan	Saaxwaan
matqleKaa	Matvlekaa
makqDien	Makvndien
ilaam	Ilaam
peletq	Beletv
haamun	Haamun
eTaan	Etaan
hemaan	Hemaan
KaanKo	Kaanko
DaanDaa	Ndaanndaa
yeTe	Yete
sejkupg	Segupc
sammai	Sammai
aaBihaain	Aambihaain
itgi	Itci
sesan	Sesan
akglai	Akclai
saajBaatg	Saaxmbaatc
eleaasaaj	Eleaasaax
yeKaamiyaa	Yekaamiyaa
peletg	Beletc
efaa	Efaa
saaapg	Saaapc
Qewaa	Qewaa
simeaa	Simeaa
nokaa	Nogaa
sejlupqBaaBen	Selupvmbaamben
haananyaa	Haananyaa
BeleKiyaa	Mbelekiyaa
pelaaTiyaa	Belaatiyaa
yesaayaa	Yesaayaa
lefaiyaa	Lefaiyaa
seKaaniyaa	Sekaaniyaa
semaiaa	Semaiaa
hatqTatq	Hatvtatv
neaaliyaa	Neaaliyaa
elionai	Elionai
atgliKam	Atclikam
hoDaawiyaa	Hondaawiyaa
eliyaasipq	Eliyaasipv
pelaiyaa	Belaiyaa
akgKupg	Akckupc
yohaanan	Yohaanan
Delaiyaa	Ndelaiyaa
leaayaa	Leaayaa
yaahaatg	Yaahaatc
etaam	Edaam
itgmaa	Itcmaa
helaa	Helaa
paasejaa	Baaseaa
sejlaiaa	Selaiaa
etglaa	Etclaa
meletq	Meletv
efe	Efe
Kenan	Kenan
maahaalaalen	Maahaalaalen
enokq	Enokv
meTusejlaa	Metuselaa
noyaa	Noyaa
aalam	Aalam
Qelaa	Qelaa
isakg	Isakc
loTaan	Lotaan
Dison	Ndison
haaDatg	Haandatc
yuDaa	Yundaa
amminaaDapg	Amminaandapc
naason	Naason
sanjmon	Sanxmon
oBetg	Ombetc
Jaai	Jaai
sesan	Sesan
naaTan	Naatan
yehu	Yehu
Daawitq	Ndaawitv
lehojBoam	Lehoxmboam
aaBiyaa	Aambiyaa
aasaaj	Aasaax
aamaasiyaa	Aamaasiyaa
aasaaliyaa	Aasaaliyaa
aahatg	Aahatc
heseKiyaa	Hesekiyaa
ammon	Ammon
yehoyaaKin	Yehoyaakin
sejlupqBaaBen	Selupvmbaamben
yesaayaa	Yesaayaa
lefaiyaa	Lefaiyaa
oBaaDi	Ombaandi
semaiaa	Semaiaa
yaahaatg	Yaahaatc
maalesaa	Maalesaa
keDelaa	Gendelaa
nemuen	Nemuen
yaalipq	Yaalipv
sanlum	Sanlum
mipqsamj	Mipvsamx
sakgke	Sakcge
aayin	Aayin
yoen	Yoen
aasien	Aasien
aaDien	Aandien
zizaa	Zizaa
yeDaayaa	Yendaayaa
simli	Simli
miKaa	Mikaa
kileaatg	Gileaatc
miKaaen	Mikaaen
Butg	Mbutc
aahi	Aahi
elien	Elien
finehatg	Finehatc
aaBiQuwaa	Aambiquwaa
BukgKi	Mbukcki
utgsi	Utcsi
sejlaahiyaa	Selaahiyaa
sejlaahiyaa	Selaahiyaa
melaayotq	Melaayotv
aamaaliyaa	Aamaaliyaa
aamaaliyaa	Aamaaliyaa
saajDokg	Saaxndokc
hinKiyaa	Hinkiyaa
yehosaaDakg	Yehosaandakc
neBuKatqnetqsaa	Nembukatvnetvsaa
simjmaa	Simxmaa
yoaa	Yoaa
zelaa	Zelaa
enKaanaa	Enkaanaa
eBiyaasaapg	Embiyaasaapc
eBiyaasaapg	Embiyaasaapc
Taahatg	Taahatc
ulien	Ulien
utgsiyaa	Utcsiyaa
eliapg	Eliapc
yeloham	Yeloham
yeloham	Yeloham
simeaa	Simeaa
maahaatq	Maahaatv
aamaasaij	Aamaasaix
yoen	Yoen
sejfanyaa	Sefanyaa
atgsij	Atcsi
itghaa	Itchaa
Kohaatq	Kohaatv
lewi	Lewi
aasaapg	Aasaapc
aasaapg	Aasaapc
BeleKiyaa	Mbelekiyaa
manKiyaa	Mankiyaa
simjmaa	Simxmaa
keson	Geson
apgDi	Apcndi
manlukq	Manlukv
haasaapiyaa	Haasaabiyaa
haasaapiyaa	Haasaabiyaa
amsi	Amsi
amsi	Amsi
Baani	Mbaani
Qeme	Qeme
maali	maazli
melaali	Melaali
utgsi	Utcsi
melaayotq	Melaayotv
DaaBelatq	Ndaambelatv
Puaa	Puaa
yeDiyaaen	Yendiyaaen
yelimotq	Yelimotv
yelemotq	Yelemotv
aalemetq	Aalemetv
Kenaaaanaa	Kenaaaanaa
hupgpim	Hupcbim
supqpim	Supvbim
pelctq	Belaetv
ulaam	Ulaam
Telaa	Telaa
Taahan	Taahan
laaDaan	Laandaan
laaDaan	Laandaan
manKien	Mankien
yaafeletq	Yaafeletv
some	Some
hoTaam	Hotaam
sojfaa	Sofaa
Bese	Mbese
aalaa	Aalaa
atgDaa	Atcndaa
mesaa	Mesaa
enpaaan	Enbaaan
aahiyo	Aahiyo
saasakq	Saasakv
sejBaaDiyaa	Sembaandiyaa
eDe	Ende
yohaa	Yohaa
yaaKim	Yaakim
sinjleTai	Sinxletai
haanan	Haanan
yeien	Yeien
saulo	Saulo
piTon	Biton
melekq	Melekv
Taalia	Taalie
simjli	Simxli
Bineaa	Mbineaa
Bineaa	Mbineaa
eleaasaaj	Eleaasaax
aasen	Aasen
BoKelu	Mbokelu
seaaliyaa	Seaaliyaa
isaalaaen	Isaalaaen
yeuen	Yeuen
sanjlu	Sanxlu
hatgsejnuaa	Hatcsenuaa
elaa	Elaa
mesunlaam	Mesunlaam
sefaaTiyaa	Sefaatiyaa
leuen	Leuen
aaDaayaa	Aandaayaa
paatghe	Baatche
paatghe	Baatche
manKiyaa	Mankiyaa
imme	Imme
kaalaan	Gaalaan
matqTaaniyaa	Matvtaaniyaa
sikgli	Sikcli
yeDuTun	Yendutun
yeDuTun	Yendutun
mikqlotq	Mikvlotv
yeButg	Yembutc
pelon	Belon
sipgBeKai	Sipcmbekai
saaanBon	Saaanmbon
eliyaaBaa	Eliyaambaa
kimso	Gimso
haasem	Haasem
uaa	Uaa
itglai	Itclai
yaaaasien	Yaaaasien
semaaliyaa	Semaaliyaa
itgsiyaa	Itcsiyaa
aasaalen	Aasaalen
yaasoBeam	Yaasombeam
Kaaq	kaav
suv	kuatv
Rwrnj	nzuonx
aaBiQai	Aambiqai
silia	Silie
saataan	Saadaan
namj	namx
selomotq	Selomotv
kesom	Gesom
haalim	Haalim
miyaamin	Miyaamin
hakqKotg	Hakvkotc
yesuaa	Yesuaa
Binkaa	Mbingaa
hesi	Hesi
peTaahiyaa	Betaahiyaa
maaaasiyaa	Maaaasiyaa
yaaaasiyaa	Yaaaasiyaa
keDaaliyaa	Gendaaliyaa
yeDuTun	Matvtitiyaa
seBuen	Sembuen
haanaani	Haanaani
yehohaanan	Yehohaanan
hosaaj	Hosaax
kwanb	guanh
Havj	hnyangx
henDai	Henndai
elihu	Elihu
itgmaiaa	Itcmaiaa
aanKi	Aanki
saalomxn	Saalomorn
luvd	lungz
Tailaq	Tailaqv
yapqfaa	Yapvfaa
KeluBim	kelumbim
yetg	yietc
puv	bung
lovd	longz
punb	bunh
isaalaaen	Isaalaaen
saalomxn	Saalomorn
seKem	Sekem
yeloBoam	Yelomboam
maahaalatq	Maahaalatv
yelusaalem	Yelusaalem
yuDaa	Yundaa
oDetg	Ondetc
pwavq	buangv
tia	die
BaaaaQaa	Mbaaaaqaa
yehosaafatq	Yehosaafatv
neTaaniyaa	Netaaniyaa
ToBiyaa	Tombiyaa
yehosaaBaatg	Yehosaambaatc
aahapg	Aahapc
pcg	baeqc
’	’
yaahaasien	Yaahaasien
se	Sekaaliyaa
se	Mbenaiyaa
tuvq	dungx
aahatgyaa	Aahatcyaa
yeholam	Yeholam
yehien	Yehien
eTiopia	Etiobie
yolam	Yolam
yehu	Yehu
kruq	gouv
yehoyaaDaa	Yehoyaandaa
huvb	hungh
simeatg	Simeatc
yehoaatg	Yehoaatc
yeKoliyaa	Yekoliyaa
zivb	zingh
filisaatia	Filisaadie
aamxtq	Aamortv
ofen	Ofen
yoTaam	Yotaam
maaaasejaa	Maaaaseaa
mesinlemotq	Mesinlemotv
paauj	baaux
tiaj	diex
Zamq	camv
Mmd	hmz
maanatqsej	Maanatvse
aamon	Aamon
zxg	zorc
txvj	dorngx
yosaaBaatg	Yosaambaatc
yuvb	yungh
yoaahaatg	Yoaahaatc
yelemi	Yelemi
pesia	Besie
sailatq	Sailatv
lotg	Lotc
haaDitg	Haanditc
ono	Ono
sejnaaaa	Senaaaa
aanTaasesitq	Aantaasesitv
mitqleDaatg	Mitvlendaatc
Daaliatg	Ndaaliatc
hakqkai	Hakvgai
yiuTai	Yiutai
aahiTupq	Aahitupv
aaBiQuwaa	Aambiquwaa
eleaasaa	Eleaasaa
esaalaa	Esaalaa
aahaawaa	Aahaawaa
hev	heng
esaalaa	Esaalaa
sapqBeTai	Sapvmbetai
KeliTaa	Kelitaa
melemotq	Melemotv
matqTenai	Matvtenai
selemiyaa	Selemiyaa
haaKaaliyaa	Haakaaliyaa
nehaami	Nehaami
susaaj	Susaax
Namq	hnamv
sanjBaanlatq	Sanxmbaanlatv
ToBiaa	Tombiaa
kesem	Gesem
imli	Imli
mesesaaBen	Mesesaamben
yoyaaDaa	Yoyaandaa
haasapqneyaa	Haasapvneyaa
hatgsupq	Hatcsupv
hanlohetg	Hanlohetc
lehum	Lehum
sapgBai	Sapcmbai
Baalukq	Mbaalukv
hatgsupq	Hatcsupv
henaaDatg	Henaandatc
Binnwi	Mbinnui
paalaan	Baalaan
paalotq	Baalotv
laanb	laanh
ToBiaa	Tombiaa
yrug	youc
moDeKai	Mondekai
Binsaan	Mbinsaan
Bikgwai	Mbikcwai
Jxib	joih
Katgmien	Katcmien
QeBaaniyaa	Qembaaniyaa
Bunni	Mbunni
selepiyaa	Selebiyaa
hoDiyaa	Hondiyaa
ken	gen
Kxiq	koiv
Daanien	Ndaanien
kinneTon	Ginneton
patglotq	Batclotv
satgTu	Satctu
atgkaatg	Atcgaatc
BeBai	Mbembai
aaDin	Aandin
aaTe	Aate
haasum	Haasum
Besai	Mbesai
haalipq	Haalipv
yaatqDuwaa	Yaatvnduwaa
aanaayaa	Aanaayaa
sanjlai	Sanxlai
yoyaalipq	Yoyaalipv
atgliKam	Atclikam
sijhag	Sihaqc
seanTien	Seantien
yoyaaKim	Yoyaakim
yonaaTaan	Yonaataan
minyaamin	Minyaamin
aamokq	Aamokv
Tanmon	Tanmon
hosaayaa	Hosaayaa
matqTaaniyaa	Matvtaaniyaa
miKaayaa	Mikaayaa
eliyaaKim	Eliyaakim
aahaasuelatq	Aahaasuelatv
inDia	Inndie
yinb	yinh
watqQaaTi	Watvqaati
haag	haac
yeKoniyaa	Yekoniyaa
moDeKai	Mondekai
eseTe	Esete
eseTe	Esete
eseTe	Esete
Diuj	ndiux
haamaan	Haamaan
haamaan	Haamaan
lamd	lamz
haaTaakq	Haataakv
haaTaakq	Haataakv
KenDia	Kenndie
mapq	mapv
zyruj	zioux
lewiaaTaan	Lewiaataan
henb	henh
syenb	sienh
Waaj	huaax
Gapg	nqapc
Lyenj	hlienx
mitg	mitc
yia’	yie’
Rwid	nzuiz
Laaj	hlaax
mwrnd	muonz
kob	goh
Quwaa	Quwaa
BinDatg	Mbinndatc
lwavb	luangh
lrug	louc
zimb	zimh
naaaame	Naaaame
Truj	toux
suv	sung
suj	sux
haavb	haangh
pyob	bioh
syeng	sienc
wrtq	wuotv
kwcq	guaeqv
Rung	nzunc
Zyen	cien
hxig	hoic
fapq	fapv
naanb	naanh
mag	maqc
Biaq	mbieqv
wavg	wangc
kwenj	guenx
Lxq	hlorv
Eaab	nyaah
Beu	mbeu
Beu	mbeu
Gxq	nqorqv
yia	Yie
koj	gox
elihu	Elihu
zweib	zueih
waag’	waac’
soq	soqv
yemb	yiemh
aauj	aaux
Dang	ndanc
Matq	hmatv
Lopq	hlopv
paamd	baamz
yend	yienz
tog	doc
hxpg’	horpc’
kwinb	guinh
kwinb	guinh
kivj	gingx
mwavb	muangh
lamd	lamz
Komq	komv
Daug	ndauc
Zaaiq	caaiv
Eaaiq	nyaaiv
Behemotq	Mbehemotv
tiuj	diux
Zutq	cutv
selaa	Selaa
selaa	Selaa
txb	dorziec
Zyenb	cienh
tob	doh
waag	waac
lrub	louh
zaauj	zaaux
Taanj	taanx
zuaq	zuoqv
liud	liuz
Wavj	huangx
kruj	goux
zyavb	ziangh
myenb	zuizmienh
Zxvb	corngh
wrtq	wuotv
leBaanxn	Lembaanorn
finj	finx
xq	orqv
tonj	dangxdonx
haaq	Haav
haaq	haav
myend	mienz
patq	batv
tunj	dunx
Jiaj	jiex
laig	laic
Eyemd	nyiemz
nyruq	niouv
Ryruj	nzioux
sinj	sinx
Eiaj	nyiex
Lopq	hlopv
Ewrtq	nyuotv
Byaaud	mbiaauz
maad	maaz
Beuj	mbeux
keBaan	Gembaan
pwrnj	buonx
Tib	tih
aamen	Aamen
Beij	mbeix
laavg	wuomlaangc
pyopg	biopc
zyenb	Zienh
Gaatq	nqaatv
laib	laih
menKiseDekg	Menkisendekc
JxDcn	Jorndaen
kaatq	gaatv
yaaKopq	Yaakopv
efaaTaa	Efaataa
Qiaj	singqiex
Bov	mbong
mun	mun
yaapq	yaapv
heiq	heiv
Faauj	gorngvnjaaux
yrub	youh
Qopq	qopv
nuq	nuqv
Eaavg	nyaangc
lxd	lorz
Dyepq	ndiepv
Fruj	njoux
lom	lom
tiq	div
fitq	fitv
Taaib	taaih
Eaanb	nyaanh
Vovj	hngongx
Kxi	koi
Kxq	korqv
iTien	Itien
iTien	Itien
mwavj	muangx
Eei	nyei
saauj	saaux
lcvd	laengz
saalon	Saalon
Janb	Janxmuangz
hxg	horqc
hxg	horqc
Jiug	jiuc
Jiug	jiuc
Baiq	mbaiv
anman	anman
Eweid	nyueiz
txvb	sicdorngh
Zyruq	bingxciouv
Waav	biauvhuaang
tomb	wuomdomh
zwrnj	zuonx
Daamatqkatg	Ndaamatvgatc
muvd	fiuv
efaaim	Efaaim
vaaid	baengcngaaiz
Donj	ndiangxndonx
BaaBilon	Mbaambilon
moapg	Moapc
aan	Aan
txq	dorv
naiaa	Naiaa
Batg	mbatc
iyipq	Iyipv
atgsilia	Atcsilie
myenb	maaic
txij	doix
sepqnaa	Sepvnaa
Naavj	laihnaangx
aalien	Aalien
aalien	Aalien
zipq	zipv
Bxvj	mborngx
sru	Sou
Jiaq	nziaauxjieqv
sion	Sion
Kub	kuh
kuaq	guoqv
isaayaa	Isaayaa
saipatg	Saibatc
huaj	huox
Eim	nyim
Zauj	faangensen
Jxib	biouvjoih
Pitq	pitv
aq’	aqv’
kcv	lozgaeng
Yenj	hienx
lyemb	liemh
zunj	zunx
nin	nin
nia	nie
Baaan	Mbaaan
zauj	buozzaux
manKiaa	Mankiaa
yosiyaa	Yosiyaa
sijDaa	sindaa
kwaatq	guaatv
atgKelon	Atckelon
zwavj	zuangx
uliaa	Uliaa
kemaaliyaa	Gemaaliyaa
Kolaayaa	Kolaayaa
nehelaam	Nehelaam
sejfanyaa	Sefanyaa
puvb	bungxzuoqc
Faauj	njaaux
sejDeKiyaa	Sendekiyaa
KenDia	Kenndie
Qovj	qongx
neliyaa	Neliyaa
Baalukq	Mbaalukv
kxg	gorqvmienh
Koniyaa	Koniyaa
yehuKan	Yehukan
Benyaamin	Mbenyaamin
matqTaan	Matvtaan
puaq	buov
Kaaleaa	Kaaleaa
Tanhumetq	Tanhumetv
Kaaleaa	Kaaleaa
keDaaliyaa	Gendaaliyaa
ping	binc
Taapaanhetg	Taabaanhetc
memfitq	Memfitv
Lyruq	hliouv
KiliyaaTaaim	Kiliyaataaim
DiBon	Ndimbon
Favj	njangx
eDom	Endom
eDom	Endom
Dwi	ndui
Din	ndin
fxvb	forngcang
Jopg	ndongc
fuvj	fungx
BaaBilon	Mbaambilon
zemb	zemh
Byrub	mbiouh
Levj	hlengx
neBuKatqnetqsaa	Nembukatvnetvsaa
zung	zunc
ziaj	ziex
meud	meuz
Fapg	njapc
pwrnb	buonvguoqv
ziq	ziqv
hopq	hopv
scvb	saenghmz
yem	Yiem
KeBaa	Kembaa
yaaaasanyaa	Yaaaasanyaa
Zcv	caeng
lwib	luijuoqv
tiaq	diev
huvb	hungh
Kuq	kuv
Paiq	paiv
Tapq	tapv
oholaa	Oholaa
oholiBaa	Oholimbaa
paaig	baaic
eTiopia	Etiobie
on	On
scvb	saengcietv
Fog	njoqc
Bevj	mbengx
miab	mievciangv
yavb	yangh
kokg	Gokc
aab	Gokc
txvj	zaangh
sivj	singx
home	home
hxg	horc
Daanien	Ndaanien
lai	lai
Beij	mbeix
BenTesatqsaa	Mbentesatvsaa
satqlakq	Satvlakv
mesaakq	Mesaakv
aaBetgneko	Aambetcnego
aaBetgneko	Aambetcnego
Hruq	hnyouv
Bensatqsaa	Mbensatvsaa
taij	daix
mene	Mene
TeKen	Teken
paasin	Baasin
taub	dauh
kaaBelyen	Gaambelien
Tiuj	tiux
hoseyaa	Hoseyaa
limb	limh
aamotq	Aamotv
aamotq	Aamotv
Keliotg	Keliotc
Ziq	civ
liq	liv
kinkaan	Gingaan
mwavq	muangv
finisia	Finisie
saajlefatq	Saaxlefatv
yonaa	Yonaa
yonaa	Yonaa
ninaawe	Ninaawe
vxvd	ngorngz
Ganj	nqanx
Dunb	ndunh
pyeib	bieivzeiv
naahum	Naahum
liBia	Limbie
Exj	nyorx
haaBaakukg	Haambaagukc
Pwrtq	puotv
Kusi	Kusi
zyavq	ziangv
minKom	Minkom
hxvg	jaaihorngc
Favb	njanglaangc
yosuwaa	Yosuwaa
Gaaij	nqaaix
fivj	fingx
seij	seix
Zaib	caidoix
log	duqv
peletq	Beletv
hetqlon	Hetvlon
laam	Laam
Boaatg	Mboaatc
Jyetgsi	Jetcsi
eliyaaKim	Eliyaakim
yosepq	Yosepv
maaliyaa	Maaliyaa
maaliyaa	Maaliyaa
yesu	Yesu
yesu	Yesu
kitug	Giduc
yesu	Yesu
imaanuen	Imaanuen
eij	eix
helotq	Helotv
yuDia	Yundie
naasaaletq	Naasaaletv
naasaaletq	Naasaaletv
yohan	Yohan
yohan	Yohan
yohan	Yohan
Ropg	nzopc
txnb	Dornhnamv
sejBeDi	Sembendi
yaakxpg	Yaagorpc
TotqBuli	Totvmbuli
Gopq	nqopv
paaib	baaih
Euag	nyuoqc
kilo	gilo
pru	bou
Laau	hlaau
vcvq	ngaengv
vcvq	ngaengv
tuvd	dungz
tuvd	dungz
tuvd	dungz
Kamj	kamx
filipq	Filipv
BaaTolomiu	Mbaatolomiu
Tomatq	Tomatv
matqTaai	Matvtaai
anfeatg	Anfeatc
TatqDeatg	Tatvndeatc
simon	Simon
yuDaatg	Yundaatc
isaaKaaliotg	Isaakaaliotc
Eeig	nyeic
Zyrub	ciouh
tung	dunc
tog	doqc
hev	heng
faalisij	Faalisi
faalisij	Faalisi
myenq	mienv
BeenseBun	Mbeensembun
saataan	Saadaan
lcvg	laengc
heloDyetg	Helondietc
yesu	Yesu
txn	mbiauzdorn
saaDusij	Saandusi
saaDusij	Saandusi
pite	Bide
pite	Bide
saib	Saigorx
Juaq	juov
saa	saa
BeTaani	Mbetaani
sisaa	Sisaa
taub’	dauh’
kitug	Giduc
haad	Haaz
Kaayaafaatq	Kaayaafaatv
cj	aex
pite	Bide
lomaa	Lomaa
pilaatq	Bilaatv
yuDaatg	Yundaatc
pilaatq	Bilaatv
pilaatq	Bilaatv
BaalapqBatg	Mbaalapvmbatc
BaalapqBatg	Mbaalapvmbatc
kwatg	guatc
sailin	Sailin
simon	Simon
eli	Eli
laamaasaaBakgTaani	laamaasaambakctaani
makqDaalaa	Makvndaalaa
anDaalu	Anndaalu
Kaapenaaum	Kaabenaaum
yesu	Yesu
kwaiq	guaiv
Gomd	nqomz
laavd	laangz
helotq	Helotv
Bomd	mbomz
BetgsaiDaa	Mbetcsaindaa
mose	Mose
hosaanaa	Hosaanaa
lomaa	Lomaa
aalekqsaanDe	Aalekvsaannde
lufatq	Lufatv
matqTatq	Matvtatv
matqTatq	Matvtatv
menKi	Menki
menKi	Menki
matqTaaTiatg	Matvtaatiatc
matqTaaTiatg	Matvtaatiatc
eaa	Eaa
simeon	Simeon
apglaaham	Apclaaham
naaho	Naaho
sejlukq	Selukv
leu	Leu
pelekq	Belekv
eBe	Embe
aanfaasatq	Aanfaasatv
laamekq	Laamekv
yaaletq	Yaaletv
enotq	Enotv
aaDam	Aandam
kelaasaa	Gelaasaa
yailatq	Yailatv
Zyru	ciou
saamaalia	Saamaalie
pyaub	biauvziouv
maaTaa	Maataa
Daavb	ndaangh
kaalili	Gaalili
sijloam	Siloam
puvj	bungx
waang	waanc
hrug	houc
’	cuqv
taan	zaeqvdaan
laasaalatq	Laasaalatv
sakgKyetq	Sakckietv
’	’
sig	siqc
Eomj	nyomx
helotq	Helotv
Kib	kih
Kaatq	kaatv
Danb	ndanh
filipq	Filipv
naaTaanaaen	Naataanaaen
niKoDematq	Nikondematv
livb	lingh
yiuTai	Yiutai
Kaanaa	Kaanaa
vib	ngih
suvj	sungx
sapq	sapv
Bx	mbor
laasaalatq	Laasaalatv
laasaalatq	Laasaalatv
maaTaa	Maataa
Paaiq	paaiv
yuDaatg	Yundaatc
syenj	sienx
laanb	laanh
hiuq	hiuv
annaatq	Annaatv
aanaania	Aanaanie
aanaania	Aanaanie
Tim	tim
saaTefen	Saatefen
anTiokg	Antiokc
niKolau	Nikolau
tapg	dapc
saulo	Saulo
aineatg	Aineatc
litqDaa	Litvndaa
samb	samh
Koneliatg	Koneliatc
Koneliatg	Koneliatc
sisaaliyaa	Sisaaliyaa
BaanaaBatg	Mbaanaambatc
BaanaaBatg	Mbaanaambatc
Taasatq	Taasatv
ziub	ziuh
maaKo	Maako
paulo	Baulo
paulo	Baulo
iKoniyum	Ikoniyum
hemetq	Hemetv
pekaa	Begaa
silaa	Silaa
maasiDonia	Maasindonie
paulo	Baulo
silaa	Silaa
Tesaalonikaa	Tesaalonigaa
yaasonj	Yaasonx
aaTen	Aaten
TimoTai	Timotai
fyru	fiou
KolinTo	Kolinto
Kaalitqpatg	Kaalitvbatc
kanlio	Ganlio
aaKaayaa	Aakaayaa
efeso	Efeso
pitgsinjlaa	Bitcsinxlaa
aaKwinlaa	Aakuinlaa
aapxlo	Aaborlo
aanTemitq	Aantemitv
esia	Esie
Demetqliatg	Ndemetvliatc
Beloaa	Mbeloaa
aalitqTaaKatq	Aalitvtaakatv
kaaiatg	Gaaiatc
TiKikatg	Tikigatc
tofimatq	Dofimatv
toatg	Doatc
silisia	Silisie
felikq	Felikv
felikq	Felikv
KaalaauDiatg	Kaalaaundiatc
lisyetq	Lisietv
fesaaTatq	Fesaatatv
fesaaTatq	Fesaatatv
aaGiPaa	Aanqipaa
aaGiPaa	Aanqipaa
Zovb	congh
apglaaham	Apclaaham
kitug	Giduc
aa	Aa
saapen	Saaben
lusiatg	Lusiatc
saaTefaanatq	Saatefaanatv
aapxlo	Aaborlo
zaang	zaanc
nrub	nouh
Nomq	hnomv
maasiDonia	Maasindonie
kitug	Giduc
Titatg	Tidatc
Titatg	Tidatc
zog	zoqc
Tevj	tengx
Zev	ceng
fuq	fuqv
Namq	hnamv
epaafaa	Ebaafaa
lauDisia	Laundisie
sin	sin
zruj	zoux
naanb	naanh
Bua	mbuo
himeneatg	Himeneatc
lxj	lorx
fyem	fiem
Rcv	nzaeng
Demaatq	Ndemaatv
kaalaaTia	Gaalaatie
lukaa	Lugaa
onesifolatq	Onesifolatv
elatqTatq	Elatvtatv
mileTatq	Miletatv
swrng	suonc
filemon	Filemon
onesimatq	Onesimatv
saalem	Saalem
Ryaamq	nziaamv
mose	Mose
Eei	nyei
kanb	ganh
laamb	laamh
Baalaaam	Mbaalaaam
Kaain	Kaain
Kolaa	Kolaa
mauq	mauv
kruq	gouv
Bopq	mbopv
ເຢ	ye
ຊູ	su
maa	maaz
li	li
aadam	aandam
kaain	kaain
aabcn	aambaen
tov	enden
aadaa	aandaa
maahaalaalen	maahaalaalen
metusejlaa	metuselaa
kaanaaan	kaanaaan
kome	gome
maadai	maandai
tuban	tumban
atgkenatq	atckenatv
tokaanmaa	togaanmaa
eliseaa	eliseaa
kitqtim	kitvtim
lodaanim	londaanim
iyipq	iyipv
sejbaa	sembaa
haawilaa	haawilaa
sapgtaa	sapctaa
laaaamaa	laaaamaa
sapgtekaa	sapctekaa
qebaa	qembaa
dedaan	ndendaan
ninaawe	ninaawe
ludim	lundim
aanaamim	aanaamim
lehaabim	lehaambim
napqtuhim	napvtuhim
atgsu	atcsu
aanfaasatq	aanfaasatv
lude	lunde
kete	gete
ebe	embe
yokqtaan	yokvtaan
anmodatg	anmondatc
haasaanmaawetq	haasaanmaawetv
haadolam	haandolam
dikglaa	ndikclaa
aabimaaen	aambimaaen
yobapg	yombapc
baaben	mbaamben
leu	leu
naaho	naaho
apglaam	apclaam
betgen	mbetcen
sojdom	sondom
komolaa	gomolaa
atgmaa	atcmaa
sejboyim	semboyim
sojaa	soaa
aamaalekq	aamaalekv
aamolai	aamolai
sitgdim	sitcndim
daamatqkatg	ndaamatvgatc
kedolaaome	kendolaaome
aane	aane
etgko	etcko
eliyese	eliyese
apglaaham	apclaaham
hitqtai	hitvtai
pelitqsi	belitvsi
lefaaim	lefaaim
isaamaaen	isaamaaen
kelaaaa	gelaaaa
aabimelekq	aambimelekv
isakg	isakc
beeqebaa	mbeeqembaa
betuen	mbetuen
lebekaa	lembekaa
hebolon	hembolon
sojhaaj	sohaax
efolon	efolon
laabaan	laambaan
ketulaa	ketulaa
yokqsaan	yokvsaan
mitqmaa	mitvmaa
haadatg	haandatc
kedemaa	kendemaa
filisaatia	filisaadie
beeli	mbeeli
baasejmatq	mbaasematv
laabaan	laambaan
binhaa	mbinhaa
leaa	leaa
napqtaali	napvtaali
sinjpaa	sinxbaa
dudaaim	ndundaaim
isaalaaen	isaalaaen
seji	sei
simeon	simeon
efaalaataa	efaalaataa
benyaamin	mbenyaamin
aase	aase
elifatq	elifatv
leuen	leuen
naahatg	naahatc
yeutg	yeutc
oholibaamaa	oholimbaamaa
edom	endom
sobaan	sombaan
maanaahaatq	maanaahaatv
ebaan	embaan
etgbaan	etcmbaan
itglaan	itclaan
ese	ese
sibeon	simbeon
edom	endom
dinhaabaa	ndinhaambaa
bosaalaa	mbosaalaa
bedatg	mbendatc
moapg	moapc
midyen	mindien
samjlaa	samxlaa
lehojbotg	lehoxmbotc
saaun	saaun
akgbo	akcmbo
mipqsaa	mipvsaa
luben	lumben
yudaa	yundaa
quaa	quaa
eaa	eaa
hipqlu	hipvlu
naiaa	naiaa
hetqlon	hetvlon
yemuen	yemuen
ohaatg	ohaatc
kohaatq	kohaatv
melaali	melaali
itgsaajkaa	itcsaaxkaa
sejbulun	sembulun
yaaleen	yaaleen
hakqki	hakvgi
etgbon	etcmbon
elei	elei
aaleli	aaleli
itgwaa	itcwaa
itgwi	itcwi
beliyaa	mbeliyaa
selaaaa	selaaaa
hebe	hembe
atgben	atcmben
naaaamaan	naaaamaan
yaasien	yaasien
maanatqsej	maanatvse
efaaim	efaaim
jxdcn	jorndaen
lipqni	lipvni
simei	simei
itghaa	itchaa
sikgli	sikcli
utgsien	utcsien
misaaen	misaaen
ensaafaan	ensaafaan
naadapg	naandapc
itaamaa	itaamaa
atgsij	atcsi
enkaanaa	enkaanaa
eleaasaa	eleaasaa
finehatg	finehatc
sukgkotq	sukckotv
aabipg	aambipc
lefidim	lefindim
huaa	huaa
yosuwaa	yosuwaa
aabihu	aambihu
kelubim	kelumbim
besaalen	mbesaalen
yebutg	yembutc
oholiapg	oholiapc
selomitq	selomitv
sujlisatqdai	suxlisatvndai
selumien	selumien
amminaadapg	amminaandapc
zuaa	zuaa
netanen	netanen
eliapg	eliapc
ammihutq	ammihutv
elisaamaa	elisaamaa
pedaasu	bendaasu
kaamaalien	gaamaalien
kideoni	gindeoni
aabidan	aambindan
aahiyese	aahiyese
paakien	baagien
deuen	ndeuen
eliyaasaapg	eliyaasaapc
aahilaa	aahilaa
elisaafaan	elisaafaan
maanaa	maanaa
sakgke	sakcge
sammuwaa	sammuwaa
yefunne	yefunne
ikaan	igaan
hoseyaa	hoseyaa
mikaaen	mikaaen
aabilam	aambilam
melibaa	melimbaa
kaadetg	kaandetc
hoaa	hoaa
sihonj	sihonx
hetqbon	hetvmbon
sipgpo	sipcbo
baalaaam	mbaalaaam
baaan	mbaaan
beo	mbeo
peo	beo
simjli	simxli
kotqbi	kotvmbi
sujaa	suxaa
otgni	otcni
atglien	atclien
semidaa	semindaa
sejlofehatg	selofehatc
maahaalaa	maahaalaa
hokqlaa	hokvlaa
tilaasaa	tilaasaa
suham	suham
kileaatg	gileaatc
maakile	maakile
aabaalim	aambaalim
lebaa	lembaa
mikqdon	mikvndon
lipqnaa	lipvnaa
taahatg	taahatc
yotqbaataa	yotvmbaataa
obotg	ombotc
nebo	nembo
atgmon	atcmon
meditelenyen	mendidelenien
sejdatg	sendatc
bukgki	mbukcki
hannien	hannien
kemuen	kemuen
pantien	bantien
aahihutq	aahihutv
edeni	endeni
atgtaalotq	atctaalotv
yaahaatq	yaahaatv
aankopg	aangopc
saidxn	saindorn
aalaabaa	aalaambaa
pitgkaa	bitcgaa
kelisim	gelisim
laahapg	laahapc
kinkaan	gingaan
yeliko	yeliko
sapgdi	sapcndi
kibeon	gimbeon
beelotq	mbeelotv
yelusaalem	yelusaalem
ekglon	ekclon
debi	ndembi
aasekaa	aasekaa
makqkedaa	makvkendaa
aiyaalon	aiyaalon
yaabin	yaambin
maadon	maandon
akgsaapq	akcsaapv
mitqpaa	mitvbaa
aadunlam	aandunlam
tapqpuwaa	tapvbuwaa
mekitgdo	megitcndo
kedetg	kendetc
yokqneam	yokvneam
maaaakaa	maaaakaa
saajlekaa	saaxlekaa
kedemotq	kendemotv
mefaaaatg	mefaaaatc
baaaalaa	mbaaaalaa
timnaahaa	timnaahaa
akgsaaj	akcsaax
otgnien	otcnien
sipgaa	sipcaa
beaalotq	mbeaalotv
molaadaa	molaandaa
entolatq	entolatv
sikglaakq	sikclaakv
matqmannaa	matvmannaa
botgkaatq	mbotckaatv
ete	ete
atgnaa	atcnaa
etgtemoaa	etctemoaa
maaon	maaon
yitqleen	yitvleen
kedo	gendo
aataalotq	aataalotv
naaaalaa	naaaalaa
apgwim	apcwim
ofaalaa	ofaalaa
kision	kision
ebetg	embetc
kinneletq	kinneletv
etgtaaon	etctaaon
ekolon	ekolon
enteke	enteke
kipgbeton	gipcmbeton
baaaalatq	mbaaaalatv
aahimaan	aahimaan
akgsipq	akcsipv
lehopg	lehopc
ehutq	ehutv
debolaa	ndembolaa
aabinoam	aambinoam
taabo	taambo
sisejlaa	siselaa
kideon	gindeon
yoaatg	yoaatc
aabiyese	aambiyese
zebaa	zembaa
sanjmunnaa	sanxmunnaa
penuen	benuen
bee	mbee
sejbun	sembun
kaaan	gaaan
tebetg	tembetc
jaai	jaai
yepqtaa	yepvtaa
aaloe	aaloe
betglehem	mbetclehem
pilaaton	bilaaton
apgdon	apcndon
maanoaa	maanoaa
scmsanj	saemsanx
delilaa	ndelilaa
laaitg	laaitc
kibeaa	gimbeaa
naaomi	naaomi
elimelekq	elimelekv
lute	lute
kilion	kilion
boaatg	mboaatc
sanjmon	sanxmon
obetg	ombetc
jyetgsi	jetcsi
peninnaa	beninnaa
saamuen	saamuen
atgdotg	atcndotc
aabinaadapg	aambinaandapc
yaabetg	yaambetc
naahaatg	naahaatc
mikqmaatq	mikvmaatv
suan	suan
yonaataan	yonaataan
aahiyaa	aahiyaa
apgne	apcne
aabien	aambien
koliatg	goliatc
saaaalaaim	saaaalaaim
aahimelekq	aahimelekv
doekg	ndoekc
aahitupq	aahitupv
aabiyaataa	aambiyaataa
keilaa	keilaa
naabaan	naambaan
aabikaayin	aambigaayin
aahinoam	aahinoam
sejluyaa	seluyaa
yoaapg	yoaapc
aabiqai	aambiqai
kinboaa	ginmboaa
keleti	keleti
yaatqti	yaatvti
yelaameen	yelaameen
itgbosetq	itcmbosetv
maahaanaaim	maahaanaaim
aasaajhen	aasaaxhen
aadoniyaa	aandoniyaa
hakqkitg	hakvgitc
sefaatiyaa	sefaatiyaa
kitgtaaim	gitctaaim
baaaanaa	mbaaaanaa
saalomxn	saalomorn
ipghaa	ipchaa
elisuwaa	elisuwaa
eliyaadaa	eliyaandaa
elifeletq	elifeletv
kebaa	gembaa
utgsaa	utcsaa
sijdaa	sindaa
sojbaa	sombaa
haadatgese	haandatcese
yufetitg	yufeditc
yehoyaadaa	yehoyaandaa
benaiyaa	mbenaiyaa
sibaa	simbaa
mefibosetq	mefimbosetv
batgqebaa	mbatcqembaa
uliaa	uliaa
lapqbaa	lapvmbaa
apgsaalom	apcsaalom
yonaadapg	yonaandapc
tekoaa	tekoaa
itgtai	itctai
saajdokg	saaxndokc
aahimaaatg	aahimaaatc
aahitofen	aahitofen
baasinlai	mbaasinlai
aamaasaaj	aamaasaax
bikgli	mbikcli
ilaa	ilaa
aiaa	aiaa
litqpaa	litvbaa
simehaa	simehaa
aahojhai	aahoxhai
dodo	ndondo
enhaanan	enhaanan
heletqte	heletvte
ikgketg	ikcketc
aanaatotq	aanaatotv
netofaa	netofaa
maahaalai	maahaalai
libai	limbai
kaaatg	gaaatc
baahulim	mbaahulim
atgmaawetq	atcmaawetv
aahiyam	aahiyam
hetqlo	hetvlo
naahaalai	naahaalai
itglai	itclai
uliyaa	uliyaa
aalaaunaa	aalaaunaa
aabiqaakq	aambiqaakv
aasaaliyaa	aasaaliyaa
aahilutq	aahilutv
itgdo	itcndo
yehosaafatq	yehosaafatv
lebaanxn	lembaanorn
aadonilam	aandonilam
sion	sion
kaalili	gaalili
taapenetq	taabenetv
yeloboam	yelomboam
lehojboam	lehoxmboam
aabiyaa	aambiyaa
nebatg	nembatc
aabiyam	aambiyam
aabiqaalom	aambiqaalom
baaaaqaa	mbaaaaqaa
saamaalia	saamaalie
aahapg	aahapc
aaselaa	aaselaa
eliyaa	eliyaa
obaadi	ombaandi
yeseben	yesemben
yehu	yehu
elisaa	elisaa
haasaaen	haasaaen
naabotg	naambotc
mikaayaa	mikaayaa
aahatgyaa	aahatcyaa
sinhi	sinhi
aasubaa	aasumbaa
yeholam	yeholam
kehaasi	gehaasi
yehoaahaatg	yehoaahaatc
aataaliyaa	aataaliyaa
yehoaatg	yehoaatc
aamaasiyaa	aamaasiyaa
sejkaaliyaa	sekaaliyaa
utgsiyaa	utcsiyaa
kaadi	gaandi
menaahem	menaahem
atgsilia	atcsilie
pekaahiyaa	bekaahiyaa
lemaaliyaa	lemaaliyaa
aahatg	aahatc
kiaa	kiaa
midia	mindie
baabilon	mbaambilon
sejfaanwaaim	sefaanwaaim
hesekiyaa	hesekiyaa
sennaakelipq	sennaakelipv
isaayaa	isaayaa
ipgwaa	ipcwaa
yosiyaa	yosiyaa
aadaayaa	aandaayaa
mesunlaam	mesunlaam
aasaalaiyaa	aasaalaiyaa
hinkiyaa	hinkiyaa
aahikam	aahikam
aasaajyaa	aasaaxyaa
hundaa	hunndaa
kitglon	kitclon
haamutaan	haamutaan
yelemi	yelemi
lipqlaa	lipvlaa
yehoyaakim	yehoyaakim
pedaayaa	bendaayaa
yehoyaakin	yehoyaakin
ennaatan	ennaatan
sejdekiyaa	sendekiyaa
matqsaaj	matvsaax
mitqsaa	mitvsaa
binhaan	mbinhaan
saajwaan	saaxwaan
matqlekaa	matvlekaa
makqdien	makvndien
ilaam	ilaam
daandaa	ndaanndaa
yete	yete
aabihaain	aambihaain
itgi	itci
akglai	akclai
saajbaatg	saaxmbaatc
eleaasaaj	eleaasaax
yekaamiyaa	yekaamiyaa
efaa	efaa
saaapg	saaapc
simeaa	simeaa
sejlupqbaaben	selupvmbaamben
haananyaa	haananyaa
belekiyaa	mbelekiyaa
pelaatiyaa	belaatiyaa
yesaayaa	yesaayaa
lefaiyaa	lefaiyaa
sekaaniyaa	sekaaniyaa
semaiaa	semaiaa
hatqtatq	hatvtatv
neaaliyaa	neaaliyaa
elionai	elionai
atglikam	atclikam
hodaawiyaa	hondaawiyaa
eliyaasipq	eliyaasipv
pelaiyaa	belaiyaa
akgkupg	akckupc
yohaanan	yohaanan
delaiyaa	ndelaiyaa
leaayaa	leaayaa
yaahaatg	yaahaatc
itgmaa	itcmaa
paasejaa	baaseaa
sejlaiaa	selaiaa
etglaa	etclaa
maahaalaalen	maahaalaalen
metusejlaa	metuselaa
isakg	isakc
haadatg	haandatc
yudaa	yundaa
amminaadapg	amminaandapc
sanjmon	sanxmon
obetg	ombetc
jaai	jaai
yehu	yehu
lehojboam	lehoxmboam
aabiyaa	aambiyaa
aamaasiyaa	aamaasiyaa
aasaaliyaa	aasaaliyaa
aahatg	aahatc
hesekiyaa	hesekiyaa
yehoyaakin	yehoyaakin
sejlupqbaaben	selupvmbaamben
yesaayaa	yesaayaa
lefaiyaa	lefaiyaa
obaadi	ombaandi
semaiaa	semaiaa
yaahaatg	yaahaatc
maalesaa	maalesaa
kedelaa	gendelaa
nemuen	nemuen
mipqsamj	mipvsamx
sakgke	sakcge
yoen	yoen
aasien	aasien
aadien	aandien
yedaayaa	yendaayaa
kileaatg	gileaatc
mikaaen	mikaaen
aahi	aahi
elien	elien
finehatg	finehatc
aabiquwaa	aambiquwaa
bukgki	mbukcki
utgsi	utcsi
sejlaahiyaa	selaahiyaa
sejlaahiyaa	selaahiyaa
melaayotq	melaayotv
aamaaliyaa	aamaaliyaa
aamaaliyaa	aamaaliyaa
saajdokg	saaxndokc
hinkiyaa	hinkiyaa
yehosaadakg	yehosaandakc
nebukatqnetqsaa	nembukatvnetvsaa
simjmaa	simxmaa
yoaa	yoaa
enkaanaa	enkaanaa
ebiyaasaapg	embiyaasaapc
ebiyaasaapg	embiyaasaapc
taahatg	taahatc
ulien	ulien
utgsiyaa	utcsiyaa
eliapg	eliapc
yeloham	yeloham
yeloham	yeloham
simeaa	simeaa
maahaatq	maahaatv
aamaasaij	aamaasaix
yoen	yoen
sejfanyaa	sefanyaa
atgsij	atcsi
itghaa	itchaa
kohaatq	kohaatv
belekiyaa	mbelekiyaa
mankiyaa	mankiyaa
simjmaa	simxmaa
apgdi	apcndi
haasaapiyaa	haasaabiyaa
haasaapiyaa	haasaabiyaa
melaali	melaali
utgsi	utcsi
melaayotq	melaayotv
daabelatq	ndaambelatv
puaa	puaa
yediyaaen	yendiyaaen
yelimotq	yelimotv
yelemotq	yelemotv
aalemetq	aalemetv
kenaaaanaa	kenaaaanaa
hupgpim	hupcbim
supqpim	supvbim
taahan	taahan
laadaan	laandaan
laadaan	laandaan
mankien	mankien
yaafeletq	yaafeletv
some	some
atgdaa	atcndaa
enpaaan	enbaaan
aahiyo	aahiyo
sejbaadiyaa	sembaandiyaa
ede	ende
yohaa	yohaa
sinjletai	sinxletai
yeien	yeien
simjli	simxli
bineaa	mbineaa
bineaa	mbineaa
eleaasaaj	eleaasaax
bokelu	mbokelu
seaaliyaa	seaaliyaa
isaalaaen	isaalaaen
yeuen	yeuen
sanjlu	sanxlu
hatgsejnuaa	hatcsenuaa
mesunlaam	mesunlaam
sefaatiyaa	sefaatiyaa
leuen	leuen
aadaayaa	aandaayaa
paatghe	baatche
paatghe	baatche
mankiyaa	mankiyaa
matqtaaniyaa	matvtaaniyaa
sikgli	sikcli
yedutun	yendutun
yedutun	yendutun
mikqlotq	mikvlotv
yebutg	yembutc
sipgbekai	sipcmbekai
saaanbon	saaanmbon
eliyaabaa	eliyaambaa
uaa	uaa
itglai	itclai
yaaaasien	yaaaasien
semaaliyaa	semaaliyaa
itgsiyaa	itcsiyaa
aasaalen	aasaalen
yaasobeam	yaasombeam
aabiqai	aambiqai
selomotq	selomotv
miyaamin	miyaamin
hakqkotg	hakvkotc
yesuaa	yesuaa
binkaa	mbingaa
petaahiyaa	betaahiyaa
maaaasiyaa	maaaasiyaa
yaaaasiyaa	yaaaasiyaa
kedaaliyaa	gendaaliyaa
yedutun	matvtitiyaa
sebuen	sembuen
haanaani	haanaani
yehohaanan	yehohaanan
hendai	henndai
elihu	elihu
itgmaiaa	itcmaiaa
saalomxn	saalomorn
yapqfaa	yapvfaa
kelubim	kelumbim
isaalaaen	isaalaaen
saalomxn	saalomorn
yeloboam	yelomboam
maahaalatq	maahaalatv
yelusaalem	yelusaalem
yudaa	yundaa
odetg	ondetc
baaaaqaa	mbaaaaqaa
yehosaafatq	yehosaafatv
netaaniyaa	netaaniyaa
tobiyaa	tombiyaa
yehosaabaatg	yehosaambaatc
aahapg	aahapc
yaahaasien	yaahaasien
se	sekaaliyaa
se	mbenaiyaa
aahatgyaa	aahatcyaa
yeholam	yeholam
yehien	yehien
etiopia	etiobie
yehu	yehu
yehoyaadaa	yehoyaandaa
simeatg	simeatc
yehoaatg	yehoaatc
yekoliyaa	yekoliyaa
filisaatia	filisaadie
maaaasejaa	maaaaseaa
mesinlemotq	mesinlemotv
maanatqsej	maanatvse
yosaabaatg	yosaambaatc
yoaahaatg	yoaahaatc
yelemi	yelemi
haaditg	haanditc
sejnaaaa	senaaaa
aantaasesitq	aantaasesitv
mitqledaatg	mitvlendaatc
daaliatg	ndaaliatc
hakqkai	hakvgai
aahitupq	aahitupv
aabiquwaa	aambiquwaa
eleaasaa	eleaasaa
esaalaa	esaalaa
aahaawaa	aahaawaa
esaalaa	esaalaa
sapqbetai	sapvmbetai
kelitaa	kelitaa
melemotq	melemotv
matqtenai	matvtenai
selemiyaa	selemiyaa
haakaaliyaa	haakaaliyaa
nehaami	nehaami
sanjbaanlatq	sanxmbaanlatv
tobiaa	tombiaa
mesesaaben	mesesaamben
yoyaadaa	yoyaandaa
haasapqneyaa	haasapvneyaa
hatgsupq	hatcsupv
hanlohetg	hanlohetc
lehum	lehum
sapgbai	sapcmbai
hatgsupq	hatcsupv
henaadatg	henaandatc
tobiaa	tombiaa
modekai	mondekai
bikgwai	mbikcwai
katgmien	katcmien
qebaaniyaa	qembaaniyaa
selepiyaa	selebiyaa
hodiyaa	hondiyaa
daanien	ndaanien
kinneton	ginneton
patglotq	batclotv
satgtu	satctu
atgkaatg	atcgaatc
bebai	mbembai
aadin	aandin
aate	aate
yaatqduwaa	yaatvnduwaa
aanaayaa	aanaayaa
sanjlai	sanxlai
yoyaalipq	yoyaalipv
atglikam	atclikam
sijhag	sihaqc
seantien	seantien
yoyaakim	yoyaakim
yonaataan	yonaataan
minyaamin	minyaamin
hosaayaa	hosaayaa
matqtaaniyaa	matvtaaniyaa
mikaayaa	mikaayaa
eliyaakim	eliyaakim
aahaasuelatq	aahaasuelatv
india	inndie
watqqaati	watvqaati
yekoniyaa	yekoniyaa
modekai	mondekai
esete	esete
esete	esete
esete	esete
kendia	kenndie
lewiaataan	lewiaataan
bindatg	mbinndatc
naaaame	naaaame
elihu	elihu
behemotq	mbehemotv
lebaanxn	lembaanorn
kebaan	gembaan
menkisedekg	menkisendekc
jxdcn	jorndaen
efaataa	efaataa
itien	itien
itien	itien
anman	anman
daamatqkatg	ndaamatvgatc
efaaim	efaaim
baabilon	mbaambilon
moapg	moapc
naiaa	naiaa
iyipq	iyipv
atgsilia	atcsilie
sepqnaa	sepvnaa
aalien	aalien
aalien	aalien
sion	sion
isaayaa	isaayaa
zauj	faangensen
baaan	mbaaan
mankiaa	mankiaa
yosiyaa	yosiyaa
sijdaa	sindaa
atgkelon	atckelon
uliaa	uliaa
kemaaliyaa	gemaaliyaa
kolaayaa	kolaayaa
nehelaam	nehelaam
sejfanyaa	sefanyaa
sejdekiyaa	sendekiyaa
kendia	kenndie
neliyaa	neliyaa
koniyaa	koniyaa
yehukan	yehukan
benyaamin	mbenyaamin
matqtaan	matvtaan
kaaleaa	kaaleaa
tanhumetq	tanhumetv
kaaleaa	kaaleaa
kedaaliyaa	gendaaliyaa
taapaanhetg	taabaanhetc
kiliyaataaim	kiliyaataaim
dibon	ndimbon
edom	endom
edom	endom
baabilon	mbaambilon
nebukatqnetqsaa	nembukatvnetvsaa
kebaa	kembaa
yaaaasanyaa	yaaaasanyaa
oholaa	oholaa
oholibaa	oholimbaa
etiopia	etiobie
home	home
daanien	ndaanien
bentesatqsaa	mbentesatvsaa
satqlakq	satvlakv
aabetgneko	aambetcnego
aabetgneko	aambetcnego
bensatqsaa	mbensatvsaa
kaabelyen	gaambelien
hoseyaa	hoseyaa
keliotg	keliotc
kinkaan	gingaan
finisia	finisie
saajlefatq	saaxlefatv
ninaawe	ninaawe
naahum	naahum
libia	limbie
haabaakukg	haambaagukc
yosuwaa	yosuwaa
hetqlon	hetvlon
boaatg	mboaatc
jyetgsi	jetcsi
eliyaakim	eliyaakim
maaliyaa	maaliyaa
maaliyaa	maaliyaa
imaanuen	imaanuen
yudia	yundie
naasaaletq	naasaaletv
naasaaletq	naasaaletv
yohan	yohan
yohan	yohan
yohan	yohan
sejbedi	sembendi
totqbuli	totvmbuli
baatolomiu	mbaatolomiu
matqtaai	matvtaai
anfeatg	anfeatc
tatqdeatg	tatvndeatc
yudaatg	yundaatc
isaakaaliotg	isaakaaliotc
faalisij	faalisi
faalisij	faalisi
beensebun	mbeensembun
helodyetg	helondietc
saadusij	saandusi
saadusij	saandusi
betaani	mbetaani
kaayaafaatq	kaayaafaatv
yudaatg	yundaatc
baalapqbatg	mbaalapvmbatc
baalapqbatg	mbaalapvmbatc
laamaasaabakgtaani	laamaasaambakctaani
makqdaalaa	makvndaalaa
andaalu	anndaalu
kaapenaaum	kaabenaaum
betgsaidaa	mbetcsaindaa
hosaanaa	hosaanaa
aalekqsaande	aalekvsaannde
matqtatq	matvtatv
matqtatq	matvtatv
matqtaatiatg	matvtaatiatc
matqtaatiatg	matvtaatiatc
eaa	eaa
simeon	simeon
apglaaham	apclaaham
naaho	naaho
leu	leu
ebe	embe
aanfaasatq	aanfaasatv
aadam	aandam
kelaasaa	gelaasaa
saamaalia	saamaalie
kaalili	gaalili
sijloam	siloam
laasaalatq	laasaalatv
sakgkyetq	sakckietv
naataanaaen	naataanaaen
nikodematq	nikondematv
laasaalatq	laasaalatv
laasaalatq	laasaalatv
yudaatg	yundaatc
aanaania	aanaanie
aanaania	aanaanie
saatefen	saatefen
antiokg	antiokc
nikolau	nikolau
aineatg	aineatc
litqdaa	litvndaa
koneliatg	koneliatc
koneliatg	koneliatc
sisaaliyaa	sisaaliyaa
baanaabatg	mbaanaambatc
baanaabatg	mbaanaambatc
ikoniyum	ikoniyum
maasidonia	maasindonie
tesaalonikaa	tesaalonigaa
timotai	timotai
kolinto	kolinto
kaalitqpatg	kaalitvbatc
kanlio	ganlio
aakaayaa	aakaayaa
efeso	efeso
pitgsinjlaa	bitcsinxlaa
aakwinlaa	aakuinlaa
aapxlo	aaborlo
aantemitq	aantemitv
demetqliatg	ndemetvliatc
beloaa	mbeloaa
aalitqtaakatq	aalitvtaakatv
kaaiatg	gaaiatc
tikikatg	tikigatc
tofimatq	dofimatv
toatg	doatc
silisia	silisie
kaalaaudiatg	kaalaaundiatc
fesaatatq	fesaatatv
fesaatatq	fesaatatv
aagipaa	aanqipaa
aagipaa	aanqipaa
apglaaham	apclaaham
lusiatg	lusiatc
saatefaanatq	saatefaanatv
aapxlo	aaborlo
maasidonia	maasindonie
epaafaa	ebaafaa
laudisia	laundisie
himeneatg	himeneatc
kaalaatia	gaalaatie
onesifolatq	onesifolatv
elatqtatq	elatvtatv
miletatq	miletatv
filemon	filemon
onesimatq	onesimatv
baalaaam	mbaalaaam
kaain	kaain
tinb huvb	tinhungh
revg	cingnzengc
lrug	jauvlouc
buv	niembung
kuq	saengkuv
jweiq	dornjueiv
faq	funfaqv
daub	ndaubeih
euvg	nyungcnyungc
zeib	zeivfun
fivj	fingxfingx
puv	deicbung
ziab	ziecdorngh
havb	hnyangxjeiv
zang	zanczanc
liub	ndopvliuh
tivb	jaadingh
lomb	lomchuaang
myenb	finmienh
miub	miucfangx
hruj	luihoux
pcvb	baengbieiv
wavq	winwangv
len	koivhlen
kapg	gapvjaaix
hog	jangxhoc
latg	leizlatc
penq	labieivbenv
fub	fusux
scvb	saengyietv
bwrnb	mbuonvmuonc
zag	caqvbouc
eeig	leiznyeic
kxg	gorqvmienh
huvb	hunglouh
eiag	hnoinyieqc
sig	jaasic
ryemb	nziemxyaangh
byaag	biaavmbiaac
taaij	ongtaaix
pcvg	wuonbaengc
diaq	buozndiev
maanb	maanzhmuangx
zia	maazcie
yrud	gorxyouz
zunb	cungaeng
pxvb	borngbuoz
aiq	mbongaiv
zivq	wuomzingv
fivj	ndaamvfingx
nxmb	normnorm
zeq	cienceqv
kanaaib	ganaaivcenv
zinj	juangzinx
pcv	junbaeng
fyenb	njienyouh
mevb	congmengh
myenb	gongmienh
zuq	zorngzuqv
pcvb	baengguanh
scvb	saengziepc
fiub	fiuvdaanh
laavg	njanglaangc
havb	hnyangxhnyangx
syepq	siepvsiepv
kovb	gongzinh
lxg	ornlorqc
zung	nziaauxzunc
doq	gornndoqv
daub	ndauhuaang
eij	saengeix
zovb	congmengh
kxvb	gorngvbaeqc
lyenb	korvlienh
eeig	jopvnyeic
qru	qouqou
fim	gongfim
gwaab	ndiangxnquaah
dyavb	ndiangxgaaz
fung	sounjunc
zevj	zorngzengx
tov	poutong
rru	koivnzou
kxb	gorxyouz
lovj	longxlongx
zivb	enzingh
nxi	lozhnoi
syavb	siangnzung
zyruq	zaeqvziouv
nxib	hnoihnoi
aadam	aandam
haawaa	haawaa
kaain	kaain
aabcn	aambaen
enokq	enokv
laamekq	laamekv
aadaa	aandaa
enotq	enotv
kenan	kenan
maahaalaalen	maahaalaalen
yaaletq	yaaletv
metusejlaa	metuselaa
noyaa	noyaa
yaafetq	yaafetv
kaanaaan	kaanaaan
kome	gome
maakokg	maagokc
maadai	maandai
yaawaan	yaawaan
tuban	tumban
mesekq	mesekv
tilaatq	tilaatv
atgkenatq	atckenatv
lifaatq	lifaatv
tokaanmaa	togaanmaa
eliseaa	eliseaa
taansitq	taansitv
kitqtim	kitvtim
lodaanim	londaanim
iyipq	iyipv
sejbaa	sembaa
haawilaa	haawilaa
sapgtaa	sapctaa
laaaamaa	laaaamaa
sapgtekaa	sapctekaa
qebaa	qembaa
dedaan	ndendaan
nimlotq	nimlotv
ninaawe	ninaawe
ludim	lundim
aanaamim	aanaamim
lehaabim	lehaambim
napqtuhim	napvtuhim
hiwai	hiwai
aankaa	aankaa
sijni	sini
elaam	elaam
atgsu	atcsu
aanfaasatq	aanfaasatv
lude	lunde
aalam	aalam
kete	gete
qelaa	qelaa
ebe	embe
yokqtaan	yokvtaan
anmodatg	anmondatc
qelepq	qelepv
haasaanmaawetq	haasaanmaawetv
yelaa	yelaa
haadolam	haandolam
usaan	usaan
dikglaa	ndikclaa
aabimaaen	aambimaaen
ofi	ofi
yobapg	yombapc
baaben	mbaamben
pelekq	belekv
leu	leu
sejlukq	selukv
naaho	naaho
telaa	telaa
apglaam	apclaam
haalaan	haalaan
saalaai	saalaai
minkaa	minkaa
nekepg	negepc
faalo	faalo
betgen	mbetcen
sojdom	sondom
komolaa	gomolaa
atgmaa	atcmaa
sejboyim	semboyim
belaa	mbelaa
sojaa	soaa
taamaa	taamaa
aamaalekq	aamaalekv
aamolai	aamolai
sitgdim	sitcndim
daamatqkatg	ndaamatvgatc
kedolaaome	kendolaaome
aane	aane
etgko	etcko
mamle	mamle
paaib	torngvbaaih
eliyese	eliyese
apglaaham	apclaaham
hitqtai	hitvtai
pelitqsi	belitvsi
lefaaim	lefaaim
haakaa	haagaa
isaamaaen	isaamaaen
saalaa	saalaa
kelaaaa	gelaaaa
aabimelekq	aambimelekv
isakg	isakc
beeqebaa	mbeeqembaa
haaso	haaso
betuen	mbetuen
lebekaa	lembekaa
hebolon	hembolon
sojhaaj	sohaax
efolon	efolon
laabaan	laambaan
ketulaa	ketulaa
yokqsaan	yokvsaan
mitqmaa	mitvmaa
dumaa	ndumaa
haadatg	haandatc
temaa	temaa
yetu	yetu
naafitq	naafitv
kedemaa	kendemaa
esaau	esaau
yaakopq	yaakopv
filisaatia	filisaadie
beeli	mbeeli
elon	elon
baasejmatq	mbaasematv
laasen	laasen
laabaan	laambaan
binhaa	mbinhaa
leaa	leaa
lewi	lewi
napqtaali	napvtaali
sinjpaa	sinxbaa
dudaaim	ndundaaim
dinaa	ndinaa
isaalaaen	isaalaaen
yosepq	yosepv
seji	sei
haamo	haamo
sekem	sekem
simeon	simeon
efaalaataa	efaalaataa
benyaamin	mbenyaamin
aase	aase
elifatq	elifatv
leuen	leuen
temaan	temaan
omaa	omaa
sejfo	sefo
naahatg	naahatc
zelaa	zelaa
aanaa	aanaa
yeutg	yeutc
yaalaam	yaalaam
kolaa	kolaa
oholibaamaa	oholimbaamaa
edom	endom
holi	holi
homam	homam
lotaan	lotaan
timnaa	timnaa
sobaan	sombaan
maanaahaatq	maanaahaatv
ebaan	embaan
onam	onam
dison	ndison
etgbaan	etcmbaan
itglaan	itclaan
kelaan	kelaan
ese	ese
disaan	ndisaan
aalan	aalan
sibeon	simbeon
edom	endom
dinhaabaa	ndinhaambaa
bosaalaa	mbosaalaa
husaam	husaam
bedatg	mbendatc
moapg	moapc
midyen	mindien
aawitq	aawitv
samjlaa	samxlaa
lehojbotg	lehoxmbotc
saaun	saaun
akgbo	akcmbo
anwaa	anwaa
yetetq	yetetv
elaa	elaa
pinon	binon
kenatq	kenatv
mipqsaa	mipvsaa
dotaan	ndotaan
luben	lumben
yudaa	yundaa
quaa	quaa
eaa	eaa
onan	onan
hipqlu	hipvlu
naiaa	naiaa
haanokq	haanokv
panlu	banlu
hetqlon	hetvlon
kaanmi	kaanmi
yemuen	yemuen
yaamin	yaamin
ohaatg	ohaatc
yaakin	yaakin
keson	geson
kohaatq	kohaatv
melaali	melaali
itgsaajkaa	itcsaaxkaa
tolaa	tolaa
simlon	simlon
sejbulun	sembulun
sejletq	seletv
yaaleen	yaaleen
hakqki	hakvgi
suni	suni
etgbon	etcmbon
elei	elei
aaleli	aaleli
imnaa	imnaa
itgwaa	itcwaa
itgwi	itcwi
beliyaa	mbeliyaa
selaaaa	selaaaa
hebe	hembe
beke	mbeke
atgben	atcmben
kelaa	gelaa
naaaamaan	naaaamaan
husim	husim
yaasien	yaasien
kuni	guni
yese	yese
sinlem	sinlem
kosen	gosen
maanatqsej	maanatvse
efaaim	efaaim
jxdcn	jorndaen
maaki	maaki
mose	mose
aalon	aalon
lipqni	lipvni
simei	simei
maali	maazli
musi	musi
itghaa	itchaa
nefekq	nefekv
sikgli	sikcli
utgsien	utcsien
misaaen	misaaen
ensaafaan	ensaafaan
naason	naason
naadapg	naandapc
itaamaa	itaamaa
atgsij	atcsi
enkaanaa	enkaanaa
eleaasaa	eleaasaa
finehatg	finehatc
len	biauvhlen
raug	douznzauc
baali	mbaali
sukgkotq	sukckotv
aabipg	aambipc
milyem	miliem
lefidim	lefindim
huaa	huaa
yosuwaa	yosuwaa
yeto	yeto
sinaai	sinaai
bovb	mbongningv
genj	mbongnqenx
aabihu	aambihu
kelubim	kelumbim
efotq	efotv
txv	ndaamdorng
uli	uli
besaalen	mbesaalen
setq	siousetv
yebutg	yembutc
oholiapg	oholiapc
jaavb	caeqvjaangh
ulim	ulim
tummim	tummim
puab	buozzaangv
molekq	molekv
selomitq	selomitv
fivj	buonvfingx
sujlisatqdai	suxlisatvndai
selumien	selumien
amminaadapg	amminaandapc
zuaa	zuaa
netanen	netanen
helon	helon
eliapg	eliapc
ammihutq	ammihutv
elisaamaa	elisaamaa
pedaasu	bendaasu
kaamaalien	gaamaalien
kideoni	gindeoni
aabidan	aambindan
aahiyese	aahiyese
okaan	okaan
paakien	baagien
deuen	ndeuen
eliyaasaapg	eliyaasaapc
enan	enan
aahilaa	aahilaa
amlaam	amlaam
elisaafaan	elisaafaan
maanaa	maanaa
sakgke	sakcge
sammuwaa	sammuwaa
saafatq	saafatv
yefunne	yefunne
kaalepq	kaalepv
ikaan	igaan
hoseyaa	hoseyaa
mikaaen	mikaaen
homaa	homaa
tekg	doixdekc
daataan	ndaataan
aabilam	aambilam
syavb	siangsic
melibaa	melimbaa
kaadetg	kaandetc
hoaa	hoaa
aalaatq	aalaatv
tog	naangdoqc
zeletq	zeletv
sihonj	sihonx
hetqbon	hetvmbon
kemotq	kemotv
sipgpo	sipcbo
baalaakq	mbaalaakv
baalaaam	mbaalaaam
baaan	mbaaan
beo	mbeo
kenai	kenai
peo	beo
simjli	simxli
kotqbi	kotvmbi
sujaa	suxaa
otgni	otcni
yaasupq	yaasupv
atglien	atclien
semidaa	semindaa
hefe	hefe
sejlofehatg	selofehatc
maahaalaa	maahaalaa
hokqlaa	hokvlaa
tilaasaa	tilaasaa
suham	suham
kileaatg	gileaatc
maakile	maakile
aabaalim	aambaalim
ewi	ewi
lekem	lekem
lebaa	lembaa
mikqdon	mikvndon
lipqnaa	lipvnaa
taahatg	taahatc
yotqbaataa	yotvmbaataa
obotg	ombotc
nebo	nembo
atgmon	atcmon
meditelenyen	mendidelenien
haamatq	haamatv
sejdatg	sendatc
bukgki	mbukcki
hannien	hannien
kemuen	kemuen
pantien	bantien
aahihutq	aahihutv
edeni	endeni
atgtaalotq	atctaalotv
baasaan	mbaasaan
holepq	holepv
aanaakq	aanaakv
yaahaatq	yaahaatv
aankopg	aangopc
hemon	hemon
saidxn	saindorn
sejni	seni
aalaabaa	aalaambaa
pitgkaa	bitcgaa
puad	kungxbuoz
ammon	ammon
kelisim	gelisim
aamen	aamen
laahapg	laahapc
kinkaan	gingaan
yeliko	yeliko
sapgdi	sapcndi
aakaan	aakaan
kibeon	gimbeon
beelotq	mbeelotv
yelusaalem	yelusaalem
yaanmutq	yaanmutv
laakitq	laakitv
yaafia	yaafie
ekglon	ekclon
debi	ndembi
aasekaa	aasekaa
makqkedaa	makvkendaa
aiyaalon	aiyaalon
kese	gese
yaabin	yaambin
maadon	maandon
akgsaapq	akcsaapv
mitqpaa	mitvbaa
aadunlam	aandunlam
tapqpuwaa	tapvbuwaa
aafekq	aafekv
mekitgdo	megitcndo
kedetg	kendetc
kaanmen	kaanmen
yokqneam	yokvneam
koyim	goyim
kesu	gesu
maaaakaa	maaaakaa
saajlekaa	saaxlekaa
kedemotq	kendemotv
mefaaaatg	mefaaaatc
baaaalaa	mbaaaalaa
timnaahaa	timnaahaa
akgsaaj	akcsaax
otgnien	otcnien
sipgaa	sipcaa
telem	telem
beaalotq	mbeaalotv
semaa	semaa
molaadaa	molaandaa
esem	esem
entolatq	entolatv
sikglaakq	sikclaakv
matqmannaa	matvmannaa
sojko	soko
botgkaatq	mbotckaatv
ete	ete
aaqan	aaqan
atgnaa	atcnaa
aanaapq	aanaapv
etgtemoaa	etctemoaa
aalapg	aalapc
maaon	maaon
yitqleen	yitvleen
kedo	gendo
aataalotq	aataalotv
naaaalaa	naaaalaa
silo	silo
apgwim	apcwim
ofaalaa	ofaalaa
laamaa	laamaa
mosaa	mosaa
kision	kision
ebetg	embetc
hammatq	hammatv
kinneletq	kinneletv
sojlaa	solaa
etgtaaon	etctaaon
ekolon	ekolon
enteke	enteke
kipgbeton	gipcmbeton
baaaalatq	mbaaaalatv
besekq	mbesekv
sesai	sesai
aahimaan	aahimaan
tanmai	tanmai
akgsipq	akcsipv
lehopg	lehopc
ehutq	ehutv
aanaatq	aanaatv
samkaa	samgaa
debolaa	ndembolaa
aabinoam	aambinoam
taabo	taambo
sisejlaa	siselaa
kideon	gindeon
yoaatg	yoaatc
uamb	wuomhlen
aabiyese	aambiyese
zebaa	zembaa
sanjmunnaa	sanxmunnaa
penuen	benuen
heletq	heletv
yotaam	yotaam
bee	mbee
sejbun	sembun
kaaan	gaaan
tebetg	tembetc
saami	saami
jaai	jaai
yepqtaa	yepvtaa
aaloe	aaloe
betglehem	mbetclehem
pilaaton	bilaaton
apgdon	apcndon
maanoaa	maanoaa
scmsanj	saemsanx
kaasaa	gaasaa
delilaa	ndelilaa
mikaa	mikaa
laaitg	laaitc
kibeaa	gimbeaa
naaomi	naaomi
elimelekq	elimelekv
lute	lute
maalon	maalon
kilion	kilion
niaq	hnievhniev
maalaa	maalaa
boaatg	mboaatc
zamq	camvcamv
sanjmon	sanxmon
obetg	ombetc
jyetgsi	jetcsi
daawitq	ndaawitv
eei	buonvzingh
eli	eli
peninnaa	beninnaa
hannaa	hannaa
yuvd	saengyungz
saamuen	saamuen
atgdotg	atcndotc
txvj	lozdorngx
aabinaadapg	aambinaandapc
saulo	saulo
yaabetg	yaambetc
naahaatg	naahaatc
mikqmaatq	mikvmaatv
suan	suan
yonaataan	yonaataan
aahiyaa	aahiyaa
apgne	apcne
aabien	aambien
suwaa	suwaa
aakakg	aagakc
sammaa	sammaa
myenb	hmienfangx
koliatg	goliatc
saaaalaaim	saaaalaaim
siag	sieqvhlo
mikaan	mikaan
naayotq	naayotv
aahimelekq	aahimelekv
aakitq	aakitv
doekg	ndoekc
aahitupq	aahitupv
aabiyaataa	aambiyaataa
keilaa	keilaa
naabaan	naambaan
aabikaayin	aambigaayin
aahinoam	aahinoam
sejluyaa	seluyaa
yoaapg	yoaapc
aabiqai	aambiqai
sunem	sunem
kinboaa	ginmboaa
keleti	keleti
laamotq	laamotv
yaatqti	yaatvti
yelaameen	yelaameen
yaasaa	yaasaa
itgbosetq	itcmbosetv
maahaanaaim	maahaanaaim
aasaajhen	aasaaxhen
amnon	amnon
aadoniyaa	aandoniyaa
hakqkitg	hakvgitc
sefaatiyaa	sefaatiyaa
kitgtaaim	gitctaaim
limmon	limmon
lekaapq	lekaapv
baaaanaa	mbaaaanaa
minlo	minlo
naatan	naatan
saalomxn	saalomorn
ipghaa	ipchaa
elisuwaa	elisuwaa
eliyaadaa	eliyaandaa
elifeletq	elifeletv
kebaa	gembaa
utgsaa	utcsaa
sijdaa	sindaa
sojbaa	sombaa
haadatgese	haandatcese
yufetitg	yufeditc
silia	silie
yehoyaadaa	yehoyaandaa
benaiyaa	mbenaiyaa
peletq	peletv
sibaa	simbaa
mefibosetq	mefimbosetv
haanun	haanun
batgqebaa	mbatcqembaa
uliaa	uliaa
lapqbaa	lapvmbaa
apgsaalom	apcsaalom
yonaadapg	yonaandapc
tekoaa	tekoaa
itgtai	itctai
saajdokg	saaxndokc
aahimaaatg	aahimaaatc
aahitofen	aahitofen
husai	husai
baasinlai	mbaasinlai
aamaasaaj	aamaasaax
bikgli	mbikcli
ilaa	ilaa
aiaa	aiaa
litqpaa	litvbaa
simehaa	simehaa
aahojhai	aahoxhai
dodo	ndondo
haalaa	haalaa
enhaanan	enhaanan
haalotq	haalotv
heletqte	heletvte
ikgketg	ikcketc
aanaatotq	aanaatotv
husaa	husaa
netofaa	netofaa
maahaalai	maahaalai
libai	limbai
kaaatg	gaaatc
baahulim	mbaahulim
atgmaawetq	atcmaawetv
aahiyam	aahiyam
kilon	gilon
hetqlo	hetvlo
baani	mbaani
sejlekq	selekv
naahaalai	naahaalai
itglai	itclai
kaalepq	gaalepv
uliyaa	uliyaa
yaase	yaase
aalaaunaa	aalaaunaa
aabiqaakq	aambiqaakv
aasaaliyaa	aasaaliyaa
aahilutq	aahilutv
itgdo	itcndo
yehosaafatq	yehosaafatv
hilaam	hilaam
lebaanxn	lembaanorn
aadonilam	aandonilam
penq	ndiangxbenv
tailaq	tailaqv
sion	sion
kaalili	gaalili
taapenetq	taabenetv
yeloboam	yelomboam
lehojboam	lehoxmboam
zyruq	lozziouv
aabiyaa	aambiyaa
daavg	jaandaangc
sisakq	sisakv
nebatg	nembatc
aabiyam	aambiyam
aabiqaalom	aambiqaalom
aasaaj	aasaax
baaaaqaa	mbaaaaqaa
omli	omli
saamaalia	saamaalie
aahapg	aahapc
aaselaa	aaselaa
eliyaa	eliyaa
obaadi	ombaandi
yeseben	yesemben
kison	kison
yehu	yehu
elisaa	elisaa
haasaaen	haasaaen
naabotg	naambotc
imlaa	imlaa
mikaayaa	mikaayaa
aahatgyaa	aahatcyaa
sinhi	sinhi
aasubaa	aasumbaa
yolam	yolam
yeholam	yeholam
saib	saidiex
kehaasi	gehaasi
aannon	aannon
yehoaahaatg	yehoaahaatc
aataaliyaa	aataaliyaa
yehoaatg	yehoaatc
aamaasiyaa	aamaasiyaa
sejkaaliyaa	sekaaliyaa
sanlum	sanlum
utgsiyaa	utcsiyaa
kaadi	gaandi
menaahem	menaahem
atgsilia	atcsilie
pekaahiyaa	bekaahiyaa
lemaaliyaa	lemaaliyaa
pekaa	bekaa
aahatg	aahatc
lesin	lesin
kiaa	kiaa
midia	mindie
baabilon	mbaambilon
sejfaanwaaim	sefaanwaaim
hesekiyaa	hesekiyaa
sennaakelipq	sennaakelipv
isaayaa	isaayaa
aanpatg	aanbatc
henaa	henaa
ipgwaa	ipcwaa
aamon	aamon
yosiyaa	yosiyaa
aadaayaa	aandaayaa
mesunlaam	mesunlaam
aasaalaiyaa	aasaalaiyaa
saafaan	saafaan
hinkiyaa	hinkiyaa
aahikam	aahikam
aasaajyaa	aasaaxyaa
hundaa	hunndaa
kitglon	kitclon
sin	buonvsin
haamutaan	haamutaan
yelemi	yelemi
lipqlaa	lipvlaa
yehoyaakim	yehoyaakim
pedaayaa	bendaayaa
yehoyaakin	yehoyaakin
ennaatan	ennaatan
sejdekiyaa	sendekiyaa
aanwatq	aanwatv
matqsaaj	matvsaax
kaataam	gaataam
mitqsaa	mitvsaa
anwaan	anwaan
binhaan	mbinhaan
saajwaan	saaxwaan
matqlekaa	matvlekaa
makqdien	makvndien
ilaam	ilaam
peletq	beletv
haamun	haamun
etaan	etaan
hemaan	hemaan
kaanko	kaanko
daandaa	ndaanndaa
yete	yete
sejkupg	segupc
sammai	sammai
aabihaain	aambihaain
itgi	itci
sesan	sesan
akglai	akclai
saajbaatg	saaxmbaatc
eleaasaaj	eleaasaax
yekaamiyaa	yekaamiyaa
peletg	beletc
efaa	efaa
saaapg	saaapc
qewaa	qewaa
simeaa	simeaa
nokaa	nogaa
sejlupqbaaben	selupvmbaamben
haananyaa	haananyaa
belekiyaa	mbelekiyaa
pelaatiyaa	belaatiyaa
yesaayaa	yesaayaa
lefaiyaa	lefaiyaa
sekaaniyaa	sekaaniyaa
semaiaa	semaiaa
hatqtatq	hatvtatv
neaaliyaa	neaaliyaa
elionai	elionai
atglikam	atclikam
hodaawiyaa	hondaawiyaa
eliyaasipq	eliyaasipv
pelaiyaa	belaiyaa
akgkupg	akckupc
yohaanan	yohaanan
delaiyaa	ndelaiyaa
leaayaa	leaayaa
yaahaatg	yaahaatc
etaam	edaam
itgmaa	itcmaa
helaa	helaa
paasejaa	baaseaa
sejlaiaa	selaiaa
etglaa	etclaa
meletq	meletv
efe	efe
kenan	kenan
maahaalaalen	maahaalaalen
enokq	enokv
metusejlaa	metuselaa
noyaa	noyaa
aalam	aalam
qelaa	qelaa
isakg	isakc
lotaan	lotaan
dison	ndison
haadatg	haandatc
yudaa	yundaa
amminaadapg	amminaandapc
naason	naason
sanjmon	sanxmon
obetg	ombetc
jaai	jaai
sesan	sesan
naatan	naatan
yehu	yehu
daawitq	ndaawitv
lehojboam	lehoxmboam
aabiyaa	aambiyaa
aasaaj	aasaax
aamaasiyaa	aamaasiyaa
aasaaliyaa	aasaaliyaa
aahatg	aahatc
hesekiyaa	hesekiyaa
ammon	ammon
yehoyaakin	yehoyaakin
sejlupqbaaben	selupvmbaamben
yesaayaa	yesaayaa
lefaiyaa	lefaiyaa
obaadi	ombaandi
semaiaa	semaiaa
yaahaatg	yaahaatc
maalesaa	maalesaa
kedelaa	gendelaa
nemuen	nemuen
yaalipq	yaalipv
sanlum	sanlum
mipqsamj	mipvsamx
sakgke	sakcge
aayin	aayin
yoen	yoen
aasien	aasien
aadien	aandien
zizaa	zizaa
yedaayaa	yendaayaa
simli	simli
mikaa	mikaa
kileaatg	gileaatc
mikaaen	mikaaen
aahi	aahi
elien	elien
finehatg	finehatc
aabiquwaa	aambiquwaa
bukgki	mbukcki
utgsi	utcsi
sejlaahiyaa	selaahiyaa
sejlaahiyaa	selaahiyaa
melaayotq	melaayotv
aamaaliyaa	aamaaliyaa
aamaaliyaa	aamaaliyaa
saajdokg	saaxndokc
hinkiyaa	hinkiyaa
yehosaadakg	yehosaandakc
nebukatqnetqsaa	nembukatvnetvsaa
simjmaa	simxmaa
yoaa	yoaa
zelaa	zelaa
enkaanaa	enkaanaa
ebiyaasaapg	embiyaasaapc
ebiyaasaapg	embiyaasaapc
taahatg	taahatc
ulien	ulien
utgsiyaa	utcsiyaa
eliapg	eliapc
yeloham	yeloham
yeloham	yeloham
simeaa	simeaa
maahaatq	maahaatv
aamaasaij	aamaasaix
yoen	yoen
sejfanyaa	sefanyaa
atgsij	atcsi
itghaa	itchaa
kohaatq	kohaatv
lewi	lewi
aasaapg	aasaapc
aasaapg	aasaapc
belekiyaa	mbelekiyaa
mankiyaa	mankiyaa
simjmaa	simxmaa
keson	geson
apgdi	apcndi
manlukq	manlukv
haasaapiyaa	haasaabiyaa
haasaapiyaa	haasaabiyaa
amsi	amsi
amsi	amsi
baani	mbaani
qeme	qeme
maali	maazli
melaali	melaali
utgsi	utcsi
melaayotq	melaayotv
daabelatq	ndaambelatv
puaa	puaa
yediyaaen	yendiyaaen
yelimotq	yelimotv
yelemotq	yelemotv
aalemetq	aalemetv
kenaaaanaa	kenaaaanaa
hupgpim	hupcbim
supqpim	supvbim
pelctq	belaetv
ulaam	ulaam
telaa	telaa
taahan	taahan
laadaan	laandaan
laadaan	laandaan
mankien	mankien
yaafeletq	yaafeletv
some	some
hotaam	hotaam
sojfaa	sofaa
bese	mbese
aalaa	aalaa
atgdaa	atcndaa
mesaa	mesaa
enpaaan	enbaaan
aahiyo	aahiyo
saasakq	saasakv
sejbaadiyaa	sembaandiyaa
ede	ende
yohaa	yohaa
yaakim	yaakim
sinjletai	sinxletai
haanan	haanan
yeien	yeien
saulo	saulo
piton	biton
melekq	melekv
taalia	taalie
simjli	simxli
bineaa	mbineaa
bineaa	mbineaa
eleaasaaj	eleaasaax
aasen	aasen
bokelu	mbokelu
seaaliyaa	seaaliyaa
isaalaaen	isaalaaen
yeuen	yeuen
sanjlu	sanxlu
hatgsejnuaa	hatcsenuaa
elaa	elaa
mesunlaam	mesunlaam
sefaatiyaa	sefaatiyaa
leuen	leuen
aadaayaa	aandaayaa
paatghe	baatche
paatghe	baatche
mankiyaa	mankiyaa
imme	imme
kaalaan	gaalaan
matqtaaniyaa	matvtaaniyaa
sikgli	sikcli
yedutun	yendutun
yedutun	yendutun
mikqlotq	mikvlotv
yebutg	yembutc
pelon	belon
sipgbekai	sipcmbekai
saaanbon	saaanmbon
eliyaabaa	eliyaambaa
kimso	gimso
haasem	haasem
uaa	uaa
itglai	itclai
yaaaasien	yaaaasien
semaaliyaa	semaaliyaa
itgsiyaa	itcsiyaa
aasaalen	aasaalen
yaasobeam	yaasombeam
aabiqai	aambiqai
silia	silie
saataan	saadaan
selomotq	selomotv
kesom	gesom
haalim	haalim
miyaamin	miyaamin
hakqkotg	hakvkotc
yesuaa	yesuaa
binkaa	mbingaa
hesi	hesi
petaahiyaa	betaahiyaa
maaaasiyaa	maaaasiyaa
yaaaasiyaa	yaaaasiyaa
kedaaliyaa	gendaaliyaa
yedutun	matvtitiyaa
sebuen	sembuen
haanaani	haanaani
yehohaanan	yehohaanan
hosaaj	hosaax
hendai	henndai
elihu	elihu
itgmaiaa	itcmaiaa
aanki	aanki
saalomxn	saalomorn
tailaq	tailaqv
yapqfaa	yapvfaa
kelubim	kelumbim
isaalaaen	isaalaaen
saalomxn	saalomorn
sekem	sekem
yeloboam	yelomboam
maahaalatq	maahaalatv
yelusaalem	yelusaalem
yudaa	yundaa
odetg	ondetc
baaaaqaa	mbaaaaqaa
yehosaafatq	yehosaafatv
netaaniyaa	netaaniyaa
tobiyaa	tombiyaa
yehosaabaatg	yehosaambaatc
aahapg	aahapc
yaahaasien	yaahaasien
aahatgyaa	aahatcyaa
yeholam	yeholam
yehien	yehien
etiopia	etiobie
yolam	yolam
yehu	yehu
yehoyaadaa	yehoyaandaa
simeatg	simeatc
yehoaatg	yehoaatc
yekoliyaa	yekoliyaa
filisaatia	filisaadie
aamxtq	aamortv
ofen	ofen
yotaam	yotaam
maaaasejaa	maaaaseaa
mesinlemotq	mesinlemotv
maanatqsej	maanatvse
aamon	aamon
yosaabaatg	yosaambaatc
yoaahaatg	yoaahaatc
yelemi	yelemi
pesia	besie
sailatq	sailatv
haaditg	haanditc
ono	ono
sejnaaaa	senaaaa
aantaasesitq	aantaasesitv
mitqledaatg	mitvlendaatc
daaliatg	ndaaliatc
hakqkai	hakvgai
yiutai	yiutai
aahitupq	aahitupv
aabiquwaa	aambiquwaa
eleaasaa	eleaasaa
esaalaa	esaalaa
aahaawaa	aahaawaa
esaalaa	esaalaa
sapqbetai	sapvmbetai
kelitaa	kelitaa
melemotq	melemotv
matqtenai	matvtenai
selemiyaa	selemiyaa
haakaaliyaa	haakaaliyaa
nehaami	nehaami
susaaj	susaax
sanjbaanlatq	sanxmbaanlatv
tobiaa	tombiaa
kesem	gesem
imli	imli
mesesaaben	mesesaamben
yoyaadaa	yoyaandaa
haasapqneyaa	haasapvneyaa
hatgsupq	hatcsupv
hanlohetg	hanlohetc
lehum	lehum
sapgbai	sapcmbai
baalukq	mbaalukv
hatgsupq	hatcsupv
henaadatg	henaandatc
binnwi	mbinnui
paalaan	baalaan
paalotq	baalotv
tobiaa	tombiaa
modekai	mondekai
binsaan	mbinsaan
bikgwai	mbikcwai
katgmien	katcmien
qebaaniyaa	qembaaniyaa
bunni	mbunni
selepiyaa	selebiyaa
hodiyaa	hondiyaa
daanien	ndaanien
kinneton	ginneton
patglotq	batclotv
satgtu	satctu
atgkaatg	atcgaatc
bebai	mbembai
aadin	aandin
aate	aate
haasum	haasum
besai	mbesai
haalipq	haalipv
yaatqduwaa	yaatvnduwaa
aanaayaa	aanaayaa
sanjlai	sanxlai
yoyaalipq	yoyaalipv
atglikam	atclikam
sijhag	sihaqc
seantien	seantien
yoyaakim	yoyaakim
yonaataan	yonaataan
minyaamin	minyaamin
aamokq	aamokv
tanmon	tanmon
hosaayaa	hosaayaa
matqtaaniyaa	matvtaaniyaa
mikaayaa	mikaayaa
eliyaakim	eliyaakim
aahaasuelatq	aahaasuelatv
india	inndie
watqqaati	watvqaati
yekoniyaa	yekoniyaa
modekai	mondekai
esete	esete
esete	esete
esete	esete
haamaan	haamaan
haamaan	haamaan
haataakq	haataakv
haataakq	haataakv
kendia	kenndie
lewiaataan	lewiaataan
quwaa	quwaa
bindatg	mbinndatc
naaaame	naaaame
elihu	elihu
behemotq	mbehemotv
selaa	selaa
selaa	selaa
txb	dorziec
myenb	zuizmienh
lebaanxn	lembaanorn
tonj	dangxdonx
kebaan	gembaan
aamen	aamen
laavg	wuomlaangc
menkisedekg	menkisendekc
jxdcn	jorndaen
yaakopq	yaakopv
efaataa	efaataa
qiaj	singqiex
faauj	gorngvnjaaux
itien	itien
itien	itien
saalon	saalon
janb	janxmuangz
anman	anman
txvb	sicdorngh
zyruq	bingxciouv
waav	biauvhuaang
tomb	wuomdomh
daamatqkatg	ndaamatvgatc
efaaim	efaaim
vaaid	baengcngaaiz
donj	ndiangxndonx
baabilon	mbaambilon
moapg	moapc
naiaa	naiaa
iyipq	iyipv
atgsilia	atcsilie
sepqnaa	sepvnaa
naavj	laihnaangx
aalien	aalien
aalien	aalien
jiaq	nziaauxjieqv
sion	sion
isaayaa	isaayaa
saipatg	saibatc
jxib	biouvjoih
kcv	lozgaeng
baaan	mbaaan
zauj	buozzaux
mankiaa	mankiaa
yosiyaa	yosiyaa
sijdaa	sindaa
atgkelon	atckelon
uliaa	uliaa
kemaaliyaa	gemaaliyaa
kolaayaa	kolaayaa
nehelaam	nehelaam
sejfanyaa	sefanyaa
puvb	bungxzuoqc
sejdekiyaa	sendekiyaa
kendia	kenndie
neliyaa	neliyaa
baalukq	mbaalukv
kxg	gorqvmienh
koniyaa	koniyaa
yehukan	yehukan
benyaamin	mbenyaamin
matqtaan	matvtaan
kaaleaa	kaaleaa
tanhumetq	tanhumetv
kaaleaa	kaaleaa
kedaaliyaa	gendaaliyaa
taapaanhetg	taabaanhetc
memfitq	memfitv
kiliyaataaim	kiliyaataaim
dibon	ndimbon
edom	endom
edom	endom
fxvb	forngcang
baabilon	mbaambilon
nebukatqnetqsaa	nembukatvnetvsaa
pwrnb	buonvguoqv
scvb	saenghmz
kebaa	kembaa
yaaaasanyaa	yaaaasanyaa
lwib	luijuoqv
oholaa	oholaa
oholibaa	oholimbaa
etiopia	etiobie
scvb	saengcietv
miab	mievciangv
home	home
daanien	ndaanien
bentesatqsaa	mbentesatvsaa
satqlakq	satvlakv
mesaakq	mesaakv
aabetgneko	aambetcnego
aabetgneko	aambetcnego
bensatqsaa	mbensatvsaa
mene	mene
teken	teken
paasin	baasin
kaabelyen	gaambelien
hoseyaa	hoseyaa
aamotq	aamotv
aamotq	aamotv
keliotg	keliotc
kinkaan	gingaan
finisia	finisie
saajlefatq	saaxlefatv
yonaa	yonaa
yonaa	yonaa
ninaawe	ninaawe
pyeib	bieivzeiv
naahum	naahum
libia	limbie
haabaakukg	haambaagukc
kusi	kusi
minkom	minkom
hxvg	jaaihorngc
favb	njanglaangc
yosuwaa	yosuwaa
zaib	caidoix
peletq	beletv
hetqlon	hetvlon
boaatg	mboaatc
jyetgsi	jetcsi
eliyaakim	eliyaakim
yosepq	yosepv
maaliyaa	maaliyaa
maaliyaa	maaliyaa
yesu	yesu
yesu	yesu
kitug	giduc
yesu	yesu
imaanuen	imaanuen
helotq	helotv
yudia	yundie
naasaaletq	naasaaletv
naasaaletq	naasaaletv
yohan	yohan
yohan	yohan
yohan	yohan
txnb	dornhnamv
sejbedi	sembendi
yaakxpg	yaagorpc
totqbuli	totvmbuli
kilo	gilo
filipq	filipv
baatolomiu	mbaatolomiu
tomatq	tomatv
matqtaai	matvtaai
anfeatg	anfeatc
tatqdeatg	tatvndeatc
simon	simon
yudaatg	yundaatc
isaakaaliotg	isaakaaliotc
faalisij	faalisi
faalisij	faalisi
beensebun	mbeensembun
saataan	saadaan
helodyetg	helondietc
yesu	yesu
txn	mbiauzdorn
saadusij	saandusi
saadusij	saandusi
pite	bide
pite	bide
saib	saigorx
betaani	mbetaani
sisaa	sisaa
kitug	giduc
kaayaafaatq	kaayaafaatv
pite	bide
lomaa	lomaa
pilaatq	bilaatv
yudaatg	yundaatc
pilaatq	bilaatv
pilaatq	bilaatv
baalapqbatg	mbaalapvmbatc
baalapqbatg	mbaalapvmbatc
sailin	sailin
simon	simon
eli	eli
laamaasaabakgtaani	laamaasaambakctaani
makqdaalaa	makvndaalaa
andaalu	anndaalu
kaapenaaum	kaabenaaum
yesu	yesu
helotq	helotv
betgsaidaa	mbetcsaindaa
mose	mose
hosaanaa	hosaanaa
lomaa	lomaa
aalekqsaande	aalekvsaannde
lufatq	lufatv
matqtatq	matvtatv
matqtatq	matvtatv
menki	menki
menki	menki
matqtaatiatg	matvtaatiatc
matqtaatiatg	matvtaatiatc
eaa	eaa
simeon	simeon
apglaaham	apclaaham
naaho	naaho
sejlukq	selukv
leu	leu
pelekq	belekv
ebe	embe
aanfaasatq	aanfaasatv
laamekq	laamekv
yaaletq	yaaletv
enotq	enotv
aadam	aandam
kelaasaa	gelaasaa
yailatq	yailatv
saamaalia	saamaalie
pyaub	biauvziouv
maataa	maataa
kaalili	gaalili
sijloam	siloam
taan	zaeqvdaan
laasaalatq	laasaalatv
sakgkyetq	sakckietv
helotq	helotv
filipq	filipv
naataanaaen	naataanaaen
nikodematq	nikondematv
yiutai	yiutai
kaanaa	kaanaa
laasaalatq	laasaalatv
laasaalatq	laasaalatv
maataa	maataa
yudaatg	yundaatc
annaatq	annaatv
aanaania	aanaanie
aanaania	aanaanie
saatefen	saatefen
antiokg	antiokc
nikolau	nikolau
saulo	saulo
aineatg	aineatc
litqdaa	litvndaa
koneliatg	koneliatc
koneliatg	koneliatc
sisaaliyaa	sisaaliyaa
baanaabatg	mbaanaambatc
baanaabatg	mbaanaambatc
taasatq	taasatv
maako	maako
paulo	baulo
paulo	baulo
ikoniyum	ikoniyum
hemetq	hemetv
pekaa	begaa
silaa	silaa
maasidonia	maasindonie
paulo	baulo
silaa	silaa
tesaalonikaa	tesaalonigaa
yaasonj	yaasonx
aaten	aaten
timotai	timotai
kolinto	kolinto
kaalitqpatg	kaalitvbatc
kanlio	ganlio
aakaayaa	aakaayaa
efeso	efeso
pitgsinjlaa	bitcsinxlaa
aakwinlaa	aakuinlaa
aapxlo	aaborlo
aantemitq	aantemitv
esia	esie
demetqliatg	ndemetvliatc
beloaa	mbeloaa
aalitqtaakatq	aalitvtaakatv
kaaiatg	gaaiatc
tikikatg	tikigatc
tofimatq	dofimatv
toatg	doatc
silisia	silisie
felikq	felikv
felikq	felikv
kaalaaudiatg	kaalaaundiatc
lisyetq	lisietv
fesaatatq	fesaatatv
fesaatatq	fesaatatv
aagipaa	aanqipaa
aagipaa	aanqipaa
apglaaham	apclaaham
kitug	giduc
saapen	saaben
lusiatg	lusiatc
saatefaanatq	saatefaanatv
aapxlo	aaborlo
maasidonia	maasindonie
kitug	giduc
titatg	tidatc
titatg	tidatc
epaafaa	ebaafaa
laudisia	laundisie
himeneatg	himeneatc
demaatq	ndemaatv
kaalaatia	gaalaatie
lukaa	lugaa
onesifolatq	onesifolatv
elatqtatq	elatvtatv
miletatq	miletatv
filemon	filemon
onesimatq	onesimatv
saalem	saalem
mose	mose
baalaaam	mbaalaaam
kaain	kaain
kolaa	kolaa
