เยซู	yesu
เยซู	yesu
หฑั่ง	Ravg
ต้ง	tovb
ธอ	Zx
ทินฮู่ง	Tinb huvb
เหฒย	zeij
ลู่ง	luvb
เดา	Dau
เหธา	Zauj
หม่าน	maang
หมวด	mwrtg
ฮนั้ง	Navq
น้าย	naaiq
นอ	nx
เหฒียง	zyavj
เหฑ่ง	Revg
อ๊ะ	aq
เถา	Tauj
ตะเธี้ยด	taZyetq
ฮนอย	Nxi
โหฒว	zruj
นิ่น	ninb
เญย	Eei
กง	kov
ฯฒฯ	zyrug
ตี้ง	tivb
ฮิด	hitq
ขวน	Kwrnj
ธ้วด	Zwrtq
เหธย	Zeij
ฟุ	fuq
ปุน	pun
วั้ว	uaq
นอม	nxm
เป๋น	penj
ธีงเหฑ่ง	Revg
เหว่ย	weig
หฒุ	zug
หย่า	yaag
หฮวีง	Wivj
เจ๊าโหล่ว	lrug
เซ	se
เฒี้ยว	zyruq
หฒั่น	zang
ไม้	maiq
แก้ง	kcvb
ม่าย	maaib
หาย	haiq
หญู่ง	Euvg
เมี้ย	miaq
เดี๋ยง	Dyavj
ขูง	Kuvj
ววม	uam
เยียม	yem
สาม	saamj
ต้าย	taaib
ดอน	Dxn
ก๋อม	kxmj
แอ๋ง	cvj
เฒาะ	zxq
เต๋ย	teij
เนียบูง	Buv
นั้น	nanq
เต้า	taub
เมี่ยน	myenb
ปย๊ม	pyomq
แหม่ง	mcvg
เฉีย	Qiaj
เปียะ	piag
บะฒอง	Bazxv
ตง	tov
ปูง	puv
กะญั์ว	kaEuad
เดี๊ย	Diaq
ม่าน	maanb
เจี์ย	Jiad
กอน	kxn
หฮยาง	Yaavj
เจี๊ยน	Jyenq
ฝาว	faauj
ยู์ง	yuvd
ตุ๊	tuq
เซียะ	siaq
ก๊อง	kxvq
บั๋ว	Buaj
เม่ย	meib
เม่ย	meib
เหยียด	yetg
เปย๊า	pyauq
ฮมวั้ง	Mwavq
ต่อย	txig
อ๋อย	xij
ฑั้ง	Ravq
จ๋า	Jaaj
เยีย	yia
ปวัด	pwatg
กั้น	kanb
หอบ	hxpg
เฮญี้ยว	Hruq
ตะฟ่าน	tafaanb
หวุย	wij
แซงคู้	Kuq
ต้อ	txb
เสี่ย	siag
ต๋อย	txij
โก๊ว	kruq
เญ์ย	Eeid
เหนาะ	nxg
เสีย	siaj
โต่ว	trug
ป๊วน	pwrnq
ฒู้ง	zuvq
หละคุ	laKuq
เฮยี่ย	Yiab
ฒ่อย	zxib
ปวัง	pwav
หว่า	waag
ตอน	txn
บัว	Bua
ตอนเจว๊ย	Jweiq
ฟุนฟะ	faq
ปวั๊ง	pwavq
ทิน	Tinb
เต่ย	teig
โต้ว	trub
เดาเป้ย	Daub
ญอง	Exv
กะน้าย	kanaaiq
ค้อย	Kxiq
เบย์า	Byaud
กั้ม	kamb
เหฑีย	Riaj
จิว	Jiu
กุ๊น	kunq
ไฮ่	haib
ต์ง	tovd
หญั่น	Eang
ฮบ	hopq
อี้	ib
หญู่งๆ	Euvg
ฒิ่น	zinb
ด่าง	Daavg
มี่ง	mivb
เซม	sem
ฮาม	haam
เฒ้ยฟุน	zeib
เหยียม	yemj
ลิ์ว	liud
ฆะฮ้า	Gahaaq
ปัว	pua
ดุ	Dug
ฟี่	fib
ฝีง	fivj
โฮล	Lo
เม่ง	mevb
โห่	hog
เหฒียว	zyruj
ฝีงๆ	fivj
เมี่ยน	myenb
หฒิว	ziuj
เจ๊า	Jauq
โล้ด	lotq
เธี้ยด	Zyetq
เหฒียบ	zyepg
ฮม์	Mmd
หฮญัง	Havj
เอ๊า	auq
ฟุน	fun
เลี่ยม	lyemb
หฒ่อน	zxng
เต้าๆ	taub
เต่ยปูง	puv
หมี่	mig
กัน	kan
เจี๋ย	Jiaj
ฒี่ง	zivb
ติ้ว	tiub
ต้ม	tomb
บะอง	Baov
เฒวย	zwei
หิ่น	hing
น้าย	naaiq
เหฒี่ยต้อง	ziab
เหฒี่ย	ziag
ฮู่ง	huvb
หฮญังเจ๊ย	Havb
จั๊ว	Juaq
เยีย	yia
เน่น	nrnb
หมวัง	mwavj
หฒั่นๆ	zang
ลั่ม	lamb
เฆ่ม	Gemb
ต๋อง	txvj
เฒว์ย	zweid
ด๊บลิ่ว	liub
เก้า	kaub
ยัวะ	yuaq
เฒี่ยง	zyavb
เสย	seij
หฒั่ง	zavg
แป๊ะ	pcq
หญี่	Eig
ฮลัง	Lav
โก๋	koj
ไห่	haig
หล่ง	lovg
เห่ว	heug
เหฌี่ย	Fiag
จาตี้ง	tivb
หฑิบ	Ripg
เฒ้ย	zeiq
ปวั้ง	pwavb
หฑุ่น	Rung
ฮวาง	Waav
หง่อ	vxg
หล่มฮวาง	lomb
กวั้น	kwanb
ปะกี	paki
ยู่ง	yuvb
เปว๋ย	pweij
กะเฮลน	kaLen
ฟินเมี่ยน	myenb
แปง	pcv
ไฟ	fai
เธี้ยง	Zyavq
พ้าย	Paaiq
เฝียน	fyenj
ล์อ	lxd
ก๋อ	kxj
หฌาว	Faauj
เกา	kau
เฝย	feij
ฆอย	Gxi
ฝุเจว๊ย	fuJweiq
อี	i
โน่ว	nrub
เป์ย	peid
พัวะ	Puaq
หธีง	Zivj
ฟัด	fatq
มป่า	mq paag
ถิว	Tiuj
ฒิบ	zipq
ชัม	Qam
ฒม	zom
มเซียะ	msiaq
หฑย่าว	Ryaaug
ไฮ์	haid
ฮนั้ม	Namq
หลง	lovj
ดั๊ว	Duaq
ซุ้ย	swiq
หมิ่วฝัง	miub
กวั่ง	kwavg
สา	saaj
เหยี่ยน	yeng
ลุยโหว	hruj
หธ่อ	Zxg
เตีย	tia
หลุน	lunj
เล่ย	leib
เปย๋า	pyauj
ซิน	sin
ตะเหญ่ย	taEeig
เถง	Tevj
หมั่ง	mavg
หว่าย	waaig
ไต่	taig
หธาม	Zaamj
โป้ว	prub
อะหงุ่น	avung
ติ๊ว	tiuq
เจียน	Jyen
ฌั้ว	Fuaq
ต่อง	txvg
เตี๋ย	tiaj
โก๋ว	kruj
ติ่น	ting
แปงเปย๊ย	pcvb
หววน	wrnj
โล่	lob
เล่า	laub
เบ๋ย	Beij
โซ้ว	sruq
ด้าย	Daaib
เฮลน	Len
ยั่ง	yavb
ง่ง	vovb
เหฑว่ย	Rweig
จุ่น	Jung
หลัวะ	luag
ติ	tig
น่อม	nxmb
เบย้า	Byaub
ม์าย	maaid
หฮนาง	Naavj
ไต่	taig
โค้ว	Kruq
ฒ้าน	zaanq
ญ่าน	Eaanb
ตั๊บ	tapq
บัวะ	Buag
ฑุ่ย	Rwib
โปว	pru
เอย	ei
ดอม	Dxm
เฑี้ยว	Ryruq
ฌัง	Fav
ฝูง	fuvj
ล่อ	lxb
หฑวน	Rwrnj
หฒิ	zig
หนั่ง	navg
โก	ko
ก๊าน	kaanq
หฒุ่น	zung
หฒ่าย	zaaig
หน่าย	naaig
ก๋า	kaaj
ติ่ว	tiug
บัว	Bua
เญี์ยน	Eyend
เป๊ะ	peq
ฮิ้ว	hiuq
ฑ่อย	Rxib
กั๊บ	kapq
ฒุ้น	zunq
ฮี้ง	hivq
สี่	sig
อ่า	aag
ชะ	Qaq
ต้าว	taaub
มั์ว	muad
หฑุ	Rug
ด๊าว	Daauq
โตะ	tog
หวัวะ	uag
กิ่น	king
ต๊า	taaq
หฒะเอ๋ย	zaeij
ธ่าง	Zaavb
ล่าง	laavb
ไต๋	taij
เซว่ย	sweib
เอ๋ย	eij
ฮงะ	Vaq
หลวั่ง	lwavg
จาน	Jaan
ตั๋ง	tavj
หลาย	laaij
เธี้ยว	Zyruq
เธง	Zev
ปั์ว	puad
วินวั้ง	wavq
จาง	Jaav
เกว่ย	kweig
ป๋าย	paaij
เซี่ยน	syenb
ซ้าว	saauq
หล่าว	laaug
ย่าง	yaavb
หงาด	vaatg
อ๊อ	xq
บ๊าบ	Baapq
ก๊าม	kaamq
แฮะ	hcq
เญีย	Eia
โด้	Dob
เฮมย	Mei
ฆว่า	Gwaab
โหฑ	Roj
ซิ	siq
ฑย้าม	Ryaamq
เหยี่ยม	yemg
เป๊ย	peiq
เปี๊ยว	pyruq
ธั้ม	Zamq
ค้อยเฮลน	Len
กั๊บจ๋าย	kapg
ต๋าว	taauj
เฮ้น	henq
ล่าน	laanb
บุด๋ง	BuDovj
ดาน	Daan
แป้ง	pcvb
ฟิม	fim
เซี้ยม	syemq
แปะ	pcg
นาง	naav
ปี๋ง	pivj
หฮลา	Laaj
เหญียะ	Eiag
เบว์ย	Bweid
เฒียะ	ziaq
ฒูง	zuv
ฮล้อบ	Lxpq
กู้งว์า	vwaad
อัน	an
หล่ม	lomg
ต่อ	txg
หมั่ง	mavg
ตอง	txv
หฑะเฮมียน	RaMyen
แหง่ง	vcvg
ฮ่อง	hxvb
จั๋งโห่	hog
หฑั่ม	lob
เล์ยหลัด	latg
ฑูง	Ruv
เหฌียว	Fruj
ท่าย	Taaib
เบ๊าะ	Bxq
โอ	o
บย่าว	Byaaug
เจี๊ยะ	Jiaq
ป่าย	paaig
หฌบ	Fopg
โต์ว	trud
ปั๊ว	puaq
ชุย	Qwi
ฆ้าว	Gaauq
หฒวัง	zwavj
สิน	sinj
บง	Bov
คัง	Kav
เหลียบ	lyepg
ไซ	sai
สี	sij
กิ๊น	kinq
ธ้วด	Zwrtq
ตู๋ง	tuvq
เฒี่ยน	zyenb
เล์ย	leid
หฒะ	zag
หนิ่ม	nimg
อ๋อย	xij
ฝ่ง	fovg
ห่อ	hxg
เจียม	Jyem
สุย	swij
เซ้ด	setq
บั๊ว	Buaq
ล่าม่า	lamaab
เปยย	pyei
ตัง	tav
กะลั้น	kalanq
โย่ว	yrub
ดาง	Daav
หลาบ	laapg
หลิ่ว	liug
หฒอบ	zxpg
ออน	xn
ฮูง	huv
จ๋าย	Jaaij
แล์ง	lcvd
ฟาง	faav
กะเหญี่ย	kaEiag
ปิน	pin
ฮ่อม	hxmb
ตะซุ	tasuq
ปยา	pyaa
เดาะ	Dxg
จั๊ง	Javq
เก๊าะ	kxq
แพยง	Pycv
แน้ด	nctq
เปี้ยน	pyenb
กะเดี๊ย	kaDiaq
แหมง	mcvj
แกง	kcv
หลาด	laatg
น่าม	naamb
แบะ	Bcg
ต่ง	tovg
ไฟ	fai
เดีย	Dia
ทบ	Topq
ท้าบ	Taapq
เว่ย	weib
ปย๊า	pyaaq
ธอง	Zxv
ว้วน	wrnq
ตี๋ง	tivj
เงา	vau
บั๋ว	Buaj
หฒา	zaaj
ติ้น	tinb
เหฒียะ	ziag
เตี้ย	tiab
จอง	Jxv
ก๊าด	kaatq
ธิ	Ziq
เหลาะ	lxg
ติว	tiu
เปี้ยง	pyavb
หฒุ	zug
คว้าย	Kwaaiq
หละเปย๊ยเป๊น	penq
เฟี้ย	fiaq
ฮู้	huq
หัด	hatg
เปี๋ยน	pyenj
ดั๊ด	Datq
ฒุ	zuq
สีง	sivj
ฟูสู	fub
จั๊บ	Japq
หม่วน	mwrng
จ๊าย	Jaaiq
เหยียน	yenj
ฒี่	zib
แซงเยี้ยด	scvb
หวุ่ย	wig
มาน	maan
มฆ้อง	mGxvq
ฟิ	fiq
ฒุ์ย	zwid
บ๊วนหม่วน	Bwrnb
ธะโป่ว	Zag
เล์ยเหญ่ย	Eeig
ฮวีง	Wiv
หญุด	Eutg
เปว	peu
นิด	nitq
ปี๊ง	pivq
ตะเป๊ด	tapetq
เก๊าะเมี่ยน	kxg
ฮูงโล่ว	huvb
เฮยี้ยด	Yetq
เต้ย	teib
บ๋าย	Baaij
เหฮลง	Levj
ฟาน	faan
มจั่ง	mJavg
แฒะ	zcq
หฑาว	Raauj
หฮมวัง	Mwavj
มัวะ	muaq
เก้	keb
เบี๊ยน	Byenq
เฮมียน	Myen
ไพ	Pai
เธียน	Zyen
หม่า	maag
น้าย	naaiq
ตี่ง	tivg
ฒุ่น	zunb
เหญ่ย	Eeig
เหฒีย	ziaj
ไม้	maiq
เหล่ง	levg
เจ๊ย	Jeiq
เก่	keg
เยียม	yem
เถย	Teij
ฒั้ว	zuaq
ฮนอยเหญียะ	Eiag
เลี่ยว	lyrub
บะเปยย	Bapyei
ซยาม	syaam
คู่	Kub
เซย	sei
มา	maa
โย์ว	yrud
หมั่ว	muag
เฒ่ย	zeib
กั๊วะ	kuaq
จาสี่	sig
จุ๊	Juq
เธีย	Zia
ก๊ม	komq
ลิ่ว	liub
เปย๊ย	pyeiq
เหฑียมย่าง	Ryemb
หฑัด	Ratg
บุย	Bwi
คู้ด	Kutq
ซูง	suv
ปย๊าบย่า	Byaag
องถาย	Taaij
จวั่ง	Jwavg
หลี่ง	livg
โธะ	Zoq
หูง	huvj
ด๊บ	Dopq
จ้าง	Jaavb
ฒ่ง	zovb
เกวย	kwei
หฒัง	zavj
ไกว๋	kwaij
อะเฮน้ย	aNeiq
ฟ้าด	faatq
ฮวิน	Win
ลี่ง	livb
มฒีง	mziv
ทง	Tov
เหฮยียน	Yenj
หยัวะ	yuag
ววนแป่ง	pcvg
ป่วน	pwrng
ตะเยี้ยด	tayetq
โฮ์ว	hrud
โฮ้ว	hruq
ด๊อด	Dxtq
โหฆ	Goj
หฒะเก้ง	zakevb
หละไกว้	lakwaib
ป่า	paag
จา	Jaa
จ๊าว	Jaauq
วิน	win
กาด	kaatg
ปั์วเดี๊ย	Diaq
โอก	okg
ไฝ	faij
จั๋ง	Javj
หละเปย๊ย	lapyeiq
โญ์ว	Erud
เฑ่า	Raub
เญี้ยม	Eyemq
จูง	Juv
ไฌ่	Faib
โม์ว	mrud
ม์านหฮมวัง	maanb
มู้ง	muvq
ฝัง	favj
โหยว	yruj
เฑี้ย	Riaq
หั่น	hang
ล์าง	laavd
ก๋อย	kxij
เฝง	fevj
โป๊ว	pruq
ดุ๊ด	Dutq
เฒย	zei
แอ๊ะ	cq
ปะหละ	palag
ธับ	Zapq
ม์า	maad
ม์าเธีย	Zia
โอ่	og
ฮ์อง	hxvd
ไล่	laib
โด๊ะ	Doq
เน้า	nauq
ก๋อโย์ว	yrud
น่า	naab
เกวน	kwen
ลุย	lwi
ดอบ	Dxpg
เล์า	laud
ปั่ว	puag
เจ๋า	Jauj
ต้อง	txvb
หฒี่	zig
โสว	sruj
โหม่ว	mrug
เซียว	syru
ถอง	Txvj
ธุนแกง	Zunb
ตน	ton
ฮวุย	Wi
ฒัวะ	zuaq
หฑาน	Raanj
มน่อม	mnxmb
ป้าม	paamb
เกน	ken
โท้	Toq
ญิ่น	Einb
ปองปั์ว	pxvb
นุน	nun
ฆาย	Gaai
บะฑิว	BaRiu
หยุ	yug
กวน	kwrn
ไม้	maiq
ไอ	ai
ธ้าง	Zaavq
ฒั้ว	zuaq
หว่าน	waang
ม์วน	mwrnd
บงไอ๊	aiq
ฮี่ง	hivb
แฑง	Rcv
ดั้ว	Duab
ปู้ง	puvb
ววมฒี้ง	zivq
แหธง	Zcvj
เหฒ่ง	zevg
ด้าว	Daaub
เขา	Kauj
หนิบ	nipg
ด๊ามฝีง	fivj
นอมๆ	nxmb
เค้า	Kauq
โฮ์	hod
ป๋าว	paauj
เบ๊าะ	Bxq
เตา	tau
ฝู่ง	fuvg
สี่	sig
เฑ์า	Raud
แก๊ะ	kcq
เฒ์ย	zeid
หม่าย	maaig
ฒ่า	zaab
มี่ง	mivb
ปุ๊ด	putq
แซ้ง	scvq
ขวิน	Kwinj
ตะเฝย	tafeij
หญั่น	Eang
ตั้ง	tavb
เธียนเธะ	Zeq
บวั์ง	Bwavd
กะน้ายเธ้น	kanaaib
หฑยาว	Ryaauj
อ๋าน	aanj
ปั่ง	pavg
โซว	sru
ฟะ	faq
สูบ	supg
เฒียน	zyen
ไบ้	Baib
เซวย	swei
ธิน	Zin
กู้	kub
หงว่าย	vwaaig
คี้ด	Kitq
ด่ง	Dovg
แบ่ง	Bcvg
บะเต้า	Bataub
โต๋	toj
กีก	kikg
เป๊าะ	pxq
กุ๊น	kunq
ธีง	Ziv
โท้	Toq
ไจ๊	Jaiq
จวังหฒิน	zinj
จุนแปง	pcv
เหมว่ย	mweig
หธัง	Zavj
เหย	heij
เฌียนโย่ว	Fyenb
โฑ์	Rod
พัด	Patq
ต้าน	taanb
ป้า	paab
ปิ่น	ping
นิ่น	ninb
หญู่ง	Euvg
ปู๋ง	puvj
เอ๊าะ	xq
เมี้ยน	myenq
ม่อ	mxb
ฑัง	Rav
ธัง	Zav
ปิว	piu
ฑบ	Ropq
หฌ่ง	Fovg
ตีง	tiv
เจี๊ยน	Jyenq
ซิ้ม	simq
โน้บ	nopq
หฒิน	zinj
กัด	katg
ฒง	zov
เฉียม	Qyemj
โด	Do
โฒ้ว	zruq
ฆาง	Gaav
เฮย	hei
ตะฟาม	tafaam
ตะฮม์	taMmd
ตะหลัวะ	taluag
มต้าย	mtaaib
จวั่ง	Jwavg
บู๊ง	Buvq
ห่อย	hxig
ม่าย	maaib
วิ่น	winb
เอน	en
นิ่น	ninb
ม่าย	maaib
จ่ม	Jomg
ธงเม่ง	mevb
ฑ้าด	Raatq
เคน	Ken
ปุ่ย	pwig
ทอ	Tx
ดุ้น	Dunb
กอง	kxv
ติ๊ม	timq
ธัวะ	Zuaq
เมว์ย	mweid
ห่ม	homg
สวัง	swavj
เซี้ยว	syruq
อ๊าบ	aapq
กงเมี่ยน	myenb
จวัง	Jwav
หฒัวะ	zuag
วุ่ย	wib
ฟาม	faam
เก้ม	kemb
ฟ่า	faab
เลี์ยว	lyrud
เดี้ยว	Dyrub
แฮ่ง	hcvb
บย๊อ	Byxq
ฝุน	funj
อะ	ag
ท่อ	Txb
ฒองฒุ	zuq
เผย	Peij
ฝู่	fug
เสียน	syenj
วั้ว	uaq
เยี้ยด	yetq
แป่ง	pcvg
ฒอง	zxv
แปงกวั้น	pcvb
ก้ม	komb
เหบ	hepg
ฉง	Qovj
ป์าม	paamd
เป๊ด	petq
หน่าน	naang
ไญ้	Eaiq
หฌุ่น	Fung
ตะจั๊ว	taJuaq
แซงเหฒียบ	scvb
กว๊าด	kwaatq
ตาน	taan
เหฮยียด	Yetg
โฑว	Rru
ฒ้าง	zaavq
เยียม	yem
ตุ๋น	tunj
หธะเหล่ง	Zalevg
ฟิ้วต้าน	fiub
ฆ้าบ	Gaapq
ธ่าว	Zaaub
โหะ	hog
ปั้น	panb
เหฒ่ย	zeig
เฮลียะ	Liaq
เปน	pen
เก๋ง	kevj
เต๋า	tauj
เก๋า	kauj
ฌังหล่าง	laavg
โจ๋ว	Jruj
พ้อ	Pxq
บู้ง	Buvb
หฒวด	zwrtg
ฑอง	Rxv
โน์ว	nrud
หฒ่อ	zxg
หฮญังๆ	Havb
เซี้ยบๆ	syepq
เบ่น	Beng
ป์อง	pxvd
ล่าว	laaub
คอย	Kxi
แธะ	Zcq
เหมียด	myetg
หฒาย	zaaij
ก๊อย	kxiq
เฝียว	fyruj
จอม	Jxm
เต๊ง	tevq
บะฮนอย	BaNxi
ลับ	lapq
เหฆน	Genj
ฮว้วด	Wrtq
งบ	vopq
กะเฉีย	kaQiaj
ฟิว	fiu
ฌ่อม	Fxmb
ทิ้ว	Tiuq
โย้บ	yopq
เฝย	feij
ฟ่าน	faanb
เฑียง	Ryav
ป้าม	paamb
กงฒิ่น	kovb
เพียน	Pyen
หฒีง	zivj
โล์	lod
อะฮนอย	aNxi
โคะ	Koq
ลิ่น	linb
ก๊อง	kxvq
ไกว	kwai
ไอ๊	aiq
เมี่ยน	myenb
โหฒะ	zog
ว่วน	wrnb
ฒาง	zaav
ตั๊ง	tavq
หม่อ	mxg
นั้ง	navq
ป๊า	paaq
ออนเหลาะ	lxg
บาง	Baav
เหน่า	naug
หญิด	Eitg
คู้	Kuq
แล่ง	lcvb
แก๊ง	kcvq
อม	om
เอาะ	xg
เก้ง	kevb
เฒี้ยง	zyavq
มุน	mun
เว้ด	wetq
เตี๊ย	tiaq
จ๊า	Jaaq
ตุ้น	tunb
ยุ่น	yunb
เสี่ยว	syrug
เผีย	Piaj
หฑยาวหฒุ่น	zung
กอนโด๊ะ	Doq
ฮลาง	Laav
เดาฮวาง	Daub
หธุน	Zunj
ขวัง	Kwavj
แซงเอ๋ย	eij
ธง	Zovb
อ๋า	aaj
เซ้ก	sekq
หฮงง	Vovj
โป่ว	prug
เมา	mau
ผุย	Pwij
ตุ้ย	twib
ซอง	sxv
เหฒา	zauj
ไบ	Bai
ดิ๋ว	Diuj
ฌิ้ม	Fimq
เหญี่ย	Eiag
ทิบ	Tipq
ก๊องแปะ	kxvb
จั๊ด	Jyetq
ฒอย	zxi
ล่าย	laaib
หลุ่ย	lwig
หลง	lovj
เญา	Eau
เฮยี้ยน	Yenq
เฮนี้ย	Niaq
งัด	vatq
เมี่ยน	myenb
เล์ย	leid
มู์ง	muvd
เหฒวย	zweij
ติ๊	tiq
ค้วด	Kwrtq
เญาะ	Exq
พิ	Piq
เหฒะ	zeg
บ๋วน	Bwrnj
ป๊ะ	paq
หญอ	Exj
เฮ่	heb
ธั่ม	Zamb
ฒุ่ย	zwib
จุ้น	Junb
โฮ่ว	hrub
แซง	scv
เสียว	syruj
ฑู่ง	Ruvb
ฆว้า	Gwaaq
ฒัด	zatq
เจี๊ยบ	Jyepq
ค้อเลี่ยน	lyenb
หง่าน	vaang
ด๊าด	Daatq
จ๊บเหญ่ย	Eeig
เยี่ยน	yenb
เซี้ยบ	syepq
ลุ่ย	lwib
โชวๆ	Qru
ฆวิน	Gwin
ด๋ง	Dovj
แกว๊ง	kwcvq
ม้วด	mwrtq
ไธ	Zai
กงฟิม	fim
ปิ๋ว	piuj
เธา	Zau
นี้ง	nivq
ดุย	Dwi
เดี๋ยงฆว่า	Gwaab
เบว๋ย	Bweij
เฒี้ยว	zyruq
ฮลู่ง	Luvb
ฮล้วด	Lwrtq
เฒว่ย	zweib
ฮ์าน	haand
ปย๊บ	pyopq
ไฆ้	Gaiq
แป๊ด	pctq
ลู้	luq
เดี๋ยงก์า	Dyavb
ก์า	Jyenq
โซวหฌุ่น	Fung
หลิ่ม	limg
ฌ้วด	Fwrtq
แมะ	mcq
ฟอง	fxv
ธุ้น	Zunq
เด่ย	Deig
โหย่ว	yrug
เจ้า	Jaub
เหธว	Zeuj
หลุ่น	lung
หละค้วด	laKwrtq
เฑี์ย	Riad
เธี้ย	Ziaq
ตะเหฒียบ	tazyepg
ทีง	Tiv
ธี่ง	Zivb
เบาะ	Bxg
ต๋น	tonj
โหธว	Zruj
ฑุด	Rutq
วั้ว	uaq
แฒง	zcv
เซียม	syem
เหมา	mauj
ฒองเหฒง	zevj
ดิ๊	Diq
ฒู่ง	zuvb
กะเซีย	kasia
เหญี่ยม	Eyemg
ฌุ่น	Funb
จู๊	Juq
ได๋	Daij
เกว๋ย	kweij
บยู่ง	Byuvg
สัม	samj
เหฮลย	Leij
เซีย	sia
ส่วน	swrng
โผว	Pruj
บะฮนอย	BaNxi
อ๊า	aaq
หฮลอง	Lxvj
โพวทง	Tov
ธี้ง	Zivq
หน่อย	nxig
ดั๊ว	Duaq
แม่ง	mcvb
เตว๊ย	tweiq
กิ๊ด	kitq
ถุย	Twij
ฑง	Rov
โต์	tod
จั๋น	Janj
กู๊	kuq
หฒูง	zuvj
เบี๋ยน	Byenj
ค้อยโฑว	Rru
จวั๊ง	Jwavq
ต๋าย	taaij
หลวน	lwrnj
ห่อง	hxvg
เหลี่ยว	lyrug
ต๊น	tonq
บย์อง	Byxvd
เป่ย	peig
นั่ง	navb
จิ๊ว	Jiuq
สาย	saaij
เก๊า	kauq
ดาม	Daam
บย๋าง	Byaavj
โธว	Zru
เซี้ย	siaq
เม้า	mauq
ควั้น	Kwanq
พะลี	Pali
พะหลาย	Palaaij
กว๋า	kwaaj
โจ้ว	Jrub
หฒัน	zanj
เกม	kem
บย่าง	Byaavg
ก๋อ	kxb
เหม	hemj
หละเญ้า	laEauq
โด๊ว	Druq
หลงๆ	lovj
ฮ่า	haab
คี	Ki
เอนฒี่ง	zivb
ฒั้น	zanq
หล่าง	laavg
ฉัง	Qavj
หญุ่น	Eung
เหง	hevj
น่อ	nxb
ฒุ์ย	zwid
นิ่น	ninb
โล์ฮนอย	Nxi
แคะ	Kcq
ต้าย	taaib
ปย้อง	pyxvb
เหฑียะ	Riag
โม่ว	mrub
เซียงฑูง	syavb
ปุ้น	punb
เล่ง	levb
ไจ่	Jaig
อิม	im
โต๊	toq
หธัม	Zamj
ชอง	Qxv
ฟง	fov
ม่วน	mwrnb
ม่าะ	maab
เสด	setg
ปาด	paatg
จ้อย	Jxib
ฆวะ	Gwaq
ดิบ	Dipg
ไม้	maiq
ซ้าย	saaiq
หฮยาม	Yaamj
เบี้ยวๆ	Byrub
อ้า	aab
เหมย	meij
ปู๊	puq
ล่ง	lovb
โขว	Kruj
ก๊า	kaaq
แฒะเฒี้ยว	zyruq
โบ๊ว	Bruq
เป๊ว	peuq
ท้อง	Txvq
ฌิบ	Fipq
ฮนอยๆ	Nxib
เหฒียม	zyemj
ฑั่ง	Ravb
มฌ่อม	mFxmb
ซ่าะ	saab
เป้ย	peib
เนีย	nia
อา​ดัม	aaDam
ฮา​วา	haawaa
คา​อิน	Kaain
กะน้ายหฒวัง	kanaaib
อา​แบน	aaBcn
ทอย	Txi
ธา	Zaa
นีอา	nyaa
หมอง	mxvj
นะ	naq
โฌ่ว	Frub
หฮวา	Waaj
เอ​เดน	tov
โน้ด	notq
เอ​โน้ก	enokq
อิ​ล้าด	ilaatq
เม​หู​ยา​เอน	mehujyaaen
เม​ทู​ซา​เอน	meTusaaen
ลา​เม้ก	laamekq
อา​ดา	aaDaa
สิน​ลา	sinjlaa
เซียง	syav
ตี๊	tiq
ฒวั้ง	zwavq
เอ​โน้ด	enotq
เค​นัน	Kenan
มา​หะ​ลา​เลน	maahaalaalen
ยา​เล้ด	yaaletq
เม​ทู​เส​ลา	meTusejlaa
โน​ยา	noyaa
ยา​เฟ้ด	yaafetq
อา	aa
ฮ้าบ	haapq
โฆ	Go
ฮาม	haam
คา​นา​อัน	Kaanaaan
โก​เม	kome
มา​โกก	maakokg
มา​ได	maaDai
ยา​วาน	yaawaan
ทู​บัน	TuBan
เม​เซ้ก	mesekq
ทิ​ล้าด	Tilaatq
อัด​เค​นัด	atgKenatq
ลี​ฟ้าด	lifaatq
โท​กาน​มา	Tokaanmaa
เอ​ลี​เซ​อา	eliseaa
ทาน​ซิด	Taansitq
คิด​ทิม	KitqTim
โล​ดา​นิม	loDaanim
อี​ยิบ	iyipq
พู้ด	Putq
เส​บา	sejBaa
ฮา​วิ​ลา	haawilaa
สับ​ทา	sapgTaa
ลา​อา​มา	laaaamaa
สับ​เท​คา	sapgTeKaa
เช​บา	QeBaa
เด​ดาน	DeDaan
นิม​โล้ด	nimlotq
ต๊าม	taamq
เล​เสน	lesenj
นิ​นะ​เว	ninaawe
คา​ลา	Kaalaa
ลู​ดิม	luDim
อา​นา​มิม	aanaamim
เล​หะ​บิม	lehaaBim
นับ​ทู​ฮิม	napqTuhim
ฮี​ไว	hiwai
อาน​คา	aanKaa
สี​นี	sijni
เอ​ลาม	elaam
อัด​ซู	atgsu
อาน​ฟา​ซัด	aanfaasatq
ลู​เด	luDe
อา​ลัม	aalam
อูด	utg
ฮูน	hun
เก​เท	keTe
มัด	matq
เช​ลา	Qelaa
เอ​เบ	eBe
โย้ก​ทาน	yokqTaan
อัน​โม​ดัด	anmoDatg
เช​เล้บ	Qelepq
ฮา​ซาน​มา​เว้ด	haasaanmaawetq
เย​ลา	yelaa
ฮา​โด​ลัม	haaDolam
อุ​ซาน	usaan
ดิก​ลา	Dikglaa
โอ​บาน	oBaan
อา​บี​มา​เอน	aaBimaaen
โอ​ฟี	ofi
โย​บับ	yoBapg
ฟั่น	fanb
บา​เบน	BaaBen
เป​เล้ก	pelekq
เล​อู	leu
เส​ลุก	sejlukq
นา​โฮ	naaho
เท​ลา	Telaa
อับ​ลาม	apglaam
ฮา​ลาน	haalaan
ซา​ลาย	saalaai
มิน​คา	minKaa
อิด​คา	itgKaa
เน​เกบ	nekepg
ฟา​โล	faalo
เบด​เอน	Betgen
โส​โดม	sojDom
เบย​ลา	Beilaa
โก​โม​ลา	komolaa
บิน​ซา	Binsaa
อัด​มา	atgmaa
ซี​น้าบ	sinaapq
เส​โบ​ยิม	sejBoyim
เซ​เม​เบ	semeBe
เบ​ลา	Belaa
น้าย	naaiq
โส​อา	sojaa
ฒี่ง	zivb
เอน​มิด​ฟัด	enmitqfatq
คา​เดด	KaaDetg
ฮา​ซา​โซน	haasaason
ทา​มา	Taamaa
อา​มา​เล้ก	aamaalekq
อา​โม​ไล	aamolai
สิด​ดิม	sitgDim
โญ่ว	Erub
โฮ​บา	hoBaa
ดา​มัด​กัด	Daamatqkatg
เค​โด​ลา​โอ​เม	KeDolaaome
ซา​เว	saawe
แอ๋ง	cvj
อา​เน	aane
เอด​โค	etgKo
มัม​เล	mamle
ท้องป้าย	paaib
เอ​ลี​เย​เซ	eliyese
อับ​ลา​ฮัม	apglaaham
ก๊บ	kopq
ญ่วน	Ewrnb
ฮิด​ไท	hitqTai
เป​ลิด​ซี	pelitqsi
เล​ฟา​อิม	lefaaim
ฮา​กา	haakaa
อิ​สะ​มา​เอน	isaamaaen
ซา​ลา	saalaa
นี	ni
หฒ่าม	zaamg
ขะเดา	KaDau
โล้	loq
เหฒี่ยว	zyrug
ฟ้ง	fovq
หฑาด	Raatg
ปาน	paan
เก​ลา​อา	kelaaaa
อา​บี​เม​เล้ก	aaBimelekq
อี​สัก	isakg
โห่ว	hrug
ฑิด	Ritq
เบ​เอ​เช​บา	BeeQeBaa
ล่ม	lomb
ฮญา	Haa
โดะ	Dog
เค​เสด	Kesetg
ฮา​โซ	haaso
ปิน​ดาด	pinDaatg
ยิด​ล้าบ	yitqlaapq
เบ​ทู​เอน	BeTuen
เล​เบ​คา	leBeKaa
คี​ลิ​ย้าด​อาน​บา	KiliyaatqaanBaa
เฮ​โบ​โลน	heBolon
เกะ	keg
โส​หา	sojhaaj
เอ​โฟ​โลน	efolon
ฒ่าง	zaavb
โค	Ko
โล	lo
อง	ov
กู๋	kuj
ลา​บาน	laaBaan
คั้ง	Kavq
ฮบ	hopq
ฒ้อ	zxq
เค​ทู​ลา	KeTulaa
โย้ก​ซาน	yokqsaan
อัด​ซู​ลิม	atgsulim
เล​ทู​ซิม	leTusim
เล​อุม​มิม	leummim
มิด​มา	mitqmaa
ดู​มา	Dumaa
มัด​ซา	matqsaa
ฮา​ดัด	haaDatg
เท​มา	Temaa
เย​ทู	yeTu
นา​ฟิด	naafitq
เค​เด​มา	KeDemaa
ปัด​ดาน​อา​ลัม	patgDaanaalam
เอ​ซาว	esaau
ยา​โค้บ	yaaKopq
ตบ	topg
ฟี​ลิ​สะ​เตีย	filisaatia
เบ​เอ​ลี	Beeli
ยู​ดิด	yuDitg
เอ​โลน	elon
บา​เส​มัด	Baasejmatq
ลาย	laai
อะจัง	aJav
ฮลัว	Lua
ตา	taa
ฑ์ม	Romd
ลา​เซน	laasen
เสียง	syavj
เน์า	naud
เปี๊ยด	pyetq
ลา​บาน	laaBaan
เผียน	Pyenj
บิน​ฮา	Binhaa
เล​อา	leaa
เล​วี	lewi
นับ​ทา​ลี	napqTaali
สิน​ปา	sinjpaa
วิด	witq
ซาว	saau
ดู​ดา​อิม	DuDaaim
เจี้ย	Jiab
ดี​นา	Dinaa
ต๊าบ	taapq
เตี๊ยม	tyemq
เผียว	Pyruj
กว๊าย	kwaaiq
พุย	Pwi
พยัด	Pyatq
อิ​สะ​ลา​เอน	isaalaaen
โย​เซ้บ	yosepq
เส​อี	seji
ฮา​โม	haamo
เซ​เคม	seKem
สิ​เม​โอน	simeon
ปุ๋ย	pwij
เญ่ย	Eeib
เอ​ฟา​ลา​ทา	efaalaaTaa
เบน​ยา​มิน	Benyaamin
อา​เซ	aase
เซ	se
เอ​ลี​ฟัด	elifatq
เล​อู​เอน	leuen
เท​มาน	Temaan
โอ​มา	omaa
เส​โฟ	sejfo
นา​หัด	naahatg
เฒ​ลา	zelaa
อา​นา	aanaa
เย​อูด	yeutg
ยา​ลาม	yaalaam
โค​ลา	Kolaa
โอ​โฮ​ลี​บา​มา	oholiBaamaa
ต้ง	tovb
เอ​โดม	eDom
โฮ​ลี	holi
โฮ​มัม	homam
โล​ทาน	loTaan
ทิม​นา	Timnaa
โซ​บาน	soBaan
มา​นา​ฮ้าด	maanaahaatq
เอ​บาน	eBaan
เช​โฟ	Qefo
โอ​นัม	onam
ดี​โซน	Dison
เฮม​ดาน	hemDaan
เอด​บาน	etgBaan
อิด​ลาน	itglaan
เค​ลาน	Kelaan
เอ​เซ	ese
อา​ขาน	aaKaanj
ดี​ซาน	Disaan
อา​ลัน	aalan
สิ​เบ​โอน	siBeon
เอ​โดม	eDom
ดิน​ฮา​บา	DinhaaBaa
โบ​ซา​ลา	Bosaalaa
หุ​ซาม	husaam
เบ​ดัด	BeDatg
โม​อับ	moapg
มี​เดียน	miDyen
อา​วี้ด	aawitq
สัม​ลา	samjlaa
เล​โห​โบด	lehojBotg
ซา​อุน	saaun
อัก​โบ	akgBo
บา​อัน​ฮา​นัน	Baaanhaanan
ปา​อู	paau
มัด​เล้ด	matqletq
เม​ซา​หับ	mesaahapg
อัน​วา	anwaa
เย​เท้ด	yeTetq
เอ​ลา	elaa
ปี​โนน	pinon
เค​นัด	Kenatq
มิบ​ซา	mipqsaa
โด​ทาน	DoTaan
ลู​เบน	luBen
ยู​ดา	yuDaa
ชู​อา	Quaa
เอ​อา	eaa
โอ​นัน	onan
เค​ซี้บ	Kesipq
ฮิบ​ลู	hipqlu
เจย	Jei
ไน​อา	naiaa
คอง	Kxv
อะหมั่ง	amavg
ต๊อ	txq
เหญา	Eauj
แล่	lcb
ซีง	siv
ฟี้ง	fivq
ฮา​โน้ก	haanokq
ปัน​ลู	panlu
เฮ้ด​โลน	hetqlon
คาน​มี	Kaanmi
เย​มู​เอน	yemuen
ยา​มีน	yaamin
โอ​หาด	ohaatg
ยา​คีน	yaaKin
เก​โซน	keson
โค​ฮ้าด	Kohaatq
เม​ลา​ลี	melaali
อิด​สา​คา	itgsaajKaa
โท​ลา	Tolaa
ปู​วา	puwaa
อิ​โอบ	iopg
ซิม​โลน	simlon
เส​บู​ลุน	sejBulun
เส​เล้ด	sejletq
ยา​เล​เอน	yaaleen
ฮัก​กี	hakqki
ซู​นี	suni
เอด​โบน	etgBon
เอ​เล​อี	elei
อา​โล​ดี	aaloDi
อา​เล​ลี	aaleli
อิม​นา	imnaa
อิด​วา	itgwaa
อิด​วี	itgwi
เบ​ลี​ยา	Beliyaa
เซ​ลา​อา	selaaaa
เฮ​เบ	heBe
เบ​เค	BeKe
อัด​เบน	atgBen
เก​ลา	kelaa
นา​อา​มาน	naaaamaan
เอ​ไฮ	ehai
โล​อัด	loatg
มับ​ปิม	mapqpim
อาด	aatg
หุ​ซิม	husim
ยา​ซี​เอน	yaasien
กุ​นี	kuni
เย​เซ	yese
ซิน​เลม	sinlem
โก​เซน	kosen
ญิม	Eim
มะ​นัด​เส	maanatqsej
เอ​ฟา​อิม	efaaim
วาน	waan
ญ่า	Eaab
เธย	Zei
จอ​แดน	JxDcn
อา​ท้าด	aaTaatq
มา​คี	maaKi
เบี์ยน	Byend
อะหฑย่าว	aRyaaug
โม​เซ	mose
สิบ​โป​ลา	kxvq
อา​โลน	aalon
เฒียง	zyav
เหลว่ย	lweig
ลิบ​นี	lipqni
ซิ​เม​อี	simei
มา​ลี	maali
มู​ซี	musi
อิด​ฮา	itghaa
เน​เฟ้ก	nefekq
สิก​ลี	sikgli
อุด​ซี​เอน	utgsien
มิ​ซา​เอน	misaaen
เอน​ซา​ฟาน	ensaafaan
สิด​ลี	sitgli
นา​โซน	naason
เอ​ลี​เช​บา	eliQeBaa
นา​ดับ	naaDapg
อิ​ทา​มา	iTaamaa
อัด​สี	atgsij
เอน​คา​นา	enKaanaa
อา​บี​ยา​สาบ	aaBiyaasaapg
เอ​เล​อา​ซา	eleaasaa
ปู​ทิ​เอน	puTien
ฟี​เน​หัด	finehatg
ย่าม	yaamb
ฒิ	ziq
ไหธ	Zaij
เปย๊าเฮลน	Len
ฟ้าน	faanq
ฟยาว	fyaau
ปย้อม	pyxmb
คั่ง	Kavb
ววน	wrn
โต์วเหฑ่า	Raug
เปาะ	pxg
ตุ้ย	twib
บา​ลี	Baali
เปา	pau
มับ	mapq
เฒี้ยว	zyruq
ด๊าม	Daamq
โหฒ่ว	zrug
หุ​โสบ	husopg
ลา​มา​เสด	laamaasetg
สุก​โค้ด	sukgKotq
ธี่	Zib
อา​บีบ	aaBipg
เหฒียด	zyetg
มิ​เลียม	milyem
เอ้าะ	xb
เมาะ	mxq
เล​ฟี​ดิม	lefiDim
หญุย	Ewij
ฮู​อา	huaa
โย​ซู​วา	yosuwaa
หฒุด	zutg
เย​โท	yeTo
จ๊าง	Jaavq
บะหลี่ง	Balivg
ซี​นาย	sinaai
บง	Bovb
บงเหฆน	Genj
ฮั่น	hanb
ลู์ง	luvd
ปุ้ย	pwib
เหล่ย	leig
แหว่ง	wcvg
อา​บี​ฮู	aaBihu
ควีง	Kwiv
เค​ลู​บิม	KeluBim
แว่ง	wcvb
ลุ่น	lunb
เน้ก	nekq
โคว	Kru
หว่วน	wrng
เอ​โฟ้ด	efotq
ผาน	Paanj
บิ์น	Bind
เจียมป้าย	Jyemb
ดี้ง	Divb
ดามตอง	txv
โหว	hruj
หฆัน	Ganj
ฌั้วเปียะ	piag
ฮยวัง	Ywav
กีง	kiv
ฟามปวน	faamb
เผว	Peuj
อุ​ลี	uli
เบ​ซา​เลน	Besaalen
ฮยุน	Yun
บ๊วน	Bwrnq
ซ้อด	sxtq
เซียวเซ้ด	setq
เย​บุด	yeButg
แอ๊ง	cvq
อา​หิ​สะ​มัก	aahisaamakq
โอ​โฮ​ลี​อับ	oholiapg
กู้ง	kuvb
กั่ง	kavg
ฮลางบั๊ว	Laavb
ญัด	Kwiv
ขัง	Kavj
แธะจ้าง	Jaavb
ธาน	Zaan
เกาะ	kxg
เควย	Kwei
จุ๋ย	Jwij
โช้ว	Qruq
แธง	Zcv
น้าด	naatq
ฒิน	zin
อุ​ลิม	ulim
ทุม​มิม	Tummim
ปั๊วะ	puaq
บย้า	Byaab
น์าว	naaud
ท่าน	Taanb
อ๋ม	omj
เซี้ยด	syetq
ก่อง	kxvg
ปั์วฒ้าง	puab
แมง	mcv
เลี้ยง	lyavq
กว้าย	kwaaib
ล์าว	laaud
โม​เล้ก	molekq
ดูง	Duv
เซี่ยว	syrub
เฑี้ยบ	Ryepq
ฮลาว	Laau
ติ้วๆ	tiub
ญั้น	Eanq
เซ​โล​มิด	selomitq
ดิบ​ลี	Dipgli
ป๊วนฝีง	fivj
บัง	Bav
เซ​เด​เอ	seDee
เอ​ลี​ซู	elisu
สู​ลิ​ซัด​ได	sujlisatqDai
เซ​ลู​มิ​เอน	selumien
อัม​มี​นา​ดับ	amminaaDapg
ฒู​อา	zuaa
เน​ทัน​เอน	neTanen
เฮ​โลน	helon
เอ​ลี​อับ	eliapg
อัม​มี​ฮู้ด	ammihutq
เอ​ลี​ซา​มา	elisaamaa
เป​ดา​ซู	peDaasu
กา​มา​ลิ​เอน	kaamaalien
กิ​เด​โอ​นี	kiDeoni
อา​บี​ดัน	aaBiDan
อัม​มี​ชัด​ได	ammiQatqDai
อา​หิ​เย​เซ	aahiyese
โอ​คาน	oKaan
ปา​กี​เอน	paakien
เด​อู​เอน	Deuen
เอ​ลี​ยา​สาบ	eliyaasaapg
เอ​นัน	enan
อา​หิ​ลา	aahilaa
อัม​ลาม	amlaam
เอ​ลี​ซา​ฟาน	elisaafaan
บอง	Bxv
นา​สี	naasij
บัว’	meib
ทา​เบ​ลา	TaaBelaa
มา​นา	maanaa
เหมวย	mweij
เฒ้บ	zepq
ขิบ​โล้ด​หัด​ตา​อา​วา	Kipglotqhatgtaaaawaa
ฮา​เซ​โล้ด	haaselotq
สัก​เก	sakgke
ซัม​มุ​วา	sammuwaa
ซา​ฟัด	saafatq
เย​ฟุน​เน	yefunne
คา​เล้บ	Kaalepq
อิ​กาน	ikaan
โฮ​เซ​ยา	hoseyaa
ลา​ฟู	laafu
ปัน​ที	panTi
โส​ดี	sojDi
กัด​เดียน	katgDyen
สุ​สี	susij
กัด​ดี	katgDi
เก​มัน​ลี	kemanli
อัม​มี​เอน	ammien
มี​คา​เอน	miKaaen
เส​ทู	sejTu
โว้บ​สี	wopqsij
นา​บี	naaBi
เก​อู​เอน	keuen
หย่าว	yaaug
เห่	heg
เฑีย	Ria
หฒิด	zitg
โฮ​มา	homaa
ต๋อยเตก	tekg
ดา​ทาน	DaaTaan
อา​บี​ลัม	aaBilam
เซียงสี่	syavb
เยี่ยม	yemb
โล่ะ	lob
เซียงอะหงุ่น	avung
เญว่ย	Eweib
ฒ่อง	zxvb
เม​ลี​บา	meliBaa
คา​เดด	KaaDetg
โฮ​อา	hoaa
อา​ล้าด	aalaatq
อา​ทา​ลิม	aaTaalim
นางโตะ	tog
เฒ​เล้ด	zeletq
มัด​ทา​นา	matqTaanaa
นา​หะ​ลี​เอน	naahaalien
บา​โม้ด	Baamotq
สิ​โหน	sihonj
เฮ้ด​โบน	hetqBon
เค​โม้ด	Kemotq
เบี่ย	Biag
ไหฮล	Laij
สิบ​โป	sipgpo
บา​ล้าก	Baalaakq
บา​ลา​อัม	Baalaaam
หล่าย	laaig
คี​ลิ​ย้าด​หุ​โซ้ด	Kiliyaatqhusotq
บา​อัน	Baaan
เหฒง	zevj
เบ​โอ	Beo
เค​ไน	Kenai
ซิด​ทิม	sitqTim
เป​โอ	peo
สิม​ลี	simjli
สา​ลู	saajlu
โค้ด​บี	KotqBi
สู​อา	sujaa
โอด​นี	otgni
อา​โล้ด	aalotq
ยา​ซู้บ	yaasupq
อัด​ลี​เอน	atglien
เซ​มิ​ดา	semiDaa
เฮ​เฟ	hefe
เฮ​เฟ	hefe
เส​โล​เฟ​หัด	sejlofehatg
มา​ฮา​ลา	maahaalaa
โฮ้ก​ลา	hokqlaa
ที​ละ​ซา	Tilaasaa
เซ​ฟู​ฟาม	sefufaam
หุ​ฟาม	hufaam
ซู​ฮัม	suham
อา​เซ	aase
กิ​เล​อาด	kileaatg
มา​คี​เล	maaKile
อา​บา​ลิม	aaBaalim
เอ​วี	ewi
เล​เคม	leKem
เล​บา	leBaa
เถี่ย	Tiag
จู์ง	Juvd
เตง	tev
ตอนหละเก๊า	txnb
เอ​ทาม	eTaam
ปี​หะ​หิ​โล้ด	pihaahilotq
บา​อัน​เซ​โฟน	Baaansefon
มิก​โดน	mikqDon
โด​ฟะ​คา	DofaaKaa
อา​ลู้ด	aalutq
ลิด​มา	litqmaa
ลิม​โมน​เป​เล้ด	limmonpeletq
ลิบ​นา	lipqnaa
ลิด​สา	litqsaaj
เค​เฮ​ลา​ทา	KehelaaTaa
เซ​เฟ	sefe
ฮา​ลา​ดา	haalaaDaa
มัก​เฮ​โล้ด	makqhelotq
ทา​หัด	Taahatg
มิด​คา	mitqKaa
ฮัด​โม​นา	hatqmonaa
โม​เส​โล้ด	mosejlotq
เบ​เน​ยา​อะ​คัน	BeneyaaaaKan
โฮ​ฮัก​กีด​กาด	hohakqkitgkaatg
โย้ด​บา​ทา	yotqBaaTaa
อับ​โล​นา	apglonaa
เอ​ซี​โอน​เก​เบ	esionkeBe
สัน​โม​นา	sanjmonaa
ปู​โนน	punon
โอ​โบด	oBotg
อี​เย​อา​บา​ลิม	iyeaaBaalim
ดี​โบน​กาด	DiBonkaatg
อัน​โมน​ดิบ​ลา​ทา​อิม	anmonDipglaaTaaim
เน​โบ	neBo
อัด​โมน	atgmon
เม​ดิ​เต​เล​เนียน	meDitelenyen
ฮา​มัด	haamatq
เส​ดัด	sejDatg
เซ​มู​เอน	semuen
ชิด​โลน	Qitqlon
เอ​ลี​ดาด	eliDaatg
โย้ก​ลี	yokqli
บุก​คี	BukgKi
ฮัน​นี​เอน	hannien
ซิบ​ทาน	sipqTaan
เค​มู​เอน	Kemuen
ปา​น้าก	paanaakq
อัด​ซาน	atgsaan
ปัน​ที​เอน	panTien
เซ​โล​มี	selomi
อา​หิ​ฮู้ด	aahihutq
เป​ดา​เฮน	peDaahen
เอ​เดน​อี	eDeni
อัด​ทา​โล้ด	atgTaalotq
บา​ซาน	Baasaan
โฮ​เล้บ	holepq
ฒิ่น	zinb
เอ​มิม	emim
อา​น้าก	aanaakq
คา​เดด​บา​เนีย	KaaDetgBaania
ยา​ฮ้าด	yaahaatq
อาน​โกบ	aankopg
ซอน	sxn
เฮ​โมน	hemon
ไซ​ดอน	saiDxn
สี​ลี​ออน	sijlixn
เส​นี	sejni
โมว	mru
เป๊น	penq
อา​ลา​บา	aalaaBaa
ปิด​กา	pitgkaa
จั๊วะ	Juaq
เจี้ยน	Jyenb
แฆะ	Gcq
หมะ	mag
เดี๋ยงฟาง	faav
กุด​โก​ดา	kutgkoDaa
จั๊ม	Jamq
ธ้าย	Zaaiq
มล่ม	mlomb
มิว	miu
ลง	lov
เหว่ย	weig
เฮม้ย	Meiq
ขูงปั์ว	puad
เปย	pei
ธิม	Zim
เจี๋ยม	Jyemj
ฟิน	fin
อัม​โมน	ammon
ไง่	vaib
หลิ่น	ling
โตว	tru
แป๋ง	pcvj
เอ๊า	auq
ทุด	Tutq
เก​ลิ​ซิม	kelisim
ถง	Tovj
อา​เมน	aamen
ปัวะ	puag
ฆ้าด	Gaatq
ยัง	yav
ลา​หับ	laahapg
กิน​กาน	kinkaan
โต์วเลา	lau
เย​ลี​โค	yeliKo
เช​บา​ลิม	QeBaalim
สับ​ดี	sapgDi
อา​คาน	aaKaan
ดั๊บ	Dapq
กิ​เบ​โอน	kiBeon
เค​ฟี​ลา	Kefilaa
เบ​เอ​โล้ด	Beelotq
คี​ลิ​ย้าด​เย​อา​ลิม	Kiliyaatqyeaalim
เย​ลู​ซา​เลม	yelusaalem
อา​โด​นี​เซ​เดก	aaDoniseDekg
โฮ​ฮัม	hoham
ยาน​มู้ด	yaanmutq
ปี​ลาม	pilaam
ลา​คี้ด	laaKitq
ยา​เฟีย	yaafia
เอก​โลน	ekglon
เด​บี	DeBi
เบด​โฮ​โลน	Betgholon
อา​เซ​คา	aaseKaa
มัก​เค​ดา	makqKeDaa
ไอ​ยา​โลน	aiyaalon
เก​เซ	kese
โฮ​ลาม	holaam
ยา​บิน	yaaBin
มา​โดน	maaDon
อัก​ซ้าบ	akgsaapq
เม​โลม	melom
ววม	uamb
มิด​เล​โฟ้ด​มา​อิม	mitqlefotqmaaim
มิด​ปา	mitqpaa
เท้า	Tauq
นิด	nitq
เก​เด	keDe
อา​ดุน​ลัม	aaDunlam
ทับ​ปู​วา	Tapqpuwaa
อา​เฟ้ก	aafekq
ลา​ซา​โลน	laasaalon
ซิม​โลน​เม​โลน	simlonmelon
ทา​อา​น้าก	Taaaanaakq
เม​กิด​โด	mekitgDo
เค​เดด	KeDetg
คาน​เมน	Kaanmen
โย้ก​เน​อัม	yokqneam
นา​โฟ้ด​โด​อา	naafotqDoaa
โด​อา	Doaa
กา​ลิ​ลีเญย	kaaliliEei
โก​ยิม	koyim
เก​ซู	kesu
มา​อา​คา	maaaaKaa
สา​เล​คา	saajleKaa
เค​เด​โม้ด	KeDemotq
เม​ฟา​อาด	mefaaaatg
เบด​เป​โอ	Betgpeo
เบด​เย​ซิ​โม้ด	Betgyesimotq
บา​อา​ลา	Baaaalaa
เย​ลา​ลิม	yelaalim
เค​สะ​โลน	Kesaalon
เบด​เซ​เม้ด	Betgsemetq
ทิม​นา​ฮา	Timnaahaa
คี​ลิ​ย้าด​เส​เฟ	Kiliyaatqsejfe
อัก​สา	akgsaaj
โอด​นี​เอน	otgnien
ต์าน	taand
คี​นา	Kinaa
ดี​โม​นา	Dimonaa
อา​ดา​ดา	aaDaaDaa
อิด​นาน	itgnaan
สิบ​อา	sipgaa
เท​เลม	Telem
เบ​อา​โล้ด	Beaalotq
ฮา​โซ​ฮา​ดัด​ทา	haasohaaDatgTaa
เค​ลิ​โอด​เฮ้ด​โลน	Keliotghetqlon
อา​มัม	aamam
เซ​มา	semaa
โม​ลา​ดา	molaaDaa
ฮา​ซาน​กัด​ดา	haasaankatgDaa
เฮ้ด​โมน	hetqmon
เบด​เป​เล้ด	Betgpeletq
ฮา​ซาน​ซู​อาน	haasaansuaan
บิ​ซิ​โอ​ทิ​ยา	BisioTiyaa
อิ​ยิม	iyim
เอ​เซม	esem
เอน​โท​ลัด	enTolatq
เค​สิน	Kesinj
โฮน​มา	honmaa
สิก​ล้าก	sikglaakq
มัด​มัน​นา	matqmannaa
สัน​สัน​นา	sanjsanjnaa
สา​โน​อา	saajnoaa
เอน​กัน​นิม	enkannim
เอ​นาม	enaam
โส​โค	sojKo
เส​นัน	sejnan
ฮา​ดา​ชา	haaDaaqaa
มิก​ดัน​กาด	mikqDankaatg
ดิ​เล​อัน	Dilean
โย้ด​เท​เอน	yotqTeen
โบด​ค้าด	BotgKaatq
คับ​โบน	KapqBon
ลา​มัม	laamam
คิด​ลิด	Kitqlitq
เอ​เท	eTe
อา​ชัน	aaQan
อิบ​ทา	ipgTaa
อัด​นา	atgnaa
เน​ซี้บ	nesipq
ดาน​นา	Daannaa
คี​ลิ​ย้าด​สัน​นา	Kiliyaatqsanjnaa
อา​น้าบ	aanaapq
เอด​เท​โม​อา	etgTemoaa
อา​นิม	aanim
อา​หลับ	aalapg
เอ​ซาน	esaan
ยา​นิม	yaanim
เบด​ทับ​ปู​วา	BetgTapqpuwaa
อา​เฟ​คา	aafeKaa
มา​โอน	maaon
ยุด​ทา	yutqTaa
ยิด​เล​เอน	yitqleen
โย้ก​เด​อัม	yokqDeam
ฮัน​ฮูน	hanhun
เบด​สู​อา	Betgsujaa
เก​โด	keDo
ยา​โน​อา	yaanoaa
อา​ทา​โล้ด	aaTaalotq
นา​อา​ลา	naaaalaa
ซี​โล	silo
เบด​โฮ้ก​ลา	Betghokqlaa
เอ​เม้ก​เค​ซี้ด	emekqKesitq
เบด​อา​ลา​บา	BetgaalaaBaa
เส​มา​ลา​อิม	sejmaalaaim
อับ​วิม	apgwim
ปา​ลา	paalaa
โอ​ฟา​ลา	ofaalaa
ลา​มา	laamaa
โม​ซา	mosaa
อิน​เป​เอน	inpeen
ทา​ละ​ลา	Taalaalaa
เช​บา	QeBaa
บา​ลา	Baalaa
เบด​มาน​คา​โบด	BetgmaanKaaBotg
ฮา​ซาน​สู​สา	haasaansujsaaj
ฮา​ฟา​ลา​อิม	haafaalaaim
ซี​โยน	siyon
อา​นา​หะ​ล้าด	aanaahaalaatq
ลับ​บีด	lapqBitg
คี​ซิ​โอน	Kision
เอ​เบด	eBetg
เล​เม้ด	lemetq
เอน​หัด​ดา	enhatgDaa
เบด​ปัด​เซ้ด	Betgpatgsetq
เฒ​อา	zeaa
ฮัม​มัด	hammatq
ลัก​คัด	lakqKatq
คิน​เน​เล้ด	Kinneletq
อา​ดา​มา	aaDaamaa
เอน​ฮา​โซ	enhaaso
โส​ลา	sojlaa
เอด​ทา​โอน	etgTaaon
อิน​เซ​เม้ด	insemetq
ซา​อัน​บิน	saaanBin
อิด​ลา	itglaa
เอ​โค​โลน	eKolon
เอน​เท​เค	enTeKe
กิบ​เบ​โทน	kipgBeTon
บา​อา​ลัด	Baaaalatq
เย​ฮู้ด	yehutq
เบ​เน​เบ​ล้าก	BeneBelaakq
กัด​ลิม​โมน	katglimmon
เบ​เซ้ก	Besekq
อา​โด​นี​เบ​เซ้ก	aaDoniBesekq
เซ​ไซ	sesai
อา​หิ​มาน	aahimaan
ทัน​ไม	Tanmai
อัก​โค	akgKo
อัก​ล้าบ	akglaapq
อัก​ซี้บ	akgsipq
เฮน​บา	henBaa
เล​โหบ	lehopg
เอ​ฮู้ด	ehutq
เบี่ยน	Byeng
ฟ้อ	fxq
อา​น้าด	aanaatq
ซัม​กา	samkaa
ลับ​ปิ​โดด	lapqpiDotg
เด​โบ​ลา	DeBolaa
อา​บี​โน​อัม	aaBinoam
ทา​โบ	TaaBo
สิ​เส​ลา	sisejlaa
ติ่ม	timg
หญ่ม	Eomg
หธง	Zovj
กิ​เด​โอน	kiDeon
โย​อาด	yoaatg
ววมเฮลน	uamb
เบียด	Byetg
อา​บี​เย​เซ	aaBiyese
เฒ​บา	zeBaa
สัน​มุน​นา	sanjmunnaa
เป​นู​เอน	penuen
เฮ​เล้ด	heletq
เย​ลุบ​บา​อัน	yelupqBaaan
บา​อัน​เบ​ลี้ด	BaaanBelitq
เบด​มิน​โล	Betgminlo
กาม	kaam
โย​ทาม	yoTaam
เบ​เอ	Bee
เส​บุน	sejBun
กา​อัน	kaaan
คีง	Kiv
เฑ้า	Rauq
ฮ์า	haad
เท​เบด	TeBetg
ซา​มี	saami
จา​อี	Jaai
ฮาว​โว้ด​จา​อี	haauwotqJaai
คา​โมน	Kaamon
เย้บ​ทา	yepqTaa
อา​โล​เอ	aaloe
มิน​นิด	minnitq
อา​เบน​เค​ลา​มิม	aaBenKelaamim
สา​โฟน	saajfon
เบด​เล​เฮม	Betglehem
อิบ​ซาน	ipgsaan
ปิ​ลา​โทน	pilaaTon
ฮิน​เลน	hinlen
อับ​โดน	apgDon
มา​โน​อา	maanoaa
แซม​สัน	scmsanj
เล​ฮี	lehi
แกว๋ง	kwcvj
ลา​ม้าด​เล​ฮี	laamaatqlehi
กา​ซา	kaasaa
โส​เล้ก	sojlekq
เด​ลิ​ลา	Delilaa
ฆั้ม	Gamq
มี​คา	miKaa
มา​หะ​เน​ดาน	maahaaneDaan
ลา​อิด	laaitg
เบด​เล​โหบ	Betglehopg
กิ​เบ​อา	kiBeaa
วั้ว	uaq
บา​อัน​ทา​มา	BaaanTaamaa
ยา​เบด​กิ​เล​อาด	yaaBetgkileaatg
เล​โบ​นา	leBonaa
นา​โอ​มี	naaomi
เอ​ลี​เม​เล้ก	elimelekq
โอ​ฟา	ofaa
ลู​เท	luTe
มา​โลน	maalon
คิ​ลิ​โอน	Kilion
เซียงจา	Jaa
ญาม	Eaam
จั้ว	Juab
เฮนี้ยๆ	Niaq
มา​ลา	maalaa
โบ​อาด	Boaatg
อ๋ง	ovj
ธั้มๆ	Zamq
เฑียน	Ryen
ท้ง	Tovq
ลาม	laam
สัน​โมน	sanjmon
โอ​เบด	oBetg
เจียด​ซี	Jyetgsi
ดา​วิด	Daawitq
ป๊วนฒี่ง	Eei
เอ​ลี	eli
เป​นิน​นา	peninnaa
ฮัน​นา	hannaa
แซงยู์ง	yuvd
ฮวั้วเจ๋ย	Jeij
เอ๊ย	eiq
กะน่าน	kanaanb
หละฟับดุย	lafapg
ซา​มู​เอน	saamuen
อัด​โดด	atgDotg
โล์ต๋อง	txvj
อา​บี​นา​ดับ	aaBinaaDapg
ดั๊ม	Damq
เบด​คา	BetgKaa
เซา​โล	saulo
โฒ่ว	zrub
เจี๊ยน’	Jyenq’
เสน​ซา	senjsaa
กะน้ายดุย	Dwi
ฝุย	fwij
ยา​เบด	yaaBetg
นา​หาด	naahaatg
มิก​ม้าด	mikqmaatq
ซู​อัน	suan
โย​นา​ทาน	yonaaTaan
มิ​โกน	mikon
อา​หิ​ยา	aahiyaa
อับ​เน	apgne
เน	ne
อา​บี​เอน	aaBien
เท​ลา​อิม	Telaaim
ซู​วา	suwaa
อา​กัก	aakakg
ซินเพย	sinb
ซัม​มา	sammaa
เฮมียนฝัง	Myenb
โก​ลิ​อัด	koliatg
หนาม	naamj
ซา​อา​ลา​อิม	saaaalaaim
เซียะโฮล	siag
เม​ล้าบ	heug
มี​คาน	miKaan
นา​โย้ด	naayotq
อา​หิ​เม​เล้ก	aahimelekq
อา​คิด	aaKitq
โด​เอก	Doekg
อา​หิ​ทู้บ	aahiTupq
อา​บี​ยา​ทา	aaBiyaaTaa
เค​อี​ลา	Keilaa
เซ​ลา​ฮัม​มา​เล​โค้ด	selaahammaaleKotq
เอน​เก​ดี	enkeDi
นา​บาน	naaBaan
อา​บี​กา​ยิน	aaBikaayin
อา​หิ​โน​อัม	aahinoam
เส​ลุ​ยา	sejluyaa
โย​อาบ	yoaapg
อา​บี​ไช	aaBiQai
มา​โอก	maaokg
ซู​เนม	sunem
กิน​โบ​อา	kinBoaa
โป๋	poj
เอน​โด	enDo
เตียน	tyen
เบ​โส	Besoj
เค​เล​ที	KeleTi
เยียะ	yiaq
ลา​โม้ด	laamotq
ย้าด​ที	yaatqTi
สิบ​โม้ด	sipgmotq
ลา​คาน	laaKaan
เย​ลา​เม​เอน	yelaameen
โบ​ลา​ชาน	BolaaQaan
อา​ท้าก	aaTaakq
มัน​คี​ซู​วา	manKisuwaa
อ๊อบ	xpq
เบด​ซาน	Betgsaan
หมวน	mwrnj
เจี้ยม	Jyemb
ยา​ซา	yaasaa
อิด​โบ​เซ้ด	itgBosetq
มา​หะ​นา​อิม	maahaanaaim
ฌ่าง	Faavb
หละญ้าบ	laEaapq
เฮน​ขัด​ฮัด​ซู​ลิม	henKatghatqsulim
อา​สา​เฮน	aasaajhen
บิ๊ด​โลน	Bitqlon
อัม​โนน	amnon
อา​โด​นี​ยา	aaDoniyaa
ฮัก​กีด	hakqkitg
เซ​ฟา​ทิ​ยา	sefaaTiyaa
อา​บี​ทัน	aaBiTan
อิด​เล​อัม	itgleam
เอก​ลา	ekglaa
กิด​ทา​อิม	kitgTaaim
ลิม​โมน	limmon
เล​ค้าบ	leKaapq
บา​อา​นา	Baaaanaa
มิน​โล	minlo
โซ​บับ	soBapg
นา​ทัน	naaTan
ซา​โล​มอน	saalomxn
อิบ​ฮา	ipghaa
เอ​ลี​ซู​วา	elisuwaa
เอ​ลี​ยา​ดา	eliyaaDaa
เอ​ลี​เฟ​เล้ด	elifeletq
เก​บา	keBaa
อุด​ซา	utgsaa
เป​เล้ด​อุด​ซา	peletqutgsaa
หวี่ง	wivg
โอ​เบด​เอ​โดม	oBetgeDom
หลาม	laamj
ตอนจุ่น	Jung
สี​ดา	sijDaa
เญ้า	Eauq
โส​บา	sojBaa
ฮา​ดัด​เอ​เซ	haaDatgese
ยู​เฟ​ติด	yufetitg
ซี​เลีย	silia
เบ​ทา	BeTaa
เบ​โล​ไท	BeloTai
เย​โฮ​ยา​ดา	yehoyaaDaa
เบ​ไน​ยา	Benaiyaa
เพ​เล้ด	Peletq
ซิ​บา	siBaa
โล​เด​บา	loDeBaa
เม​ฟี​โบ​เซ้ด	mefiBosetq
ฮา​นูน	haanun
เอ​ลี​อัม	eliam
บัด​เช​บา	BatgQeBaa
อุ​ลี​อา	uliaa
เย​ลุบ​เบ​เซ้ด	yelupqBesetq
ลับ​บา	lapqBaa
อับ​ซา​โลม	apgsaalom
โย​นา​ดับ	yonaaDapg
บา​อัน​ฮา​โซ	Baaanhaaso
เท​โค​อา	TeKoaa
อิด​ไท	itgTai
สา​โดก	saajDokg
อา​หิ​มา​อัด	aahimaaatg
อา​หิ​โท​เฟน	aahiTofen
หุ​ไซ	husai
โซ​บี	soBi
โล​เก​ลิม	lokelim
บา​ซิน​ไล	Baasinlai
คิม​ฮาม	Kimhaam
อา​มา​สา	aamaasaaj
บีก​ลี	Bikgli
อิ​ละ	ilaa
ไอ​อา	aiaa
ลิด​ปา	litqpaa
อาน​โม​นี	aanmoni
เม​โห​ลา	mehojlaa
อาด​ลี​เอน	aatglien
ซี​เม​ฮา	simehaa
เหฑ่น	Reng
แหฆ่ง	Gcvg
เต้า	taub
อา​โห​ไฮ	aahojhai
โด​โด	DoDo
ฮา​ลา	haalaa
อา​เก	aake
เอน​ฮา​นัน	enhaanan
ฮา​โล้ด	haalotq
เอ​ลี​คา	eliKaa
เฮ​เล้ด​เท	heletqTe
อิก​เขด	ikgKetg
อา​นา​โท้ด	aanaaTotq
หุ​ซา	husaa
เม​บุน​ไน	meBunnai
เน​โท​ฟา	neTofaa
มา​หะ​ไล	maahaalai
ลี​ไบ	liBai
กา​อัด	kaaatg
ฮิด​ได	hitqDai
อา​บี​ยัน​โบน	aaBiyanBon
บา​ฮู​ลิม	Baahulim
อัด​มา​เว้ด	atgmaawetq
ซา​มา	saamaa
ชา​ลา	Qaalaa
อา​หิ​ยัม	aahiyam
อา​หัด​ไบ	aahatgBai
กิ​โลน	kilon
เฮ้ด​โล	hetqlo
อา​ล้าบ	aalaapq
ปา​ไล	paalai
บา​นี	Baani
เส​เล้ก	sejlekq
นา​หะ​ไล	naahaalai
อิด​ไล	itglai
กา​เล้บ	kaalepq
อุ​ลี​ยา	uliyaa
ยา​เซ	yaase
ตา​ทิม​โหด​ชี	taaTimhotgQi
ดัน​ยา​อัน	Danyaaan
อา​ลาว​นา	aalaaunaa
นิ่น	ninb
เหว่ย	weig
อา​บี​ช้าก	aaBiQaakq
อา​ซา​ลิ​ยา	aasaaliyaa
เบน​เด​เค	BenDeKe
มา​ค้าด	maaKaatq
ซา​อัน​บิม	saaanBim
เอ​โลน​เบด​ฮา​นัน	elonBetghaanan
เบน​เฮ​เสด	Benhesetg
อา​ลุบ​โบด	aalupqBotg
โส​โค	sojKo
เบน​อา​บี​นา​ดับ	BenaaBinaaDapg
ทา​ฟัด	Taafatq
อา​หิ​ลู้ด	aahilutq
สา​เล​ทาน	saajleTaan
อา​เบน​เม​โฮ​ลา	aaBenmeholaa
โย้ก​เม​อัม	yokqmeam
อิด​โด	itgDo
อา​หิ​นา​ดับ	aahinaaDapg
พา​ลู​อา	Paaluaa
เย​โฮ​ซา​ฟัด	yehosaafatq
ไจ	Jai
ฮี​ลาม	hilaam
เล​บา​นอน	leBaanxn
อา​โด​นี​ลัม	aaDonilam
ซิบ	se
หลอง	lxvj
เทย	Tei
เดี๋ยงเป๊น	penq
หะโล่ว	halrub
ตาว	taau
ล่อง	lxvb
ฑิบ	Ripq
ย่วน	ywrnb
บุน	Bun
ไท​ละ	Tailaq
ล์ง	lovd
เซ่ง	sevb
หฑ่อม	Rxmg
เยี้ยน	Rxmg
สิ​โอน	sion
เอ​ทา​นิม	eTaanim
สี่	sig
หนูง	nuvj
เล​โบ​ฮา​มัด	leBohaamatq
กา​ลิ​ลี	kaalili
คา​บุน	KaaBun
อี​ยิบ	iyipq
ทา​เป​เน้ด	Taapenetq
เก​นู​บัด	kenuBatg
เย​โล​โบ​อัม	yeloBoam
เล​โห​โบ​อัม	lehojBoam
โล์เฒี้ยว	zyruq
อา​บี​ยา	aaBiyaa
จาด่าง	Daavg
นา​อา​มา	naaaamaa
ซิ​ซัก	sisakq
เน​บัด	neBatg
อา​บี​ยัม	aaBiyam
อา​บี​ชา​โลม	aaBiQaalom
อา​สา	aasaaj
บา​อา​ชา	BaaaaQaa
ทับ​ลิม​โมน	Eei
เฮ​ซี​โอน	Eei
เบน​ฮา​ดัด	BenhaaDatg
โอม​ลี	omli
กี​นัด	kinatq
ทิบ​นี	Tipqni
สะ​มา​เลีย	saamaalia
อา​หับ	aahapg
อา​เซ​ลา	aaselaa
เค​ลี้ด​ทา	KelitqTaa
โด๊ะ	Dog
เอ​ลี​ยา	eliyaa
โอ​บา​ดี	oBaaDi
เย​เซ​เบน	yeseBen
คี​โซน	Kison
นิม​ซี	nimsi
เย​ฮู	yehu
เอ​ลี​ซา	elisaa
ฮา​ซา​เอน	haasaaen
นา​โบด	naaBotg
ไม้	maiq
ลา​โม้ด​กิ​เล​อาด	laamotqkileaatg
อิม​ลา	imlaa
มี​คา​ยา	miKaayaa
อา​หัด​ยา	aahatgyaa
ซิน​หิ	sinhi
อา​ซุ​บา	aasuBaa
บา​อัน​เซ​บูบ	BaaanseBupg
โย​ลัม	yolam
เย​โฮ​ลัม	yeholam
ไซเตี๋ย	saib
โอ๊	oq
เก​หะ​ซี	kehaasi
แต	tc
ต่น	tong
ธิ้ว	Ziuq
เต่ย	teib
โย​ลัม	yolam
ไฟ	fai
ซี่	sib
อา​หับ	aahapg
บย๊าบ	Byaapq
เบด​เอ​เขด	BetgeKetg
เย​โฮ​นา​ดับ	yehonaaDapg
อาน​โนน	aannon
เย​โฮ​อา​หาด	yehoaahaatg
อา​ทา​ลิ​ยา	aaTaaliyaa
คา​ลี	Kaali
ล่วน	lwrnb
สู​เอ	suje
ไบ๋	Baij
สิ​บี​ยา	siBiyaa
ฌับ	tavb
ฌิ้ว	Fiuq
เย​โฮ​อาด	yehoaatg
อา​มา​ซิ​ยา	aamaasiyaa
ดาว	Daau
เอ​ลัด	elatq
เส​คา​ลิ​ยา	sejKaaliyaa
ซัน​ลูม	sanlum
อุด​ซี​ยา	utgsiyaa
กา​ดี	kaaDi
เม​นา​เฮม	menaahem
อัด​ซี​เลีย	atgsilia
ปู​ลา	pulaa
เป​คา​หิ​ยา	peKaahiyaa
เล​มา​ลิ​ยา	lemaaliyaa
เป​คา	peKaa
ทิก​ลัด​ปิ​เล​เส	Tikqlatqpilesej
อิ​โยน	iyon
อา​เบน​เบด​มา​อะ​คา	aaBenBetgmaaaaKaa
อา​หัด	aahatg
เล​ซิน	lesin
คี​อา	Kiaa
ฮา​ลา​อา	haalaaaa
ฮา​โบ	haaBo
โก​ซาน	kosaan
มี​เดีย	miDia
บา​บี​โลน	BaaBilon
สุก​โค้ด​เบ​โน้ด	sukgKotqBenotq
คู​ทา	KuTaa
เน​กัน	nekan
อา​ซิ​มา	aasimaa
อับ​วา	apgwaa
นิบ​หัด	nipqhatg
ทาน​ทัก	TaanTakq
เส​ฟาน​วา​อิม	sejfaanwaaim
อัด​ลัม​เม​เล้ก	atglammelekq
อา​นัม​เม​เล้ก	aanammelekq
เฮ​เซ​คี​ยา	heseKiyaa
แซน​มา​เน​เส	scnmaanesej
เซน​นา​เค​ลิบ	sennaaKelipq
อิ​สะ​ยา	isaayaa
อาน​ปัด	aanpatg
เฮ​นา	henaa
อิบ​วา	ipgwaa
อ๊บ	opq
บา​ลา​ดัน	BaalaaDan
เม​โล​ดัก​บา​ลา​ดัน	meloDakgBaalaaDan
เฮ้บ​ซี​บา	hepqsiBaa
หฆีง	Givj
อา​โมน	aamon
โย​สิ​ยา	yosiyaa
เย​ดี​ดา	yeDiDaa
อา​ดา​ยา	aaDaayaa
เม​ซุน​ลาม	mesunlaam
อา​ซา​ไล​ยา	aasaalaiyaa
ซา​ฟาน	saafaan
ฮิน​คี​ยา	hinKiyaa
อา​หิ​คัม	aahiKam
อา​สา​ยา	aasaajyaa
ฮุน​ดา	hunDaa
ฮาน​ฮัด	haanhatq
ที้ก​วา	Tikqwaa
ขิด​โลน	Kitglon
ป๊วนซิน	sin
โท​เฟ้ด	Tofetq
เบน​ฮิน​โนม	Benhinnom
ฟา​โล​เน​โค	faaloneKo
ฮา​มุ​ทาน	haamuTaan
เย​เล​มี	yelemi
ลิบ​ลา	lipqlaa
เย​โฮ​ยา​คิม	yehoyaaKim
เส​บิ​ดา	sejBiDaa
ลู​มา	lumaa
เป​ดา​ยา	peDaayaa
เย​โฮ​ยา​คีน	yehoyaaKin
เน​หุด​ทา	nehutgTaa
เอน​นา​ทัน	ennaaTan
เส​เด​คี​ยา	sejDeKiyaa
เอ​วิน​เม​โล​ดัก	ewinmeloDakg
อาน​วัด	aanwatq
เส​เม	sejme
อับ​ลาม	apglaam
มัด​สา	matqsaaj
เฒ​ฟี	zefi
กา​ทาม	kaaTaam
มิด​ซา	mitqsaa
อัน​วาน	anwaan
เซ​ฟี	sefi
ฮัม​ลาน	hamlaan
บิน​ฮาน	Binhaan
สา​วาน	saajwaan
ยา​อา​คาน	yaaaaKaan
มัด​เล​คา	matqleKaa
เม​เฮ​ทา​เบน	meheTaaBen
มัก​ดี​เอน	makqDien
อิ​ลาม	ilaam
เป​เล้ด	peletq
ฮา​มูน	haamun
เอ​ทาน	eTaan
เฮ​มาน	hemaan
คาน​โค	KaanKo
ดาน​ดา	DaanDaa
ลัด​ได	latqDai
โอ​เซม	osem
เย​เท	yeTe
เย​ลี​โอด	yeliotg
อาน​โดน	aanDon
เส​กุบ	sejkupg
คา​เล้บ​เอ​ฟา​ลา​ทา	KaalepqefaalaaTaa
อัด​ฮู	atghu
อา​ทา​ลา	aaTaalaa
ซัม​ไม	sammai
ยา​ดา	yaaDaa
อา​บี​ชู	aaBiQu
อา​บี​ฮา​อิน	aaBihaain
อัก​บาน	akgBaan
โม​ลิด	molitq
เซ​เล​เล้ด	seleletq
อับ​ปา​อิม	apgpaaim
อิด​อี	itgi
เซ​ซัน	sesan
อัก​ไล	akglai
ยา​ละ​ฮา	yaalaahaa
อัด​ไท	atgTai
สา​บาด	saajBaatg
เอ​ฟาน	efaan
เอ​เล​อา​สา	eleaasaaj
สิ​สะ​ไม	sisaamai
เย​คา​มิ​ยา	yeKaamiyaa
ลา​ฮัม	laaham
โย​ละ​เค​อัม	yolaaKeam
ยา​ได	yaaDai
เก​ซาน	kesaan
เป​เหลด	peletg
เอ​ฟา	efaa
ซา​อับ	saaapg
มัก​เบ​นา	makqBenaa
เช​วา	Qewaa
สัน​มา	sanjmaa
ฮา​เล้ด	haaletq
เบด​กา​เด	BetgkaaDe
ปุ​ไท	puTai
ซู​มัด	sumatq
มิด​ลา	mitqlaa
ซิ​เม​อา	simeaa
เอน​เป​เล้ด	enpeletq
โน​กา	nokaa
มัน​คี​ลาม	manKilaam
เซ​น้าด​ซา	senaatqsaa
โฮ​ซา​มา	hosaamaa
เน​ดา​บี​ยา	neDaaBiyaa
เส​ลุบ​บา​เบน	sejlupqBaaBen
ฮา​นัน​ยา	haananyaa
ฮา​ซู​บา	haasuBaa
โอ​เฮน	ohen
เบ​เล​คิ​ยา	BeleKiyaa
ฮา​สา​ดิ​ยา	haasaajDiyaa
ยู​ซับ​เฮ​เสด	yusapqhesetg
เป​ลา​ที​ยา	pelaaTiyaa
เย​ซา​ยา	yesaayaa
เล​ไฟ​ยา	lefaiyaa
อาน​นัน	aannan
เซ​คา​นิ​ยา	seKaaniyaa
เซ​ไม​อา	semaiaa
ฮัด​ทัด	hatqTatq
บา​ลี​ยา	Baaliyaa
เน​อา​ลี​ยา	neaaliyaa
เอ​ลี​โอ​ไน	elionai
อัด​ลี​คัม	atgliKam
โฮ​ดา​วิ​ยา	hoDaawiyaa
เอ​ลี​ยา​ซี้บ	eliyaasipq
เป​ไล​ยา	pelaiyaa
อัก​ขูบ	akgKupg
โย​ฮา​นัน	yohaanan
เด​ไล​ยา	Delaiyaa
อา​นา​นี	aanaani
เล​อา​ยา	leaayaa
ยา​หาด	yaahaatg
อา​หุ​ไม	aahumai
ลา​ฮ้าด	laahaatq
เอ​ตาม	etaam
อิด​มา	itgmaa
อิด​บาด	itgBaatg
ฮัด​เซ​เลน​โพ​นี	hatqselenPoni
เฮ​ลา	helaa
เธ​เอ​เล้ด	Zeeletq
เอด​นาน	etgnaan
ซู​ฮา	suhaa
เม​หิ	mehi
เอด​โทน	etgTon
เบด​ลา​ฟา	Betglaafaa
ปา​เส​อา	paasejaa
เท​หิน​นา	Tehinjnaa
เล​คา	leKaa
เส​ไล​อา	sejlaiaa
ฮา​ท้าด	haaTaatq
เม​โอ​โน​ไท	meonoTai
อิ​ลู	ilu
นา​อัม	naaam
เย​ฮาน​เล​เลน	yehaanlelen
สิ​ฟา	sifaa
ทิ​ลี​ยา	Tiliyaa
อา​สา​เลน	aasaajlen
เอด​ลา	etglaa
เม​เล้ด	meletq
เอ​เฟ	efe
เค​นัน	Kenan
มา​หะ​ลา​เลน	maahaalaalen
เอ​โน้ก	enokq
เม​ทู​เส​ลา	meTusejlaa
โน​ยา	noyaa
นิม​โล้ด	nimlotq
อา​ลัม	aalam
เช​ลา	Qelaa
อี​สัก	isakg
โล​ทาน	loTaan
ดี​โซน	Dison
ฮา​ดัด	haaDatg
เม​เฮ​ทา​เบน	meheTaaBen
ยู​ดา	yuDaa
อัม​มี​นา​ดับ	amminaaDapg
นา​โซน	naason
สัน​โมน	sanjmon
โอ​เบด	oBetg
เส​ลุ​ยา	sejluyaa
เย​ลี​โอด	yeliotg
อุ​ลี	uli
จา​อี	Jaai
อัด​ฮู	atghu
อา​ทา​ลา	aaTaalaa
อา​บี​ฮา​อิน	aaBihaain
อิด​อี	itgi
เซ​ซัน	sesan
เย​เท	yeTe
นา​ทัน	naaTan
เอ​ฟาน	efaan
เย​ฮู	yehu
เฮ​เล้ด​เท	heletqTe
สิ​สะ​ไม	sisaamai
เย​คา​มิ​ยา	yeKaamiyaa
ลา​ฮัม	laaham
มา​โอน	maaon
ดา​วิด	Daawitq
เล​โห​โบ​อัม	lehojBoam
อา​บี​ยา	aaBiyaa
อา​สา	aasaaj
อา​มา​ซิ​ยา	aamaasiyaa
อา​ซา​ลิ​ยา	aasaaliyaa
อา​หัด	aahatg
เฮ​เซ​คี​ยา	heseKiyaa
อัม​โมน	ammon
เย​โฮ​ยา​คีน	yehoyaaKin
เส​ลุบ​บา​เบน	sejlupqBaaBen
เย​ซา​ยา	yesaayaa
เล​ไฟ​ยา	lefaiyaa
อาน​นัน	aannan
โอ​บา​ดี	oBaaDi
เซ​คา​นิ​ยา	seKaaniyaa
เซ​ไม​อา	semaiaa
ยา​หาด	yaahaatg
เม​หิ	mehi
เท​หิน​นา	Tehinjnaa
ยา​โลน	yaalon
อิด​บา	itgBaa
บิ​ทิ​ยา	BiTiyaa
เย​เล้ด	yeletq
เย​คู​ที​เอน	yeKuTien
ซิ​โมน	siqmon
ลิน​นา	linnaa
เบน​ฮา​นัน	Benhaanan
ทิ​โลน	Tilon
โส​เหด	sojhetg
เบน​โซ​เฮ้ด	Bensohetq
มา​เล​ซา	maalesaa
ลา​อา​ดา	laaaaDaa
เบด​อัด​เบ​อา	BetgatgBeaa
เน​ทา​อิม	neTaaim
เก​เด​ลา	keDelaa
เน​มู​เอน	nemuen
ยา​ลี้บ	yaalipq
ซัน​ลูม	sanlum
มิบ​สัม	mipqsamj
มิบ​สัม	mipqsamj
ฮัม​มู​เอน	hammuen
ฮัม​มู​เอน	hammuen
สัก​เก	sakgke
โท​ลัด	Tolatq
ฮา​ซาน​สู​สิม	haasaansujsimj
เบด​บี​ลี	BetgBili
อา​ยิน	aayin
โท​เคน	ToKen
เม​โซ​บับ	mesoBapg
ยัม​เล้ก	yamlekq
โย​ซา	yosaa
โย​เอน	yoen
โย​ซิ​บี​ยา	yosiBiyaa
โย​ซิ​บี​ยา	yosiBiyaa
อา​สิ​เอน	aasien
อา​สิ​เอน	aasien
ยา​อา​โค​บา	yaaaaKoBaa
เย​โซ​ฮา​ยา	yesohaayaa
อา​ดี​เอน	aaDien
เย​สิ​มี​เอน	yesimien
ฒี​ฒา	zizaa
ฒี​ฒา	zizaa
ซิ​ฟี	sifi
ซิ​ฟี	sifi
อัน​โลน	anlon
อัน​โลน	anlon
เย​ดา​ยา	yeDaayaa
เย​ดา​ยา	yeDaayaa
ซิม​ลี	simli
ซิม​ลี	simli
มี​คา	miKaa
เล​อา​ยา	leaayaa
เบ​เอ​ลา	Beelaa
เบ​เอ​ลา	Beelaa
ซา​ฟาม	saafaam
ยา​ไน	yaanai
หุ​ลี	huli
หุ​ลี	huli
ยา​โล​อา	yaaloaa
ยา​โล​อา	yaaloaa
กิ​เล​อาด	kileaatg
มี​คา​เอน	miKaaen
เย​ซิ​ไซ	yesisai
เย​ซิ​ไซ	yesisai
ยา​โด	yaaDo
ยา​โด	yaaDo
บุด	Butg
อับ​ดี​เอน	apgDien
อา​หิ	aahi
โน​ดับ	noDapg
เอ​ลี​เอน	elien
ยา​ดี​เอน	yaaDien
ฟี​เน​หัด	finehatg
อา​บี​ชู​วา	aaBiQuwaa
บุก​คี	BukgKi
อุด​ซี	utgsi
เส​ลา​หิ​ยา	sejlaahiyaa
เส​ลา​หิ​ยา	sejlaahiyaa
เม​ลา​โย้ด	melaayotq
อา​มา​ลิ​ยา	aamaaliyaa
อา​มา​ลิ​ยา	aamaaliyaa
สา​โดก	saajDokg
ฮิน​คี​ยา	hinKiyaa
เส​ไล​อา	sejlaiaa
เย​โฮ​ซา​ดัก	yehosaaDakg
เน​บู​คัด​เน้ด​ซา	neBuKatqnetqsaa
สิม​มา	simjmaa
โย​อา	yoaa
โย​อา	yoaa
อิด​โด	itgDo
เฒ​ลา	zelaa
เย​อา​เท​ไล	yeaaTelai
เอน​คา​นา	enKaanaa
เอ​บี​ยา​สาบ	eBiyaasaapg
เอ​บี​ยา​สาบ	eBiyaasaapg
ทา​หัด	Taahatg
อุ​ลี​เอน	ulien
อุ​ลี​เอน	ulien
อุด​ซี​ยา	utgsiyaa
อา​หิ​โม้ด	aahimotq
โส​ไฟ	sojfai
โส​ไฟ	sojfai
เอ​ลี​อับ	eliapg
เย​โล​ฮัม	yeloham
เย​โล​ฮัม	yeloham
ซิ​เม​อา	simeaa
ฮัก​กี​ยา	hakqkiyaa
ฮัก​กี​ยา	hakqkiyaa
เอ​ลี​เอน	elien
โท​อา	Toaa
มา​ฮ้าด	maahaatq
มา​ฮ้าด	maahaatq
อา​มา​ไส	aamaasaij
โย​เอน	yoen
เส​ฟัน​ยา	sejfanyaa
อัด​สี	atgsij
อิด​ฮา	itghaa
โค​ฮ้าด	Kohaatq
เล​วี	lewi
อา​สาบ	aasaapg
อา​สาบ	aasaapg
เบ​เล​คิ​ยา	BeleKiyaa
บา​อา​เส​ยา	Baaaasejyaa
บา​อา​เส​ยา	Baaaasejyaa
มัน​คิ​ยา	manKiyaa
เอด​นี	etgni
เอด​นี	etgni
เอ​ทาน	eTaan
สิม​มา	simjmaa
เก​โซน	keson
คี​ซี	Kisi
คี​ซี	Kisi
อับ​ดี	apgDi
อับ​ดี	apgDi
มัน​ลุก	manlukq
ฮา​ซา​ปิ​ยา	haasaapiyaa
ฮา​ซา​ปิ​ยา	haasaapiyaa
อัม​ซี	amsi
อัม​ซี	amsi
บา​นี	Baani
เช​เม	Qeme
มา​ลี	maali
มู​ซี	musi
เม​ลา​ลี	melaali
อุด​ซี	utgsi
เม​ลา​โย้ด	melaayotq
ฮี​เลน	hilen
ดา​เบ​ลัด	DaaBelatq
มา​ซาน	maasaan
พู​อา	Puaa
เย​ดี​ยา​เอน	yeDiyaaen
เย​ลี​โม้ด	yelimotq
อิ​ลี	ili
เส​มิ​ลา	sejmilaa
เย​เล​โม้ด	yelemotq
อา​เล​เม้ด	aalemetq
บิน​ฮาน	Binhaan
เค​นา​อะ​นา	Kenaaaanaa
เส​ทาน	sejTaan
อา​หิ​ชา​ฮา	aahiQaahaa
หุบ​ปิม	hupgpim
ซุบ​ปิม	supqpim
เส​โล​เฟ​หัด	sejlofehatg
เป​แล้ด	pelctq
เช​เล้ด	Qeletq
เป​แล้ด	pelctq
อุ​ลาม	ulaam
ลา​เคม	laaKem
ฮัม​โม​เล​เค้ด	hammoleKetq
อิด​โฮ้ด	itghotq
อา​หิ​ยัน	aahiyan
ลิก​ฮี	likqhi
อา​นี​ยัม	aaniyam
เช​เอ​ลา	Qeelaa
อุด​เซน​เช​เอ​ลา	utgsenQeelaa
เล​ฟา	lefaa
เล​ฟา	lefaa
เล​เซ้บ	lesepq
เล​เซ้บ	lesepq
เท​ลา	Telaa
ทา​ฮัน	Taahan
ลา​ดาน	laaDaan
ลา​ดาน	laaDaan
อัม​มี​ฮู้ด	ammihutq
บิน​ซา​อิด	Binsaaitg
มัน​คี​เอน	manKien
ยา​เฟ​เล้ด	yaafeletq
โซ​เม	some
โฮ​ทาม	hoTaam
ปา​สัก	paasakg
บิม​ฮาน	Bimhaan
อัด​ว้าด	atgwaatq
โล​กา	lokaa
เย​ฮุบ​บา	yehupqBaa
เฮ​เลม	helem
โส​ฟา	sojfaa
เช​เอ​เล้ด	Qeeletq
อา​มัน	aaman
สุ​อา	suaa
ฮาน​เน​เฟ	haannefe
เบ​ลี	Beli
เบ​เซ	Bese
โฮ้ด	hotq
ซิน​ซา	sinsaa
ปิด​ปา	pitgpaa
อา​ลา	aalaa
อุน​ลา	unlaa
ลี​เสีย	lisiaj
โน​ฮา	nohaa
ลา​ฟา	laafaa
อัด​ดา	atgDaa
อา​บี​ฮู้ด	aaBihutq
อา​โห​อา	aahojaa
เซ​ฟู​ฟาน	sefufaan
หุ​ลาม	hulaam
เก​ลา	kelaa
ซา​หะ​ลา​อิม	saahaalaaim
บา​อา​ลา​อา	Baaaalaaaa
โฮ​เดด	hoDetg
สิ​เบีย	siBia
เม​ซา	mesaa
มัน​คาม	manKaam
เย​อุด​เอ	yeutge
สา​เคีย	saajKia
มิน​มา	minmaa
อา​บี​ทู้บ	aaBiTupq
เอน​ปา​อัน	enpaaan
อา​หิ​โย	aahiyo
ซา​ซัก	saasakq
เส​บา​ดิ​ยา	sejBaaDiyaa
เอ​เด	eDe
อิด​ปา	itgpaa
โย​ฮา	yohaa
ฮิด​คี	hitqKi
อิด​เม​ไล	itgmelai
อิ​สะ​ลิ​ยา	isaaliyaa
ยา​คิม	yaaKim
เอ​ลี​เย​ไน	eliyenai
สิน​เล​ไท	sinjleTai
เบ​ไล​อา	Belaiaa
ซิม​ล้าด	simlaatq
อิด​ปาน	itgpaan
ฮา​นัน	haanan
อัน​โท​ที​ยา	anToTiyaa
อิบ​ได​ยา	ipgDaiyaa
ซัม​เซ​ไล	samselai
เซ​หะ​ลี​ยา	sehaaliyaa
ยา​อา​เล​ซี​ยา	yaaaalesiyaa
เย​อี​เอน	yeien
เส​เค	sejKe
เซา​โล	saulo
เอด​บา​อัน	etgBaaan
เม​ลิบ​บา​อัน	melipqBaaan
เม​ลิบ​บา​อัน	melipqBaaan
ปิ​โทน	piTon
เม​เล้ก	melekq
ทา​เลีย	Taalia
เย​โฮ​อัด​ดา	yehoatgDaa
เย​โฮ​อัด​ดา	yehoatgDaa
สิม​ลี	simjli
บิ​เน​อา	Bineaa
บิ​เน​อา	Bineaa
ลา​ฟา	laafaa
เอ​เล​อา​สา	eleaasaaj
อา​เซน	aasen
โบ​เค​ลู	BoKelu
เซ​อา​ลิ​ยา	seaaliyaa
อิ​สะ​ลา​เอน	isaalaaen
เย​อู​เอน	yeuen
สัน​ลู	sanjlu
โฮ​ดา​วิ​ยา	hoDaawiyaa
หัด​เส​นู​อา	hatgsejnuaa
อิบ​เน​ยา	ipgneyaa
อิบ​เน​ยา	ipgneyaa
เอ​ลา	elaa
มิก​ลี	mikqli
มิก​ลี	mikqli
เม​ซุน​ลาม	mesunlaam
เซ​ฟา​ทิ​ยา	sefaaTiyaa
เล​อู​เอน	leuen
อิบ​นี​ยา	ipgniyaa
เย​โฮ​ยา​ลิบ	yehoyaalipq
อา​ดา​ยา	aaDaayaa
ปาด​เฮ	paatghe
ปาด​เฮ	paatghe
มัน​คิ​ยา	manKiyaa
มะ​อา​ไส	maaaasaij
มะ​อา​ไส	maaaasaij
อา​ดี​เอน	aaDien
ยา​เซ​ลา	yaaselaa
ยา​เซ​ลา	yaaselaa
เม​ซิน​เล​มิด	mesinlemitq
เม​ซิน​เล​มิด	mesinlemitq
อิม​เม	imme
บัก​บัก​คา	BakgBakgKaa
เฮ​เล้ด​เส	heletqsej
กา​ลาน	kaalaan
มัด​ทา​นิ​ยา	matqTaaniyaa
สิก​ลี	sikgli
กา​ลาน	kaalaan
เย​ดู​ทูน	yeDuTun
เย​ดู​ทูน	yeDuTun
เย​อี​เอน	yeien
มิก​โล้ด	mikqlotq
ยา​ลา	yaalaa
ยา​ลา	yaalaa
เย​บุด	yeButg
ปัด​ดัม​มิม	patgDammim
เด่ย	Deig
ซัม​โม้ด	sammotq
เป​โลน	pelon
สิบ​เบ​ไค	sipgBeKai
อิ​ไล	ilai
อิ​ไท	iTai
หุ​ไล	hulai
อาน​บา	aanBaa
ซา​อัน​โบน	saaanBon
เอ​ลี​ยา​บา	eliyaaBaa
กิม​โซ	kimso
ฮา​เซม	haasem
ซา​กี	saaki
สา​คา	saajKaa
อู​อา	uaa
เอ​ลี​ฟัน	elifan
เม​เค​ลา	meKelaa
เอด​ไบ	etgBai
นา​อา​ไล	naaaalai
ฮา​กี	haaki
มิบ​ฮา	mipqhaa
อิด​ไล	itglai
ซิ​ซา​อา	sisaaaa
อา​ดี​นา	aaDinaa
มิด​เน	mitqne
โย​ซา​ฟัด	yosaafatq
ทิ​ไซ	Tisai
มา​หะ​ไว	maahaawai
เอน​นา​อัม	ennaaam
เย​ลี​ไบ	yeliBai
โย​ซา​วิ​ยา	yosaawiyaa
เม​โซ​ไบ	mesoBai
ยา​อา​ซี​เอน	yaaaasien
เซ​มา​อา	semaaaa
เย​ซี​เอน	yesien
เพ​เหลด	Peletg
เบ​ลา​คา	BelaaKaa
เอ​ลู​ไซ	elusai
เบ​อัน​ยา	Beanyaa
เซ​มา​ลิ​ยา	semaaliyaa
ฮา​ลู้บ	haalupq
อิด​ซี​ยา	itgsiyaa
อา​ซา​เลน	aasaalen
โย​เอ​เซ	yoese
ยา​โซ​เบ​อัม	yaasoBeam
โย​เอ​ลา	yoelaa
มิด​มัน​นา	mitqmannaa
เอน​ซา​บาด	ensaaBaatg
มัก​บัน​ไน	makqBannai
คิ​โดน	KiDon
ค้า	Kaaq
ควัด	suv
อุด​ซา	puad
โอ​เบด​เอ​โดม	pyauq
เบ​เอน​ยา​ดา	BeenyaaDaa
เค​นา​นี​ยา	Kenaaniyaa
หฑวน	Rwrnj
อา​บี​ไช	aaBiQai
ซี​เลีย	silia
ซา​ตาน	saataan
หนัม	namj
เจียน	Jyen
เซ​โล​โม้ด	selomotq
ฮา​ซี​เอน	haasien
เก​โซม	kesom
ฮา​ลิม	haalim
เส​โอ​ลิม	sejolim
มิ​ยา​มิน	miyaamin
ฮัก​โขด	hakqKotg
เย​ซู​อา	yesuaa
หุบ​ปา	hupgpaa
เย​เซ​เบ​อับ	yeseBeapg
บิน​กา	Binkaa
เฮ​ซี	hesi
หับ​ปิด​เซ้ด	hapgpitgsetq
เป​ทา​หิ​ยา	peTaahiyaa
เย​เฮ​เซ​เคน	yeheseKen
กา​มุน	kaamun
มา​อา​ซิ​ยา	maaaasiyaa
ยา​อา​ซี​ยา	yaaaasiyaa
เบ​โน	Beno
เก​ดา​ลิ​ยา	keDaaliyaa
เส​ลี	yesaayaa
มัด​ที​ทิ​ยา	yeDuTun
บุก​คี​ยา	BukgKiyaa
เซ​บู​เอน	seBuen
ฮา​นา​นี	haanaani
เอ​ลี​ยา​ทา	eliyaaTaa
กิด​ดาน​ที	kitgDaanTi
โล​มัม​ที​เอ​เซ	lomamTiese
โย้ด​เบ​คา​ซา	yotqBeKaasaa
มัน​โล​ที	manloTi
โฮ​ที	hoTi
มา​หะ​ซิ​โอด	maahaasiotg
เย​โฮ​ฮา​นัน	yehohaanan
เอ​ลี​โฮ​ไน	elihonai
เป​อุน​เล​ไท	peunleTai
โฮ​สา	hosaaj
ซัน​เล​เค้ด	sanleKetq
กวั้น	kwanb
เย​ฮี​เอ​ลี	ye
เส​ทาม	yoen
เย​ลี​ยา	yeliyaa
ต๋อย	txij
หฮญัง	Havj
สับ​ดี​เอน	sapgDien
อิ​สะ​ลา	isaalaa
ซัม​หุด	samhutg
เฮน​ได	henDai
เอ​ลี​ฮู	elihu
อิด​ไม​อา	itgmaiaa
เค​ลู้บ	Kelupq
เอ​สะ​ลี	esaali
เซ​ฟาม	sefaam
อะหงุ่น	avung
โอ​บิน	oBin
เม​โล​โน้ด	melonotq
อาน​คี	aanKi
ซา​โล​มอน	saalomxn
อ๊ะ	aq
ลู์ง	luvd
ไท​ละ	Tailaq
ยับ​ฟา	yapqfaa
เค​ลู​บิม	KeluBim
เหยียด	yetg
ยัง	yav
ยัง	yav
เค​ลู​บิม	KeluBim
ปูง	puv
โต๋	toj
ทีง	Tiv
ล์ง	lovd
ปุ้น	punb
ซา​โล​มอน	saalomxn
พ่าง	Paavb
พ่าง	Paavb
พ่าง	Paavb
อิ​สะ​ลา​เอน	isaalaaen
ฮา​มัด​โส​บา	haamatqsojBaa
เบด​โฮ​โลน	Betgholon
ซา​โล​มอน	saalomxn
เซ​เคม	seKem
เย​โล​โบ​อัม	yeloBoam
เล​โห​โบ​อัม	lehojBoam
อา​โด​ลา​อิม	aaDolaaim
มา​หะ​ลัด	maahaalatq
มา​หะ​ลัด	maahaalatq
มา​หะ​ลัด	maahaalatq
สา​ฮัม	saajham
มา​อา​คา	maaaaKaa
อั๊ด​ไท	atqTai
เย​ลู​ซา​เลม	yelusaalem
ยู​ดา	yuDaa
เส​ฟา​ทา	sejfaaTaa
โอ​เดด	oDetg
ปวั๊ง	pwavq
เตีย	tia
บา​อา​ชา	BaaaaQaa
เย​โฮ​ซา​ฟัด	yehosaafatq
เน​ทา​นิ​ยา	neTaaniyaa
เซ​มิ​ลา​โม้ด	semilaamotq
เย​โฮ​นา​ทัน	yehonaaTan
โท​บี​ยา	ToBiyaa
โท้บ​อา​โด​นิ​ยา	TopqaaDoniyaa
เย​โฮ​ซา​บาด	yehosaaBaatg
อา​หับ	aahapg
ลา​โม้ด​กิ​เล​อาด	laamotqkileaatg
แปะ	pcg
’	’
เม​อู​นี	meuni
เซียงต๋อง	txvj
ยา​ฮา​ซี​เอน	yaahaasien
ยา​ฮา​ซี​เอน	se
เส​คา​ลิ​ยา	se
เบ​ไน​ยา	se
ตู๋ง	tuvq
อา​หัด​ยา	aahatgyaa
เย​โฮ​ลัม	yeholam
เย​ฮี​เอน	yehien
อา​ซา​ลี​ยา​ฮู	aasaaliyaahu
เย​โฮ​ลัม	yeholam
เอ​ที​โอ​เปีย	eTiopia
เย​โฮ​ลัม	yeholam
อา​หับ	aahapg
โย​ลัม	yolam
โย​ลัม	yolam
เย​ฮู	yehu
โก๊ว	kruq
เย​โฮ​ยา​ดา	yehoyaaDaa
ฮู่ง	huvb
ซิ​เม​อัด	simeatg
ซิม​ลิด	simlitq
ล่าง	laavb
เย​โฮ​อาด	yehoaatg
เย​โฮ​อาด	yehoaatg
อา​มา​ซิ​ยา	aamaasiyaa
ลา​คี้ด	laaKitq
เย​โค​ลี​ยา	yeKoliyaa
ยับ​เน	yapqne
ฒี่ง	zivb
ฟี​ลิ​สะ​เตีย	filisaatia
กู​อา​บา​อัน	kuaaBaaan
อุด​ซี​ยา	utgsiyaa
อา​ม้อด	aamxtq
โอ​เฟน	ofen
ท้ง	Tovq
โย​ทาม	yoTaam
มา​อา​เส​อา	maaaasejaa
เม​ซิน​เล​โม้ด	mesinlemotq
เย​ฮิด​คี​ยา	yehitqKiyaa
หัด​ไล	hatglai
ป๋าว	paauj
หฑัด	Ratg
เตี๋ย	tiaj
โค​นา​นิ​ยา	Konaaniyaa
โค​เล	Kole
กะน้าย	kanaaiq
เซน​นา​เค​ลิบ	sennaaKelipq
ปั์วเดี๊ย	Diaq
เฮ​เซ​คี​ยา	heseKiyaa
ธั้ม	Zamq
ฮม์	Mmd
มะ​นัด​เส	maanatqsej
อา​โมน	aamon
ฮวิน	Win
หฒ่อ	zxg
ต๋อง	txvj
ต๋อง	txvj
ฮา​ซา​บี​ยา	haasaaBiyaa
โย​ซา​บาด	yosaaBaatg
ยู่ง	yuvb
เน​โค	neKo
คาน​เค​มิด	KaanKemitq
โย​อา​หาด	yoaahaatg
เย​เล​มี	yelemi
เป​เซีย	pesia
ไซ​ลัด	sailatq
มัก​บีด	makqBitg
โหลด	lotg
ฮา​ดิด	haaDitg
โอ​โน	ono
เส​นา​อา	sejnaaaa
อาน​ทา​เซ​ซี้ด	aanTaasesitq
บิด​ลาม	Bitglaam
มิด​เล​ดาด	mitqleDaatg
ทา​เบ​เอน	TaaBeen
อาน​ทา​เซ​ซี้ด	aanTaasesitq
อาน​ทา​เซ​ซี้ด	aanTaasesitq
ดา​ลิ​อัด	Daaliatg
เอก​บา​ทา​นา	ekgBaaTaanaa
ฮัก​ไก	hakqkai
ยิว​ไท	yiuTai
อา​หิ​ทู้บ	aahiTupq
มา​ลา​โย้ด	maalaayotq
อา​บี​ชู​วา	aaBiQuwaa
เอ​เล​อา​ซา	eleaasaa
เอ​สะ​ลา	esaalaa
ก่อง	kxvg
อา​หะ​วา	aahaawaa
ลุย	tomb
เฮง	hev
เอ​สะ​ลา	esaalaa
เอ​สะ​ลา	esaalaa
ยา​ไซ​อา	yaasaiaa
ซับ​เบ​ไท	sapqBeTai
เค​ลา​ยา	Kelaayaa
เค​ลิ​ทา	KeliTaa
เบ​ได​ยา	BeDaiyaa
เค​ลุ​ฮี	Keluhi
วา​นิ​ยา	waaniyaa
เม​เล​โม้ด	melemotq
มัด​เท​ไน	matqTenai
ยา​อา​สุ	yaaaasu
เซ​เล​มิ​ยา	selemiyaa
มัก​นา​เด​ไบ	makqnaaDeBai
ซา​ไซ	saasai
ซา​ไล	saalai
เซ​เล​มิ​ยา	selemiyaa
ฮา​คา​ลิ​ยา	haaKaaliyaa
เน​หะ​มี	nehaami
คิด​เล้บ	Kitqlepq
สุ​สา	susaaj
ฮนั้ม	Namq
นิ​สาน	nisaanj
สัน​บาน​ลัด	sanjBaanlatq
โท​บี​อา	ToBiaa
เก​เซม	kesem
อิม​ลี	imli
เม​เซ​ซา​เบน	mesesaaBen
โย​ยา​ดา	yoyaaDaa
เบ​โส​ได​อา	BesojDaiaa
เย​ซา​นา	yesaanaa
ซอน	sxn
ฮา​ลุ​มับ	haalumapq
ฮา​ซับ​เน​ยา	haasapqneyaa
ปา​หัด​โม​อับ	paahatgmoapg
หัด​ซู้บ	hatgsupq
ฮัน​โล​เหด	hanlohetg
เล​ฮูม	lehum
สับ​ไบ	sapgBai
บา​ลุก	Baalukq
หัด​ซู้บ	hatgsupq
อา​นา​นี​ยา	aanaaniyaa
เฮ​นา​ดัด	henaaDatg
บิน​นุย	Binnwi
อุ​ไซ	usai
ปา​ลาน	paalaan
ปา​โล้ด	paalotq
สา​ล้าบ	saajlaapq
ล่าน	laanb
โท​บี​อา	ToBiaa
โน​อัด​ยา	noatgyaa
โหย่ว	yrug
ลา​อา​มี​อา	laaaamiaa
นา​หะ​มา​นี	naahaamaani
โม​เด​ไค	moDeKai
บิน​ซาน	Binsaan
มิด​เป​เล้ด	mitqpeletq
บิก​ไว	Bikgwai
เน​ฮูม	nehum
เบด​อัด​มา​เว้ด	Betgatgmaawetq
จ้อย	Jxib
ขัด​มี​เอน	Katgmien
เช​บา​นี​ยา	QeBaaniyaa
บุน​นี	Bunni
เซ​เล​ปี​ยา	selepiyaa
เค​นา​นี	Kenaani
ขัด​มี​เอน	Katgmien
เซ​เล​ปี​ยา	selepiyaa
โฮ​ดี​ยา	hoDiyaa
เช​บา​นี​ยา	QeBaaniyaa
เกน	ken
ค้อย	Kxiq
ดา​นี​เอน	Daanien
กิน​เน​โทน	kinneTon
บิน​ไก	Binkai
เบ​นิ​นู	Beninu
ปัด​โล้ด	patglotq
สัด​ทู	satgTu
อัด​กาด	atgkaatg
เบ​ไบ	BeBai
อา​ดีน	aaDin
อา​เท	aaTe
ฮา​ซูม	haasum
เบ​ไซ	Besai
ฮา​ลิบ	haalipq
เน​ไบ	neBai
มัก​บี​อาด	makqBiaatg
ย้าด​ดู​วา	yaatqDuwaa
อา​นา​ยา	aanaayaa
ปิน​หา	pinhaaj
โซ​เบก	soBekg
ฮา​ซับ​นา	haasapqnaa
อา​หิ​อา	aahiaa
อา​นัน	aanan
กับ​ไบ	kapgBai
สัน​ไล	sanjlai
โย​ยา​ลิบ	yoyaalipq
อัด​ลี​คัม	atgliKam
สับ​ดี	sapgDi
บัก​บู​คิ​ยา	BakgBuKiyaa
อับ​ดา	apgDaa
สี​หะ	sijhag
กิด​ปา	kitgpaa
เบด​เพ​เหลด	BetgPeletg
เอน​ลิม​โมน	enlimmon
เส​โบ​อิม	sejBoim
เน​บัน​ลัด	neBanlatq
เซ​อัน​ทิ​เอน	seanTien
กิน​เน​ทอย	kinneTxi
มา​อา​ดี​ยา	maaaaDiyaa
โย​ยา​คิม	yoyaaKim
โย​ยา​คิม	yoyaaKim
เอ​ลี​ยา​ซี้บ	eliyaasipq
โย​ยา​ดา	yoyaaDaa
โย​นา​ทาน	yonaaTaan
โย​ยา​คิม	yoyaaKim
เม​ลา​ยา	melaayaa
มัน​ลู​คี	manluKi
เฮน​คาย	henKaai
มิน​ยา​มิน	minyaamin
โม​อัด​ยา	moatgyaa
ปิน​ไท	pinTai
คาน​ไล	Kaanlai
อา​โม้ก	aamokq
ทัน​โมน	Tanmon
เบด​กิน​กาน	Betgkinkaan
โฮ​ซา​ยา	hosaayaa
มัด​ทา​นิ​ยา	matqTaaniyaa
มี​คา​ยา	miKaayaa
เอ​ลี​ยา​คิม	eliyaaKim
มิน​ยา​มิน	minyaamin
ยิด​สะ​ลา​ยา	yitqsaalaayaa
อัด​โดด	atgDotg
อา​หะ​สุ​เอ​ลัด	aahaasuelatq
อิน​เดีย	inDia
อา​หะ​สุ​เอ​ลัด	aahaasuelatq
สุ​สา	susaaj
ยิ่น	yinb
วัด​ชา​ที	watqQaaTi
อา​หะ​สุ​เอ​ลัด	aahaasuelatq
ยิ่น	yinb
วัด​ชา​ที	watqQaaTi
คาน​เซ​นา	Kaansenaa
เช​ทา	QeTaa
อัด​มา​ทา	atgmaaTaa
มาน​เส​นา	maansejnaa
เม​มู​คาน	memuKaan
เป​เซีย	pesia
ห่า	haag
เม​มู​คาน	memuKaan
วัด​ชา​ที	watqQaaTi
เย​โค​นี​ยา	yeKoniyaa
โม​เด​ไค	moDeKai
เอ​เซ​เท	eseTe
เฮ​ไก	hekai
เอ​เซ​เท	eseTe
เอ​เซ​เท	eseTe
เท​เบ๊ด	TeBetq
เอ​เซ​เท	eseTe
เอ​เซ​เท	eseTe
เอ​เซ​เท	eseTe
เอ​เซ​เท	eseTe
เอ​เซ​เท	eseTe
โม​เด​ไค	moDeKai
บิก​ทาน	BikgTaan
เท​เล้ด	Teletq
เอ​เซ​เท	eseTe
เอ​เซ​เท	eseTe
ดิ๋ว	Diuj
ฮา​มาน	haamaan
ฮา​มาน	haamaan
ปู​อา	puaa
ลั์ม	lamd
ฮา​มาน	haamaan
ฮา​ท้าก	haaTaakq
ฮา​ท้าก	haaTaakq
ฮา​ท้าก	haaTaakq
ปัว	pua
ธิ่น	Zinb
บิก​ทา​นา	BikgTaanaa
ปาน​ชัน​ดา​ทา	paanQanDaaTaa
ดาน​โฟน	Daanfon
อัด​ปา​ทา	atgpaaTaa
โป​ลา​ทา	polaaTaa
อา​ดัน​ยา	aaDanyaa
อา​ลี​ดา​ทา	aaliDaaTaa
ปาน​มัด​ทา	paanmatqTaa
อา​ลี​ไส	aalisaij
อา​ลี​ได	aaliDai
ไว​ซา​ทา	waisaaTaa
ปู​ลิม	pulim
ปู​ลิม	pulim
เคน​เดีย	KenDia
เสี่ย	siag
มับ	mapq
เหฒียว	zyruj
เล​วี​อา​ทาน	lewiaaTaan
เฮ่น	henb
เซี่ยน	syenb
ผอ	Pxj
หฮวา	Waaj
หฆับ	Gapg
เหฮลียน	Lyenj
หมิด	mitg
เยีย’	yia’
ฑุ์ย	Rwid
เยีย’	yia’
หฮลา	Laaj
ม์วน	mwrnd
โก้	kob
ชู​วา	Quwaa
บิน​ดัด	BinDatg
ลวั่ง	lwavb
โหล่ว	lrug
เซี้ยบ	syepq
ฒิ่ม	zimb
นา​อา​เม	naaaame
โถว	Truj
ซูง	suv
สู	suj
ฮ่าง	haavb
โปย้	pyob
โปย้	pyob
เสี่ยน	syeng
ว้วด	wrtq
แกว๊ะ	kwcq
หฑุ่น	Rung
เธียน	Zyen
ห่อย	hxig
ฟับ	fapq
เลี้ย	liaq
ฌอม	Fxm
น่าน	naanb
หมะ	mag
เบี๊ยะ	Biaq
หวั่ง	wavg
เกว๋น	kwenj
ฮล้อ	Lxq
ญ่า	Eaab
เบว	Beu
เบว	Beu
เฆาะ	Gxq
เยีย	yia
โก๋	koj
เอ​ลี​ฮู	elihu
เฒว่ย	zweib
หว่า’	waag’
โซะ	soq
เยี่ยม	yemb
อ๋าว	aauj
ดั่น	Dang
ฮมัด	Matq
ฮลบ	Lopq
ป์าม	paamd
เสี่ยว	syrug
เยี์ยน	yend
โต่	tog
หอบ’	hxpg’
บะหลี่ง	Balivg
กวิ้น	kwinb
กวิ้น	kwinb
กี๋ง	kivj
มวั่ง	mwavb
ลั์ม	lamd
น้าย’	naaiq’
ค้ม	Komq
เด่า	Daug
ธ้าย	Zaaiq
ญ้าย	Eaaiq
เบ​เฮ​โม้ด	Behemotq
ติ๋ว	tiuj
ธุด	Zutq
เซ​ลา	selaa
เซ​ลา	selaa
ตอเหฒี่ย	txb
เธี่ยน	Zyenb
โต้	tob
หฒอย	zxij
หว่า	waag
โล่ว	lrub
หฒาว	zaauj
ถาน	Taanj
ฒัวะ	zuaq
ญ่วน	Ewrnb
ลิ์ว	liud
ฒัว	zua
หฮวัง	Wavj
แป๋ง	pcvj
โก๋ว	kruj
เฒี่ยง	zyavb
ฒุ์ยเมี่ยน	myenb
ธ่อง	Zxvb
หน่าน	naang
ว้วด	wrtq
เล​บา​นอน	leBaanxn
ดิ้ว	Diub
ซี​ลี​โอน	silion
เหยียม	yemj
ฝิน	finj
เอ๊าะ	xq
ตั๋งต๋น	tonj
ฮ้า	haaq
ฮ้า	haaq
ฮ้า	haaq
ฮ้า	haaq
มิ​ซา	misaa
เมี์ยน	myend
ปั๊ด	patq
ตุ๋น	tunj
ชั้ง	Qavq
เจี๋ย	Jiaj
ไหล่	laig
เญี์ยม	Eyemd
ดั่น	Dang
เนี้ยว	nyruq
เหฑียว	Ryruj
ไห่	haig
สิน	sinj
เหญีย	Eiaj
ฮลบ	Lopq
จุ๊ด	Jutq
เหธา	Zauj
ญ้วด	Ewrtq
บย์าว	Byaaud
ม์า	maad
เบ๋ว	Beuj
เปาะ	pxg
แอ๊ง	cvq
เฑีย	Ria
เก​บาน	keBaan
ป๋วน	pwrnj
โอ​เล้บ	olepq
เส​เอบ	sejepg
สาน​มุน​นา	saanjmunnaa
บะหิน	Bahinj
ที่	Tib
อา​เมน	aamen
เบ๋ย	Beij
ป๊าย	paaiq
ฮนัม	Nam
ววมหล่าง	laavg
บั่น	Bang
เดี๊ย	Diaq
หมิ่น	ming
ปยบ	pyopg
เญี่ย	Eiab
เหญียน	Eyenj
เฒี่ยน	zyenb
ฆ้าด	Gaatq
ไล่	laib
เมน​คี​เซ​เดก	menKiseDekg
จอ​แดน	JxDcn
ดา​เล้ด	Daaletq
เฮ	he
วาว	waau
ลา​เม้ด	laametq
เพ	Pe
คบ	Kopq
เล้ด	letq
ตะฮงัด	taVatq
ตะฮงัด	taVatq
บิ์ว	Biud
ก๊าด	kaatq
ยา​โค้บ	yaaKopq
เอ​ฟา​ทา	efaaTaa
ยา​อา	yaaaa
ฑอง	Rxv
ซีงเฉีย	Qiaj
เธี้ยบ	Zyepq
ฟุป่วน	pwrng
บง	Bov
มุน	mun
ฮว้วด	Wrtq
ย้าบ	yaapq
เฮ้ย	heiq
ก๊องหฌาว	Faauj
โย่ว	yrub
วัก	wakq
ชบ	Qopq
หญับ	Eapg
นุ	nuq
หญ่าง	Eaavg
ลาน	laan
ลยา	lyaa
ล์อ	lxd
เดี๊ยบ	Dyepq
เหฌียว	Fruj
ลม	lom
ฒด	zotq
ตี๊	tiq
จ่ม	Jomg
ฟิด	fitq
ฟิด	fitq
ท่าย	Taaib
ญ่าน	Eaanb
เหลาะ	lxg
หฮงง	Vovj
หฮงง	Vovj
หนาบ	naapg
คอย	Kxi
เบี๊ยน	Byenq
ตั๊ง	tavq
เคาะ	Kxq
ตะค้ม	taKomq
ตะจุ้ย	taJwib
ยา​เค	yaaKe
อา​กู	aaku
อิ​ที​เอน	iTien
อิ​ที​เอน	iTien
อู​คาน	uKaan
เล​มู​เอน	lemuen
หมวัง	mwavj
เซียง	syav
เญย	Eei
เญา	Eau
สาว	saauj
แล์ง	lcvd
เอ๊าะ	xq
นาง	naav
ดาง	Daav
ซา​โลน	saalon
จั๋น	Janb
มวั์ง	mwavd
เหาะ	hxg
เหาะ	hxg
จิ่ว	Jiug
จิ่ว	Jiug
เปว่ย	pweig
ฮววน	Wrn
ไบ๊	Baiq
เฟย	fei
อัน​มัน	anman
เญว์ย	Eweid
ซู​เลม	sulem
ซู​เลม	sulem
ฆอย	Gxi
หละเปย๊ยแบ๋ง	Bcvj
สี่ต้อง	txvb
ปี๋งเธี้ยว	Zyruq
ฑง	Rov
เปย๊าฮวาง	Waav
กาม	kaam
ม์อง	mxvd
ววมต้ม	tomb
หฒวน	zwrnj
เหนย	neij
เล​มา​ลิ​ยา	lemaaliyaa
ดา​มัด​กัด	Daamatqkatg
ฟิ้ว	muvd
ฟิ้ว	mweid
มา​เฮ​ซา​ลาน​หัด​บัด’	maahesaalaanhatgBatg’
มา’	maa’
ตาวน่อม	nxmb
เอ​ฟา​อิม	efaaim
คาน​โน	Kaanno
แป่งง์าย	vaaid
เดี๋ยงด๋น	Donj
ไอ​ย้าด	aiyaatq
มัด​เม​นา	matqmenaa
เก​บิม	keBim
บา​บี​โลน	BaaBilon
โม​อับ	moapg
อาน	aan
โม​อับ	moapg
เอก​ลา​อิม	ekglaaim
เบ​เอ​เอ​ลิม	Beeelim
คีน​หะ​เล​เซ้ด	Kinhaalesetq
ต๊อ	txq
ไน​อา	naiaa
บัด	Batg
อี​ยิบ	iyipq
อัด​ซี​เลีย	atgsilia
ฮยวังเฮยี้ยน	Ywavb
หม่าย	myenb
ต๋อย	txij
เซ้บ​นา	sepqnaa
ไลหฮนาง	Naavj
เล​วี​อา​ทาน	lewiaaTaan
อา​ลี​เอน	aalien
อา​ลี​เอน	aalien
ฒิบ	zipq
บ๋อง	Bxvj
โซว	sru
หละงบ	lavopq
หนาน	naanj
หฑยาวเจี๊ยะ	Jiaq
สิ​โอน	sion
อะลั่น	alanb
คู่	Kub
เฑวย	Rwei
หฌุ่น	Fung
กั๊วะ	kuaq
อิ​สะ​ยา	isaayaa
เทย	Tei
ดูง	Duv
ไซ​ปัด	saipatg
หล่ม	lomg
หัว	huaj
ฆวิน	Gwin
แปะๆ	pcg
โล	lo
กุ	kug
ญิม	Eim
เล่ย	leib
ฟาน​เกน​เซน	Zauj
ตี๊	tiq
เปี๊ยวจ้อย	Jxib
เปี๊ยว	pyruq
ญั่นๆ	Eanb
เฑียววม	Riab
สะบู	lovg
เฒี่ยน’	zyenb’
ซาว	saau
เลี์ยว	lyrud
พิด	Pitq
อ๊ะ’	aq’
โล์แกง	kcv
ธุย	Zwi
เหฮยียน	Yenj
เลี่ยม	lyemb
ยู​เฟ​ติด	yufetitg
ดะม่าว	Damaaub
หฒุน	zunj
นิน	nin
เนีย	nia
บา​อัน	Baaan
เนียหะโล่ว	halrub
กับ	puab
ปั์วเหฒา	zauj
กับ	kapg
อ๊ะโล่ะ	aq
มัน​คี​อา	manKiaa
โย​สิ​ยา	yosiyaa
สี​ดา	sijDaa
ปย๊บ	pyopq
กว๊าด	kwaatq
กะน้าย’	kanaaiq’
อัด​เค​โลน	atgKelon
หฒวัง	zwavj
อุ​ลี​อา	uliaa
เอ​ลา​ซา	elaasaa
เก​มา​ลิ​ยา	kemaaliyaa
โค​ลา​ยา	Kolaayaa
เน​เฮ​ลาม	nehelaam
เส​ฟัน​ยา	sejfanyaa
เน​เฮ​ลาม	nehelaam
หฒุด	zutg
ปู๋งหฒัวะ	puvb
หฌาว	Faauj
โก​อา	koaa
เส​เด​คี​ยา	sejDeKiyaa
เคน​เดีย	KenDia
อิก​ดา​ลิ​ยา	ikgDaaliyaa
ฉง	Qovj
เน​ลิ​ยา	neliyaa
บา​ลุก	Baalukq
เก๊าะเมี่ยน	kxg
บา​ลุก	Baalukq
บา​ลุก	Baalukq
หมัด	matg
บา​ลุก	Baalukq
โค​นิ​ยา	Koniyaa
เย​ฮู​คัน	yehuKan
เบน​ยา​มิน	Benyaamin
อิ​ลี​ยา	iliyaa
มัด​ทาน	matqTaan
เอ​เบด​เม​เล้ก	eBetgmelekq
เอ​เบด​เม​เล้ก	eBetgmelekq
เอ​เบด​เม​เล้ก	eBetgmelekq
เย​เล​มี	yelemi
เน​กัน​ซา​เล​เซ	nekansaalese
สัม​กา​เน​โบ	samjkaaneBo
สาน​เส​คิม	saanjsejKim
เน​กัน​ซา​เล​เซ	nekansaalese
ปั๊ว	puaq
คา​เล​อา	Kaaleaa
ทัน​หุ​เม้ด	Tanhumetq
เอ​ฟาย	efaai
เย​ซัน​ยา	yesanyaa
คา​เล​อา	Kaaleaa
เก​ดา​ลิ​ยา	keDaaliyaa
ปิ่น	ping
ทา​ปาน​เหด	Taapaanhetg
ทา​ปาน​เหด	Taapaanhetg
ปะไน่	panaib
เหฑี่ยง	Ryavg
เมม​ฟิด	memfitq
อา​ปิด	aapitg
เฮลี้ยว	Lyruq
อัด​เค​โลน	Zauj
คี​ลิ​ยา​ทา​อิม	KiliyaaTaaim
มัด​เมน	matqmen
ลู​หิด	luhitg
โฮ​โล​นา​อิม	holonaaim
เค​โม้ด	Kemotq
ดี​โบน	DiBon
เบด​ดิบ​ลา​ทา​อิม	BetgDipglaaTaaim
คี​ลิ​ยา​ทา​อิม	KiliyaaTaaim
เบด​กา​มุน	Betgkaamun
เบด​เม​โอน	Betgmeon
หฌัง	Favj
สิบ​มา	sipgmaa
ยา​เซ	yaase
เอ​เล​อา​เล	eleaale
โฮ​โล​นา​อิม	holonaaim
เอก​ลัด​เซ​ลี​ซี​ยา	ekglatqselisiyaa
นิม​ลิม	nimlim
เอ​โดม	eDom
เอ​โดม	eDom
เอ​ลาม	elaam
ดุย	Dwi
เจียมฒ้าน	Jyemb
ดิน	Din
ฟองธัง	fxvb
ด่ง	Jopg
ฝูง	fuvj
บา​บี​โลน	BaaBilon
เบน	Ben
มา​เส​ยา	maasejyaa
เฒ่ม	zemb
เบี้ยว	Byrub
เหฮลง	Levj
ฌ์ง	Fovd
เน​บู​คัด​เน้ด​ซา	neBuKatqnetqsaa
หฮญัง	Havj
หฒุ่น	zung
เญว่ย	Eweib
เหฒีย	ziaj
เม์ว	meud
หละฟับ	lafapq
หฌับ	Fapg
หฌับ	Fapg
มฆ้อง	mGxvq
ป๊วนกั๊วะ	pwrnb
ฒิ	ziq
ฮบ	hopq
แซงฮม์	scvb
เยียม	yem
ปั์ว	puad
เยี่ยน	yenb
เค​บา	KeBaa
เค​บา	KeBaa
ยา​อา​ซัน​ยา	yaaaasanyaa
แธง	Zcv
เว้ด	wetq
ลุยจั๊วะ	lwib
ตี่ง	tivg
ปยุ้ย	pywib
เตี๊ย	tiaq
ฮู่ง	huvb
คู้	Kuq
บา​มา	Baamaa
ฑุน	Run
ไพ้	Paiq
ไพ้	Paiq
ทับ	Tapq
เท้า	Tauq
เหฑียว	Ryruj
ไบ๋	Baij
โอ​โฮ​ลา	oholaa
โอ​โฮ​ลี​บา	oholiBaa
โอ​โฮ​ลา	oholaa
โอ​โฮ​ลี​บา	oholiBaa
โอ​โฮ​ลา	oholaa
โอ​โฮ​ลี​บา	oholiBaa
โหยว	yruj
โอ​โฮ​ลา	oholaa
โอ​โฮ​ลี​บา	oholiBaa
โอ​โฮ​ลี	oholi
โอ​โฮ​ลี​บา	oholiBaa
เอ​เส​เคน	esejKen
เบด​โท​กาน​มา	BetgTokaanmaa
กาน​บุน	kaanBun
ฆาน	Gaan
หัว	huaj
หัว	huaj
ป่าย	paaig
เอ​ที​โอ​เปีย	eTiopia
เป​ลู​เซียม	pelusyem
เป​ลู​เซียม	pelusyem
โอน	on
พี​เบ​เสด	PiBesetg
แซงเธี้ยด	scvb
พะเลน	Palen
เดี๋ยงเตว๊ย	tweiq
เอ​เดน	Zauj
หงว่าย	vwaaig
ด่ง	Dovg
โหฌะ	Fog
เบ๋ง	Bevj
เมี้ยเธี้ยง	miab
นะ	naq
ยั่ง	yavb
ปะลี้ก	palikq
ปะล้อก	palxkq
บู๊ง	Buvq
โกก	kokg
โกก	aab
โกก	kokg
โกก	kokg
ฒ่าง	txvj
ธ้าง	tovb
ลู้	tovb
หลาด	laatg
ติ่ม	timg
หลาด	laatg
เดาะ	Dxg
หลาด	laatg
ปูง	puv
ฉง	Qovj
เดี้ยว	Dyrub
ฑั่ง	Ravb
เฒย	zei
ฑั่ง	Ravb
สีง	sivj
บัด	Batg
โฮ​เม	home
โฮ​เม	home
โฮ​เม	home
เซ​เขน	seKenj
เซ​เขน	seKenj
เซ​เขน	seKenj
เซ​เขน	seKenj
เซ​เขน	seKenj
มี​นา	minaa
เซ​เขน	seKenj
โฮ​เม	home
โฮ​เม	home
เหยียด	yetg
โฮ​เม	home
ห่อ	hxg
ท้ง	Tovq
เฒี่ยว	zyrub
อัด​เป​นัด	atgpenatq
ฮัน​นัน​ยา	hannanyaa
ดา​นี​เอน	Daanien
ไล	lai
เบ๋ย	Beij
เบ๋ย	Beij
ดา​นี​เอน	Daanien
เบน​เท​ซัด​ซา	BenTesatqsaa
ปะไน่	panaib
ดา​นี​เอน	Daanien
ซัด​ลัก	satqlakq
เม​ซ้าก	mesaakq
อา​เบด​เน​โก	aaBetgneko
ฒุ่น	zunb
อา​เบด​เน​โก	aaBetgneko
อา​เบด​เน​โก	aaBetgneko
อา​เบด​เน​โก	aaBetgneko
เฮญี้ยว	Hruq
เบน​ซัด​ซา	Bensatqsaa
เบน​ซัด​ซา	Bensatqsaa
ไต๋	taij
เลี่ยว	lyrub
เบน​ซัด​ซา	Bensatqsaa
เม​เน	mene
เม​เน	mene
เท​เคน	TeKen
ปา​ซิน	paasin
ปา​ซิน	paasin
ดา​ลิ​อัด	Daaliatg
ด๊าด	Daatq
เต้า	taub
ตะเฝย	tafeij
อู​ไล	ulai
อู​ไล	ulai
กา​เบ​เลียน	kaaBelyen
ม่ง	movb
ไท​กิด	Taikitg
ถิว	Tiuj
เย​เล​โบ​อัม	yeleBoam
โฮ​เซ​ยา	hoseyaa
ดิบ​ลา​อิม	Dipglaaim
โก​เม	kome
โล​ลุ​หะ​มา	loluhaamaa
โล​อัม​มี	loammi
อัม​มี	ammi
ลู​ฮา​มา	luhaamaa
หล่ม	lomb
อา​โค	aaKo
เบด​อา​เวน	Betgaawen
ซัน​มัน	sanman
เบด​อาน​เบน	BetgaanBen
เปี๊ยด	pyetq
เบย้า	Byaub
ลิ่ม	limb
อา​โม้ด	aamotq
อา​โม้ด	aamotq
อา​เวน	aawen
เบด​เอ​เดน	BetgeDen
กา​ซา	kaasaa
เค​ลิ​โอด	Keliotg
ธี้	Ziq
ลี้	liq
กิน​กาน	kinkaan
คาน​นา​อิม	Kaannaaim
มวั้ง	mwavq
ฟี​นี​เซีย	finisia
สา​เล​ฟัด	saajlefatq
เส​ฟา​ล้าด	sejfaalaatq
อา​มิด​ไท	aamitqTai
โย​นา	yonaa
โย​นา	yonaa
ปิ้ว	piub
นิ​นะ​เว	ninaawe
ซา​ฟี	saafi
ซา​นัน	saanan
เบด​เอ​เซน	Betgesen
มา​โล้ด	maalotq
ง์อง	vxvd
หฆัน	Ganj
ดุ้น	Dunb
เปย๊ยเฒ้ย	pyeib
เอน​โขด	enKotg
นา​ฮูม	naahum
เซี่ยน	syenb
ลิ​เบีย	liBia
หญอ	Exj
ฮา​บา​กุก	haaBaakukg
พ้วด	Pwrtq
ซิ​กิ​โอ​โน้ด	sikionotq
คู​ซี	Kusi
เฒี้ยง	zyavq
มิน​โคม	minKom
ติ๊วโหฌะ	tiub
จายห่อง	hxvg
เปย๊าบาง	Baav
ฌังหล่าง	Favb
ฮัก​ไก	hakqkai
อิ​สะลา​เอน	isaalaaen
โย​ซู​วา	yosuwaa
หฆาย	Gaaij
โย​ซา​ดัด	yosaaDatg
หลอบ	lxpg
ฝีง	fivj
หนาน	naanj
เสย	seij
ไธต๋อย	Zaib
ตุ๊	log
เป​เล้ด	peletq
เฮ้ด​โลน	hetqlon
ลาม	laam
โบ​อาด	Boaatg
เจียด​ซี	Jyetgsi
เซ​อัน​ทิ​เอน	seanTien
อา​บี​ยุด	aaBiyutq
อา​บี​ยุด	aaBiyutq
เอ​ลี​ยา​คิม	eliyaaKim
อา​ซอ	aasx
อา​ซอ	aasx
อา​คิม	aaKim
อา​คิม	aaKim
เอ​ลี​อูด	eliutg
เอ​ลี​อูด	eliutg
มัด​ทาน	matqTaan
โย​เซ้บ	yosepq
มา​ลี​ยา	maaliyaa
มา​ลี​ยา	maaliyaa
เย​ซู	yesu
เย​ซู	yesu
กี​ตู่	kitug
มา​ลี​ยา	maaliyaa
เย​ซู	yesu
อี​มา​นู​เอน	imaanuen
เอ๋ย	eij
เฮ​โล้ด	helotq
เฮ่น	henb
ยู​เดีย	yuDia
นา​ซา​เล้ด	naasaaletq
นา​ซา​เล้ด	naasaaletq
โย​ฮัน	yohan
โย​ฮัน	yohan
โย​ฮัน	yohan
โย​ฮัน	yohan
โย​ฮัน	yohan
หฑบ	Ropg
ตอน	txnb
เส​เบ​ดี	sejBeDi
ยา​กอบ	yaakxpg
โท้ด​บุ​ลี	TotqBuli
ฆบ	Gopq
ป้าย	paaib
หญัวะ	Euag
หญัวะ	Euag
กี​โล	kilo
กี​โล	kilo
พาน	Paan
ไป่	paig
โปว	pru
โม์ว	mrud
ฮลาว	Laau
แง้ง	vcvq
แง้ง	vcvq
ล์ม	lomd
ล์ม	lomd
ตู์ง	tuvd
ตู์ง	tuvd
ตู์ง	tuvd
ตู์ง	tuvd
ขัม	Kamj
มเต้า	mtaub
ฟี​ลิบ	filipq
บา​โท​โล​มิว	BaaTolomiu
โท​มัด	Tomatq
มัด​ทาย	matqTaai
อัน​เฟ​อัด	anfeatg
ทัด​เด​อัด	TatqDeatg
ซี​โมน	simon
ยู​ดาด	yuDaatg
อิ​สะ​คา​ลิ​โอด	isaaKaaliotg
เหญ่ย	Eeig
เธี่ยว	Zyrub
ตุ่น	tung
เธี่ยว	Zyrub
ตุ่น	tung
โตะ	tog
มน่อม	mnxmb
เฮง	hev
ฟา​ลิ​สี	faalisij
ฟา​ลิ​สี	faalisij
เมี้ยน	myenq
เบ​เอน​เซ​บูน	BeenseBun
ซา​ตาน	saataan
ฑด	Rotq
แหล่ง	lcvg
แหล่ง	lcvg
เฮ​โล​เดียด	heloDyetg
เย​ซู	yesu
เบย์าตอน	txn
สะ​ดู​สี	saaDusij
สะ​ดู​สี	saaDusij
ปี​เต	pite
ปี​เต	pite
ไซ	saib
ฝุเจว๊ย	fuJweiq
จั๊ว	Juaq
จั๊ว	Juaq
ซา	saa
เบ​ทา​นี	BeTaani
ซี​ซา	sisaa
ซี​ซา	sisaa
ซี​ซา	sisaa
สะ​ดู​สี	saaDusij
ตะไหน	tanaij
เล้า	lauq
ซาน	saan
เล้า	lauq
หธี่	Zig
เฒี้ยว’	zyruq’
เต้า’	taub’
กี​ตู่	kitug
แหมะ	mcg
ฮ์า	haad
คา​ยา​ฟ้าด	Kaayaafaatq
ฒอง	zxvb
แอ๋	cj
โด๊ว	Druq
ปี​เต	pite
โล​มา	lomaa
ปี​ล้าด	pilaatq
ยู​ดาด	yuDaatg
เดา	Dau
ปี​ล้าด	pilaatq
ปี​ล้าด	pilaatq
ปี​ล้าด	pilaatq
ฒุ์ย	zwib
บา​ลับ​บัด	BaalapqBatg
ปี​ล้าด	pilaatq
บา​ลับ​บัด	BaalapqBatg
ปี​ล้าด	pilaatq
ปี​ล้าด	pilaatq
บา​ลับ​บัด	BaalapqBatg
ปี​ล้าด	pilaatq
บา​ลับ​บัด	BaalapqBatg
ปี​ล้าด	pilaatq
ปี​ล้าด	pilaatq
ปี​ล้าด	pilaatq
ปี​ล้าด	pilaatq
กวัด	kwatg
ไซ​ลีน	sailin
ซี​โมน	simon
เอ​ลี	eli
ลา​มา​ซา​บัก​ทา​นี	laamaasaaBakgTaani
มัก​ดา​ลา	makqDaalaa
ปี​ล้าด	pilaatq
ปี​ล้าด	pilaatq
มัก​ดา​ลา	makqDaalaa
ปี​ล้าด	pilaatq
อัน​ดา​ลู	anDaalu
คา​เป​นา​อุม	Kaapenaaum
อิ​ดู​เม​อา	iDumeaa
เย​ซู	yesu
เย​ซู	yesu
โบ​อา​เน​เย	Boaaneye
เย​ซู	yesu
ไกว๊	kwaiq
ฮ์า	haad
มิ่ว	miub
ฆ์ม	Gomd
ล์าง	laavd
เฮ​โล้ด	helotq
บ์ม	Bomd
เหฮยียน	Yenj
เบด​ไซ​ดา	BetgsaiDaa
โม​เซ	mose
บา​ทิ​เม​อัด	BaaTimeatg
โฮ​ซา​นา	hosaanaa
โล​มา	lomaa
กีง	kiv
นา​ดา	naaDaa
ผง	Povj
อา​เล้ก​ซาน​เด	aalekqsaanDe
ลู​ฟัด	lufatq
เอ​โล​อี	eloi
เอ​โล​อี	eloi
โย​เสด	yosetg
สะ​โล​เม	saalome
ทุย	Twi
เส​คา	sejKaaliyaa
เส​คา​ลิ​ยา	sejKaaliyaa
อู๊	uq
เอ​ลี​ซา​เบด	elisaaBetg
เอ​ลี​ซา​เบด	elisaaBetg
อัน​นา	annaa
ฟา​นู​เอน	faanuen
อัน​นา	annaa
ทิ​เบ​ลิ​อัด	TiBeliatg
ปอน​ทิ​อัด	pxnTiatg
อิ​ทู​เลีย	iTulia
ตา​โค​นิ​ติด	taaKonititg
ลี​ซา​เนี้ยด	lisaanyetq
อา​บี​เลน	aaBilen
เฮ​ลี	heli
เฮ​ลี	heli
มัด​ทัด	matqTatq
มัด​ทัด	matqTatq
เมน​คี	menKi
เมน​คี	menKi
ยัน​นาย	yannaai
ยัน​นาย	yannaai
มัด​ทา​ที​อัด	matqTaaTiatg
มัด​ทา​ที​อัด	matqTaaTiatg
นา​ฮูม	naahum
เอด​ลี	etgli
เอด​ลี	etgli
นัก​กาย	nakqkaai
นัก​กาย	nakqkaai
มา​อาด	maaaatg
มา​อาด	maaaatg
มัด​ทา​ที​อัด	matqTaaTiatg
มัด​ทา​ที​อัด	matqTaaTiatg
เส​เม​อิน	sejmein
เส​เม​อิน	sejmein
โย​เสก	yosekg
โย​เสก	yosekg
โย​ดา	yoDaa
โย​ดา	yoDaa
โย​อา​นัน	yoaanan
โย​อา​นัน	yoaanan
เล​ซา	lesaa
เล​ซา	lesaa
เน​ลี	neli
เน​ลี	neli
เมน​คี	menKi
เมน​คี	menKi
อัด​ดี	atgDi
อัด​ดี	atgDi
โค​สัม	Kosamj
โค​สัม	Kosamj
เอน​มา​ดัม	enmaaDam
เอน​มา​ดัม	enmaaDam
เอ​อา	eaa
เอ​ลี​เย​เซ	eliyese
โย​ลิม	yolim
โย​ลิม	yolim
มัด​ทัด	matqTatq
มัด​ทัด	matqTatq
สิ​เม​โอน	simeon
โย​นาม	yonaam
โย​นาม	yonaam
เม​เล​อา	meleaa
เม​เล​อา	meleaa
เมน​นา	mennaa
เมน​นา	mennaa
มัด​ตะ​ทา	matqtaaTaa
มัด​ตะ​ทา	matqtaaTaa
อัด​มิน	atgmin
อัด​มิน	atgmin
อาน​นี	aanni
อาน​นี	aanni
อับ​ลา​ฮัม	apglaaham
นา​โฮ	naaho
เส​ลุก	sejlukq
เล​อู	leu
เป​เล้ก	pelekq
เอ​เบ	eBe
ไค​นาน	Kainaan
ไค​นาน	Kainaan
อาน​ฟา​ซัด	aanfaasatq
ลา​เม้ก	laamekq
ยา​เล้ด	yaaletq
มา​หะ​ลา​เล​เอน	maahaalaaleen
มา​หะ​ลา​เล​เอน	maahaalaaleen
เอ​โน้ด	enotq
อา​ดัม	aaDam
นี่	nib
เหฆวก	Gwekg
ซี​โมน	simon
ปี​เต	pite
หฒั่ง	zavg
เต้า	taub
หนีง	nivj
เก​ลา​ซา	kelaasaa
ไย​ลัด	yailatq
ปี​เต	pite
เธียว	Zyru
สะ​มา​เลีย	saamaalia
แท้บ	Tcpq
เปย๊าเฒี้ยว	pyaub
มา​ทา	maaTaa
ด้าง	Daavb
สัม	samj
กา​ลิ​ลี	kaalili
สี​โล​อัม	sijloam
ยวัง	ywav
ปู๋ง	puvj
บ๊วน	Bwrnq
เปียะ	piag
ฮนาง	Naav
หว่าน	waang
ฮี่ง	hivb
ป๋วน	pwrnj
โห่ว	hrug
ธุ	’
แฒะตาน	taan
ลา​ซา​ลัด	laasaalatq
กง	kovb
โฒ่	zob
สัก​เคี้ยด	sakgKyetq
’	’
สิ	sig
มา​ลี	maali
หญม	Eomj
เลา	lau
ตี่	tig
เฮ​โล้ด	helotq
คี่	Kib
ค้าด	Kaatq
เคน​โอ​ปัด	Kenopatg
ดั้น	Danb
ล์าง	laavb
อัน​ดา​ลู	anDaalu
เค​ฟ้าด	Kefaatq
เค​ฟ้าด	Kefaatq
ฟี​ลิบ	filipq
นา​ทา​นา​เอน	naaTaanaaen
นา​ทา​นา​เอน	naaTaanaaen
ก๊บ	kopq
นี​โค​เด​มัด	niKoDematq
ลี่ง	livb
นี​โค​เด​มัด	niKoDematq
อาย​โนน	aainon
สา​ลิม	saajlim
สิ​คา	siKaa
ยิว​ไท	yiuTai
คา​นา	Kaanaa
คา​เป​นา​อุม	Kaapenaaum
จิ่ว	Jiug
ลาย	laai
งี่	vib
หงูง	vuvj
สูง	suvj
ซับ	sapq
บอ	Bx
สูง	suvj
ซับ	sapq
กา	yem
ลิ​ลี	kaalili
ฟา​ลิ​สี	faalisij
เย​ซู	yesu
ลา​ซา​ลัด	laasaalatq
ลา​ซา​ลัด	laasaalatq
มา​ทา	maaTaa
มา​ทา	maaTaa
ลา​ซา​ลัด	laasaalatq
คา​ยา​ฟ้าด	Kaayaafaatq
สี่’	sig’
มเหฑีย	mRiaj
พ้าย	Paaiq
ยู​ดาด	yuDaatg
เสียน	syenj
ล่าน	laanb
เล่า’	laub’
ฮิ้ว	hiuq
เตีย	tia
บัม	Bam
มัน​คัด	manKatq
อัน​น้าด	annaatq
ป้าย	paaib
ป้าย	paaib
ลา​ติน	laatin
เท​โอ​ฟี​ลัด	Teofilatq
อา​เคน​ดา​มา	aaKenDaamaa
เพน​เท​ค้อด	PenTeKxtq
เอ๊	eq
อา​นา​เนีย	aanaania
สับ​ฟี​ลา	sapgfilaa
อา​นา​เนีย	aanaania
ทิม	Tim
สะ​เท​เฟน	saaTefen
สะ​เท​เฟน	saaTefen
โป​โค​ลัด	poKolatq
นิ​คา​โน	niKaano
ทิ​โมน	Timon
ปาน​เม​นัด	paanmenatq
อัน​ที​โอก	anTiokg
นี​โค​เลา	niKolau
ตับ	tapg
ตับ	tapg
เธ้ย	Zeiq
ฌี่	Fib
หฌูง	Fuvj
หฌุด	Futg
ชะ’	Qaq’
เซา​โล	saulo
ไอ​เน​อัด	aineatg
ไอ​เน​อัด	aineatg
ลิด​ดา	litqDaa
ลิด​ดา	litqDaa
ยับ​ฟา	yapqfaa
ลิด​ดา	litqDaa
ซั่ม	samb
โค​เน​ลิ​อัด	Koneliatg
โค​เน​ลิ​อัด	Koneliatg
ซี​ซา​ลี​ยา	sisaaliyaa
บา​นา​บัด	BaanaaBatg
บา​นา​บัด	BaanaaBatg
ทา​ซัด	Taasatq
อา​กา​บัด	aakaaBatg
คา​ลาว​ดิ​อัด	KaalaauDiatg
ฒิ่ว	ziub
มา​โค	maaKo
โล​ดา	loDaa
มา​โค	maaKo
เอ​ลี​ม้าด	elimaatq
อ๋อม	xmj
ฮลัว	Lua
เปา​โล	paulo
เปา​โล	paulo
อี​โค​นี​ยูม	iKoniyum
ซุด	sutq
เฮ​เม้ด	hemetq
อี​โค​นี​ยูม	iKoniyum
เป​กา	pekaa
อัด​ทา​ลิ​ยา	atgTaaliyaa
ซี​ลา	silaa
มา​ซี​โด​เนีย	maasiDonia
เปา​โล	paulo
ซี​ลา	silaa
อัม​ฟี​บุ​ลี	amfiBuli
อา​ปอ​โล​เนีย	aapxlonia
เท​สะ​โล​นิ​กา	Tesaalonikaa
ยา​โสน	yaasonj
ฟ้าน	faanq
ยา​โสน	yaasonj
อา​เทน	aaTen
ทิ​โม​ไท	TimoTai
อา​เล​โอ​ปา​กัด	aaleopaakatg
อา​เทน	aaTen
เฟียว	fyru
โค​ลิน​โท	KolinTo
ทิ​ทิ​อัด​ยุ​สะ​ทัด	TiTiatgyusaaTatq
คะ​ลิด​ปัด	Kaalitqpatg
โค​ลิน​โท	KolinTo
กัน​ลิ​โอ	kanlio
อา​คา​ยา	aaKaayaa
กัน​ลิ​โอ	kanlio
กัน​ลิ​โอ	kanlio
เอ​เฟ​โซ	efeso
ปิด​สิน​ลา	pitgsinjlaa
อา​ควิน​ลา	aaKwinlaa
เอ​เฟ​โซ	efeso
อา​ปอ​โล	aapxlo
ปิด​สิน​ลา	pitgsinjlaa
อา​ควิน​ลา	aaKwinlaa
เส​วา	sejwaa
อาน​เท​มิด	aanTemitq
เอ​เซีย	esia
อา​เล้ก​ซาน​เด	aalekqsaanDe
เด​เม้ด​ลิ​อัด	Demetqliatg
เบ​โล​อา	Beloaa
ปี​ลัด	pilatq
โส​ปา​เท	sojpaaTe
อา​ลิด​ทา​คัด	aalitqTaaKatq
เส​คุน​ดัด	sejKunDatg
กาย​อัด	kaaiatg
ที​คิ​กัด	TiKikatg
โต​ฟี​มัด	tofimatq
โต​อัด	toatg
ยู​ทิ​กัด	yuTikatg
ยู​ทิ​กัด	yuTikatg
อัด​โสด	atgsotg
อัด​โสด	atgsotg
มิ​ทิ​เล​นี	miTileni
ซี​ลี​เซีย	silisia
เปา​โล	paulo
เฟ​ลิก	felikq
เฟ​ลิก	felikq
คา​ลาว​ดิ​อัด	KaalaauDiatg
ลี​เซี้ยด	lisyetq
หฒี่	zig
เท​ทู​ลัด	TeTulatq
ปอ​สิ​อัด	pxsiatg
เฟ​สะ​ทัด	fesaaTatq
เฟ​สะ​ทัด	fesaaTatq
เฟ​สะ​ทัด	fesaaTatq
เฟ​สะ​ทัด	fesaaTatq
อา​ฆี​พา	aaGiPaa
เบ​นิด	Benitq
อา​ฆี​พา	aaGiPaa
เฟ​สะ​ทัด	fesaaTatq
อา​ฆี​พา	aaGiPaa
อี๊	iq
ธ่ง	Zovb
ฒั่ม	zamb
ฒั่ม	zamb
ปุบ​ลิ​อัด	pupgliatg
เฝีย	fiaj
ไซ​ลา​คิว	sailaaKiu
เล​ยี​อูม	leyium
ปู​ที​โอ​ลี	puTioli
มเซียะ	msiaq
ยิว​ไท	yiuTai
อับ​ลา​ฮัม	apglaaham
วิน	winb
วั้ง	wavq
กี​ตู่	kitug
อา	aa
ไหฑ่	Raig
เอน	en
ต้า	taab
สะ​เปน	saapen
สะ​เปน	saapen
สะ​เปน	saapen
อา​เปน​เล้ด	aapenletq
อา​ลิด​โท​บู​ลัด	aalitqToBulatq
ตี​เฟ​นา	tifenaa
ตี​โฟ​สา	tifosaaj
เป​สิด	pesitg
ลู​ฟัด	lufatq
ฟี​โล​โล​กัด	filolokatg
ยู​เลีย	yulia
เน​เล​อัด	neleatg
โอ​ลิม​ปัด	olimpatg
ลู​สิ​อัด	lusiatg
โส​สิ​ปา​เท	sojsipaaTe
เท​ทิ​อัด	TeTiatg
โอ้	ob
สะ​เท​ฟา​นัด	saaTefaanatq
อา​ปอ​โล	aapxlo
หฒ่าน	zaang
หฒ่าน	zaang
เฒี่ยน	zyenb
หย่า	yaag
เฒี่ยน	zyenb
เฒี้ยว	zyruq
ธั้ม	Zamq
โน่ว	nrub
ฮน้ม	Nomq
ฑยาว	Ryaau
กวาน	kwaan
มา​ซี​โด​เนีย	maasiDonia
ฟอ​ทู​นา​ทัด	fxTunaaTatq
อา​คาย​คัด	aaKaaiKatq
เต๋ย	teij
กี​ตู่	kitug
เบ​ลี​อัน	Belian
ตะก้อย	takxib
ทิ​ตัด	Titatg
ทิ​ตัด	Titatg
ทิ​ตัด	Titatg
ปะหฮญัง	paHavj
โหฒะ	zog
เถง	Tevj
เธง	Zev
ฟุ	fuq
อา​บา	aaBaa
เขา	Kauj
ฮลัง	Lav
ฮนั้ม	Namq
ยู​โอ​เดีย	yuoDia
สิน​ทิ​เค	sinjTiKe
เคน​เมน	Kenmen
เอ​ปา​โฟ​ดิ​ทัด	epaafoDiTatq
เอ​ปา​ฟา	epaafaa
เอ​ปา​ฟา	epaafaa
ตอน	txnb
เลา​ดี​เซีย	lauDisia
ซิน	sin
ญัด	Eatq
เดี๊ยม	Dyemq
ทิน	Tinb
โหฒว	zruj
ยุ​สะ​ทัด	yusaaTatq
ต๋าย	taaij
มฌ่อม	mFxmb
น่าน	naanb
บัว	Bua
ฮี​เม​เน​อัด	himeneatg
บุด๋ง	BuDovj
ฑี์ง	Rivd
ปอง	pxvb
หลอ	lxj
เฟียม	fyem
แหฆ่ง	Gcvg
แฑง	Rcv
อิ๊น	inq
เญ้ย	Eeiq
ฟี​เจ​ลัด	fiJelatq
เฮ​โม​เก​เน้ด	hemokenetq
สาย	saaij
ฟี​เล​ทัด	fileTatq
ยัน​เน้ด	yannetq
ยัม​เบ	yamBe
เด​ม้าด	Demaatq
เค​เล​เซน	Kelesen
กา​ลา​เทีย	kaalaaTia
ดาน​มา​เทีย	DaanmaaTia
ลู​กา	lukaa
ปอง	pxv
โอ​เน​สิ​โฟ​ลัด	onesifolatq
เอ​ลัด​ทัด	elatqTatq
มิ​เล​ทัด	mileTatq
ส่วน	swrng
เส​น้าด	sejnaatq
ฟี​เล​โมน	filemon
โอ​เน​สิ​มัด	onesimatq
โอ​เน​สิ​มัด	onesimatq
โอ​เน​สิ​มัด	onesimatq
โอ​เน​สิ​มัด	onesimatq
ต๋อง	txvj
ซา​เลม	saalem
เมน​คี​เซ​เดก	menKiseDekg
ซา​เลม	saalem
ซา​เลม	saalem
เมน​คี​เซ​เดก	menKiseDekg
ฑย้าม	Ryaamq
อา​แบน	aaBcn
โม​เซ	mose
หฑุ่น	Rung
เญย	Eei
เบียด	Byetg
กั้น	kanb
เตี้ยน	tyenb
ล่าม	laamb
โก๋ว	kruj
บา​ลา​อัม	Baalaaam
ฮยวัง	Ywav
คา​อิน	Kaain
ยิว​ดา	yiuDaa
โค​ลา	Kolaa
เม้า	mauq
หนัม	namj
โก๊ว	kruq
บะเปยย	Bapyei
พยู้	Pyuq
ไฮ่	haib
ป้า	paab
ฑูง	Ruv
อา​ละ​มา​เกด​โดน	aalaamaaketgDon
เผว	Peuj
อา​เล​ลู​ยา	aaleluyaa
บ๊บ	Bopq
อัน​ฟา	anfaa
โอ​เม​กา	omekaa
เย	ເຢ
ซู	ຊູ
อา​ดัม	aadam
คา​อิน	kaain
อา​แบน	aabcn
เอ​เดน	tov
อา​ดา	aadaa
มา​หะ​ลา​เลน	maahaalaalen
เม​ทู​เส​ลา	metusejlaa
คา​นา​อัน	kaanaaan
โก​เม	kome
มา​ได	maadai
ทู​บัน	tuban
อัด​เค​นัด	atgkenatq
โท​กาน​มา	tokaanmaa
เอ​ลี​เซ​อา	eliseaa
คิด​ทิม	kitqtim
โล​ดา​นิม	lodaanim
อี​ยิบ	iyipq
เส​บา	sejbaa
ฮา​วิ​ลา	haawilaa
สับ​ทา	sapgtaa
ลา​อา​มา	laaaamaa
สับ​เท​คา	sapgtekaa
เช​บา	qebaa
เด​ดาน	dedaan
นิ​นะ​เว	ninaawe
ลู​ดิม	ludim
อา​นา​มิม	aanaamim
เล​หะ​บิม	lehaabim
นับ​ทู​ฮิม	napqtuhim
อัด​ซู	atgsu
อาน​ฟา​ซัด	aanfaasatq
ลู​เด	lude
เก​เท	kete
เอ​เบ	ebe
โย้ก​ทาน	yokqtaan
อัน​โม​ดัด	anmodatg
ฮา​ซาน​มา​เว้ด	haasaanmaawetq
ฮา​โด​ลัม	haadolam
ดิก​ลา	dikglaa
อา​บี​มา​เอน	aabimaaen
โย​บับ	yobapg
บา​เบน	baaben
เล​อู	leu
นา​โฮ	naaho
อับ​ลาม	apglaam
เบด​เอน	betgen
โส​โดม	sojdom
โก​โม​ลา	komolaa
อัด​มา	atgmaa
เส​โบ​ยิม	sejboyim
โส​อา	sojaa
อา​มา​เล้ก	aamaalekq
อา​โม​ไล	aamolai
สิด​ดิม	sitgdim
ดา​มัด​กัด	daamatqkatg
เค​โด​ลา​โอ​เม	kedolaaome
อา​เน	aane
เอด​โค	etgko
เอ​ลี​เย​เซ	eliyese
อับ​ลา​ฮัม	apglaaham
ฮิด​ไท	hitqtai
เป​ลิด​ซี	pelitqsi
เล​ฟา​อิม	lefaaim
อิ​สะ​มา​เอน	isaamaaen
เก​ลา​อา	kelaaaa
อา​บี​เม​เล้ก	aabimelekq
อี​สัก	isakg
เบ​เอ​เช​บา	beeqebaa
เบ​ทู​เอน	betuen
เล​เบ​คา	lebekaa
เฮ​โบ​โลน	hebolon
โส​หา	sojhaaj
เอ​โฟ​โลน	efolon
ลา​บาน	laabaan
เค​ทู​ลา	ketulaa
โย้ก​ซาน	yokqsaan
มิด​มา	mitqmaa
ฮา​ดัด	haadatg
เค​เด​มา	kedemaa
ฟี​ลิ​สะ​เตีย	filisaatia
เบ​เอ​ลี	beeli
บา​เส​มัด	baasejmatq
ลา​บาน	laabaan
บิน​ฮา	binhaa
เล​อา	leaa
นับ​ทา​ลี	napqtaali
สิน​ปา	sinjpaa
ดู​ดา​อิม	dudaaim
อิ​สะ​ลา​เอน	isaalaaen
เส​อี	seji
สิ​เม​โอน	simeon
เอ​ฟา​ลา​ทา	efaalaataa
เบน​ยา​มิน	benyaamin
อา​เซ	aase
เอ​ลี​ฟัด	elifatq
เล​อู​เอน	leuen
นา​หัด	naahatg
เย​อูด	yeutg
โอ​โฮ​ลี​บา​มา	oholibaamaa
เอ​โดม	edom
โซ​บาน	sobaan
มา​นา​ฮ้าด	maanaahaatq
เอ​บาน	ebaan
เอด​บาน	etgbaan
อิด​ลาน	itglaan
เอ​เซ	ese
สิ​เบ​โอน	sibeon
เอ​โดม	edom
ดิน​ฮา​บา	dinhaabaa
โบ​ซา​ลา	bosaalaa
เบ​ดัด	bedatg
โม​อับ	moapg
มี​เดียน	midyen
สัม​ลา	samjlaa
เล​โห​โบด	lehojbotg
ซา​อุน	saaun
อัก​โบ	akgbo
มิบ​ซา	mipqsaa
ลู​เบน	luben
ยู​ดา	yudaa
ชู​อา	quaa
เอ​อา	eaa
ฮิบ​ลู	hipqlu
ไน​อา	naiaa
เฮ้ด​โลน	hetqlon
เย​มู​เอน	yemuen
โอ​หาด	ohaatg
โค​ฮ้าด	kohaatq
เม​ลา​ลี	melaali
อิด​สา​คา	itgsaajkaa
เส​บู​ลุน	sejbulun
ยา​เล​เอน	yaaleen
ฮัก​กี	hakqki
เอด​โบน	etgbon
เอ​เล​อี	elei
อา​เล​ลี	aaleli
อิด​วา	itgwaa
อิด​วี	itgwi
เบ​ลี​ยา	beliyaa
เซ​ลา​อา	selaaaa
เฮ​เบ	hebe
อัด​เบน	atgben
นา​อา​มาน	naaaamaan
ยา​ซี​เอน	yaasien
มะ​นัด​เส	maanatqsej
เอ​ฟา​อิม	efaaim
จอ​แดน	jxdcn
ลิบ​นี	lipqni
ซิ​เม​อี	simei
อิด​ฮา	itghaa
สิก​ลี	sikgli
อุด​ซี​เอน	utgsien
มิ​ซา​เอน	misaaen
เอน​ซา​ฟาน	ensaafaan
นา​ดับ	naadapg
อิ​ทา​มา	itaamaa
อัด​สี	atgsij
เอน​คา​นา	enkaanaa
เอ​เล​อา​ซา	eleaasaa
ฟี​เน​หัด	finehatg
สุก​โค้ด	sukgkotq
อา​บีบ	aabipg
เล​ฟี​ดิม	lefidim
ฮู​อา	huaa
โย​ซู​วา	yosuwaa
อา​บี​ฮู	aabihu
เค​ลู​บิม	kelubim
เบ​ซา​เลน	besaalen
เย​บุด	yebutg
โอ​โฮ​ลี​อับ	oholiapg
เซ​โล​มิด	selomitq
สู​ลิ​ซัด​ได	sujlisatqdai
เซ​ลู​มิ​เอน	selumien
อัม​มี​นา​ดับ	amminaadapg
ฒู​อา	zuaa
เน​ทัน​เอน	netanen
เอ​ลี​อับ	eliapg
อัม​มี​ฮู้ด	ammihutq
เอ​ลี​ซา​มา	elisaamaa
เป​ดา​ซู	pedaasu
กา​มา​ลิ​เอน	kaamaalien
กิ​เด​โอ​นี	kideoni
อา​บี​ดัน	aabidan
อา​หิ​เย​เซ	aahiyese
ปา​กี​เอน	paakien
เด​อู​เอน	deuen
เอ​ลี​ยา​สาบ	eliyaasaapg
อา​หิ​ลา	aahilaa
เอ​ลี​ซา​ฟาน	elisaafaan
มา​นา	maanaa
สัก​เก	sakgke
ซัม​มุ​วา	sammuwaa
เย​ฟุน​เน	yefunne
อิ​กาน	ikaan
โฮ​เซ​ยา	hoseyaa
มี​คา​เอน	mikaaen
อา​บี​ลัม	aabilam
เม​ลี​บา	melibaa
คา​เดด	kaadetg
โฮ​อา	hoaa
สิ​โหน	sihonj
เฮ้ด​โบน	hetqbon
สิบ​โป	sipgpo
บา​ลา​อัม	baalaaam
บา​อัน	baaan
เบ​โอ	beo
เป​โอ	peo
สิม​ลี	simjli
โค้ด​บี	kotqbi
สู​อา	sujaa
โอด​นี	otgni
อัด​ลี​เอน	atglien
เซ​มิ​ดา	semidaa
เส​โล​เฟ​หัด	sejlofehatg
มา​ฮา​ลา	maahaalaa
โฮ้ก​ลา	hokqlaa
ที​ละ​ซา	tilaasaa
ซู​ฮัม	suham
กิ​เล​อาด	kileaatg
มา​คี​เล	maakile
อา​บา​ลิม	aabaalim
เล​บา	lebaa
มิก​โดน	mikqdon
ลิบ​นา	lipqnaa
ทา​หัด	taahatg
โย้ด​บา​ทา	yotqbaataa
โอ​โบด	obotg
เน​โบ	nebo
อัด​โมน	atgmon
เม​ดิ​เต​เล​เนียน	meditelenyen
เส​ดัด	sejdatg
บุก​คี	bukgki
ฮัน​นี​เอน	hannien
เค​มู​เอน	kemuen
ปัน​ที​เอน	pantien
อา​หิ​ฮู้ด	aahihutq
เอ​เดน​อี	edeni
อัด​ทา​โล้ด	atgtaalotq
ยา​ฮ้าด	yaahaatq
อาน​โกบ	aankopg
ไซ​ดอน	saidxn
อา​ลา​บา	aalaabaa
ปิด​กา	pitgkaa
เก​ลิ​ซิม	kelisim
ลา​หับ	laahapg
กิน​กาน	kinkaan
เย​ลี​โค	yeliko
สับ​ดี	sapgdi
กิ​เบ​โอน	kibeon
เบ​เอ​โล้ด	beelotq
เย​ลู​ซา​เลม	yelusaalem
เอก​โลน	ekglon
เด​บี	debi
อา​เซ​คา	aasekaa
มัก​เค​ดา	makqkedaa
ไอ​ยา​โลน	aiyaalon
ยา​บิน	yaabin
มา​โดน	maadon
อัก​ซ้าบ	akgsaapq
มิด​ปา	mitqpaa
อา​ดุน​ลัม	aadunlam
ทับ​ปู​วา	tapqpuwaa
เม​กิด​โด	mekitgdo
เค​เดด	kedetg
โย้ก​เน​อัม	yokqneam
มา​อา​คา	maaaakaa
สา​เล​คา	saajlekaa
เค​เด​โม้ด	kedemotq
เม​ฟา​อาด	mefaaaatg
บา​อา​ลา	baaaalaa
ทิม​นา​ฮา	timnaahaa
อัก​สา	akgsaaj
โอด​นี​เอน	otgnien
สิบ​อา	sipgaa
เบ​อา​โล้ด	beaalotq
โม​ลา​ดา	molaadaa
เอน​โท​ลัด	entolatq
สิก​ล้าก	sikglaakq
มัด​มัน​นา	matqmannaa
โบด​ค้าด	botgkaatq
เอ​เท	ete
อัด​นา	atgnaa
เอด​เท​โม​อา	etgtemoaa
มา​โอน	maaon
ยิด​เล​เอน	yitqleen
เก​โด	kedo
อา​ทา​โล้ด	aataalotq
นา​อา​ลา	naaaalaa
อับ​วิม	apgwim
โอ​ฟา​ลา	ofaalaa
คี​ซิ​โอน	kision
เอ​เบด	ebetg
คิน​เน​เล้ด	kinneletq
เอด​ทา​โอน	etgtaaon
เอ​โค​โลน	ekolon
เอน​เท​เค	enteke
กิบ​เบ​โทน	kipgbeton
บา​อา​ลัด	baaaalatq
อา​หิ​มาน	aahimaan
อัก​ซี้บ	akgsipq
เล​โหบ	lehopg
เอ​ฮู้ด	ehutq
เด​โบ​ลา	debolaa
อา​บี​โน​อัม	aabinoam
ทา​โบ	taabo
สิ​เส​ลา	sisejlaa
กิ​เด​โอน	kideon
โย​อาด	yoaatg
อา​บี​เย​เซ	aabiyese
เฒ​บา	zebaa
สัน​มุน​นา	sanjmunnaa
เป​นู​เอน	penuen
เบ​เอ	bee
เส​บุน	sejbun
กา​อัน	kaaan
เท​เบด	tebetg
จา​อี	jaai
เย้บ​ทา	yepqtaa
อา​โล​เอ	aaloe
เบด​เล​เฮม	betglehem
ปิ​ลา​โทน	pilaaton
อับ​โดน	apgdon
มา​โน​อา	maanoaa
แซม​สัน	scmsanj
เด​ลิ​ลา	delilaa
ลา​อิด	laaitg
กิ​เบ​อา	kibeaa
นา​โอ​มี	naaomi
เอ​ลี​เม​เล้ก	elimelekq
ลู​เท	lute
คิ​ลิ​โอน	kilion
โบ​อาด	boaatg
สัน​โมน	sanjmon
โอ​เบด	obetg
เจียด​ซี	jyetgsi
เป​นิน​นา	peninnaa
ซา​มู​เอน	saamuen
อัด​โดด	atgdotg
อา​บี​นา​ดับ	aabinaadapg
ยา​เบด	yaabetg
นา​หาด	naahaatg
มิก​ม้าด	mikqmaatq
ซู​อัน	suan
โย​นา​ทาน	yonaataan
อา​หิ​ยา	aahiyaa
อับ​เน	apgne
อา​บี​เอน	aabien
โก​ลิ​อัด	koliatg
ซา​อา​ลา​อิม	saaaalaaim
อา​หิ​เม​เล้ก	aahimelekq
โด​เอก	doekg
อา​หิ​ทู้บ	aahitupq
อา​บี​ยา​ทา	aabiyaataa
เค​อี​ลา	keilaa
นา​บาน	naabaan
อา​บี​กา​ยิน	aabikaayin
อา​หิ​โน​อัม	aahinoam
เส​ลุ​ยา	sejluyaa
โย​อาบ	yoaapg
อา​บี​ไช	aabiqai
กิน​โบ​อา	kinboaa
เค​เล​ที	keleti
ย้าด​ที	yaatqti
เย​ลา​เม​เอน	yelaameen
อิด​โบ​เซ้ด	itgbosetq
มา​หะ​นา​อิม	maahaanaaim
อา​สา​เฮน	aasaajhen
อา​โด​นี​ยา	aadoniyaa
ฮัก​กีด	hakqkitg
เซ​ฟา​ทิ​ยา	sefaatiyaa
กิด​ทา​อิม	kitgtaaim
บา​อา​นา	baaaanaa
ซา​โล​มอน	saalomxn
อิบ​ฮา	ipghaa
เอ​ลี​ซู​วา	elisuwaa
เอ​ลี​ยา​ดา	eliyaadaa
เอ​ลี​เฟ​เล้ด	elifeletq
เก​บา	kebaa
อุด​ซา	utgsaa
สี​ดา	sijdaa
โส​บา	sojbaa
ฮา​ดัด​เอ​เซ	haadatgese
ยู​เฟ​ติด	yufetitg
เย​โฮ​ยา​ดา	yehoyaadaa
เบ​ไน​ยา	benaiyaa
ซิ​บา	sibaa
เม​ฟี​โบ​เซ้ด	mefibosetq
บัด​เช​บา	batgqebaa
อุ​ลี​อา	uliaa
ลับ​บา	lapqbaa
อับ​ซา​โลม	apgsaalom
โย​นา​ดับ	yonaadapg
เท​โค​อา	tekoaa
อิด​ไท	itgtai
สา​โดก	saajdokg
อา​หิ​มา​อัด	aahimaaatg
อา​หิ​โท​เฟน	aahitofen
บา​ซิน​ไล	baasinlai
อา​มา​สา	aamaasaaj
บีก​ลี	bikgli
อิ​ละ	ilaa
ไอ​อา	aiaa
ลิด​ปา	litqpaa
ซี​เม​ฮา	simehaa
อา​โห​ไฮ	aahojhai
โด​โด	dodo
เอน​ฮา​นัน	enhaanan
เฮ​เล้ด​เท	heletqte
อิก​เขด	ikgketg
อา​นา​โท้ด	aanaatotq
เน​โท​ฟา	netofaa
มา​หะ​ไล	maahaalai
ลี​ไบ	libai
กา​อัด	kaaatg
บา​ฮู​ลิม	baahulim
อัด​มา​เว้ด	atgmaawetq
อา​หิ​ยัม	aahiyam
เฮ้ด​โล	hetqlo
นา​หะ​ไล	naahaalai
อิด​ไล	itglai
อุ​ลี​ยา	uliyaa
อา​ลาว​นา	aalaaunaa
อา​บี​ช้าก	aabiqaakq
อา​ซา​ลิ​ยา	aasaaliyaa
อา​หิ​ลู้ด	aahilutq
อิด​โด	itgdo
เย​โฮ​ซา​ฟัด	yehosaafatq
เล​บา​นอน	lebaanxn
อา​โด​นี​ลัม	aadonilam
สิ​โอน	sion
กา​ลิ​ลี	kaalili
ทา​เป​เน้ด	taapenetq
เย​โล​โบ​อัม	yeloboam
เล​โห​โบ​อัม	lehojboam
อา​บี​ยา	aabiyaa
เน​บัด	nebatg
อา​บี​ยัม	aabiyam
อา​บี​ชา​โลม	aabiqaalom
บา​อา​ชา	baaaaqaa
สะ​มา​เลีย	saamaalia
อา​หับ	aahapg
อา​เซ​ลา	aaselaa
เอ​ลี​ยา	eliyaa
โอ​บา​ดี	obaadi
เย​เซ​เบน	yeseben
เย​ฮู	yehu
เอ​ลี​ซา	elisaa
ฮา​ซา​เอน	haasaaen
นา​โบด	naabotg
มี​คา​ยา	mikaayaa
อา​หัด​ยา	aahatgyaa
ซิน​หิ	sinhi
อา​ซุ​บา	aasubaa
เย​โฮ​ลัม	yeholam
เก​หะ​ซี	kehaasi
เย​โฮ​อา​หาด	yehoaahaatg
อา​ทา​ลิ​ยา	aataaliyaa
เย​โฮ​อาด	yehoaatg
อา​มา​ซิ​ยา	aamaasiyaa
เส​คา​ลิ​ยา	sejkaaliyaa
อุด​ซี​ยา	utgsiyaa
กา​ดี	kaadi
เม​นา​เฮม	menaahem
อัด​ซี​เลีย	atgsilia
เป​คา​หิ​ยา	pekaahiyaa
เล​มา​ลิ​ยา	lemaaliyaa
อา​หัด	aahatg
คี​อา	kiaa
มี​เดีย	midia
บา​บี​โลน	baabilon
เส​ฟาน​วา​อิม	sejfaanwaaim
เฮ​เซ​คี​ยา	hesekiyaa
เซน​นา​เค​ลิบ	sennaakelipq
อิ​สะ​ยา	isaayaa
อิบ​วา	ipgwaa
โย​สิ​ยา	yosiyaa
อา​ดา​ยา	aadaayaa
เม​ซุน​ลาม	mesunlaam
อา​ซา​ไล​ยา	aasaalaiyaa
ฮิน​คี​ยา	hinkiyaa
อา​หิ​คัม	aahikam
อา​สา​ยา	aasaajyaa
ฮุน​ดา	hundaa
ขิด​โลน	kitglon
ฮา​มุ​ทาน	haamutaan
เย​เล​มี	yelemi
ลิบ​ลา	lipqlaa
เย​โฮ​ยา​คิม	yehoyaakim
เป​ดา​ยา	pedaayaa
เย​โฮ​ยา​คีน	yehoyaakin
เอน​นา​ทัน	ennaatan
เส​เด​คี​ยา	sejdekiyaa
มัด​สา	matqsaaj
มิด​ซา	mitqsaa
บิน​ฮาน	binhaan
สา​วาน	saajwaan
มัด​เล​คา	matqlekaa
มัก​ดี​เอน	makqdien
อิ​ลาม	ilaam
ดาน​ดา	daandaa
เย​เท	yete
อา​บี​ฮา​อิน	aabihaain
อิด​อี	itgi
อัก​ไล	akglai
สา​บาด	saajbaatg
เอ​เล​อา​สา	eleaasaaj
เย​คา​มิ​ยา	yekaamiyaa
เอ​ฟา	efaa
ซา​อับ	saaapg
ซิ​เม​อา	simeaa
เส​ลุบ​บา​เบน	sejlupqbaaben
ฮา​นัน​ยา	haananyaa
เบ​เล​คิ​ยา	belekiyaa
เป​ลา​ที​ยา	pelaatiyaa
เย​ซา​ยา	yesaayaa
เล​ไฟ​ยา	lefaiyaa
เซ​คา​นิ​ยา	sekaaniyaa
เซ​ไม​อา	semaiaa
ฮัด​ทัด	hatqtatq
เน​อา​ลี​ยา	neaaliyaa
เอ​ลี​โอ​ไน	elionai
อัด​ลี​คัม	atglikam
โฮ​ดา​วิ​ยา	hodaawiyaa
เอ​ลี​ยา​ซี้บ	eliyaasipq
เป​ไล​ยา	pelaiyaa
อัก​ขูบ	akgkupg
โย​ฮา​นัน	yohaanan
เด​ไล​ยา	delaiyaa
เล​อา​ยา	leaayaa
ยา​หาด	yaahaatg
อิด​มา	itgmaa
ปา​เส​อา	paasejaa
เส​ไล​อา	sejlaiaa
เอด​ลา	etglaa
มา​หะ​ลา​เลน	maahaalaalen
เม​ทู​เส​ลา	metusejlaa
อี​สัก	isakg
ฮา​ดัด	haadatg
ยู​ดา	yudaa
อัม​มี​นา​ดับ	amminaadapg
สัน​โมน	sanjmon
โอ​เบด	obetg
จา​อี	jaai
เย​ฮู	yehu
เล​โห​โบ​อัม	lehojboam
อา​บี​ยา	aabiyaa
อา​มา​ซิ​ยา	aamaasiyaa
อา​ซา​ลิ​ยา	aasaaliyaa
อา​หัด	aahatg
เฮ​เซ​คี​ยา	hesekiyaa
เย​โฮ​ยา​คีน	yehoyaakin
เส​ลุบ​บา​เบน	sejlupqbaaben
เย​ซา​ยา	yesaayaa
เล​ไฟ​ยา	lefaiyaa
โอ​บา​ดี	obaadi
เซ​ไม​อา	semaiaa
ยา​หาด	yaahaatg
มา​เล​ซา	maalesaa
เก​เด​ลา	kedelaa
เน​มู​เอน	nemuen
มิบ​สัม	mipqsamj
สัก​เก	sakgke
โย​เอน	yoen
อา​สิ​เอน	aasien
อา​ดี​เอน	aadien
เย​ดา​ยา	yedaayaa
กิ​เล​อาด	kileaatg
มี​คา​เอน	mikaaen
อา​หิ	aahi
เอ​ลี​เอน	elien
ฟี​เน​หัด	finehatg
อา​บี​ชู​วา	aabiquwaa
บุก​คี	bukgki
อุด​ซี	utgsi
เส​ลา​หิ​ยา	sejlaahiyaa
เส​ลา​หิ​ยา	sejlaahiyaa
เม​ลา​โย้ด	melaayotq
อา​มา​ลิ​ยา	aamaaliyaa
อา​มา​ลิ​ยา	aamaaliyaa
สา​โดก	saajdokg
ฮิน​คี​ยา	hinkiyaa
เย​โฮ​ซา​ดัก	yehosaadakg
เน​บู​คัด​เน้ด​ซา	nebukatqnetqsaa
สิม​มา	simjmaa
โย​อา	yoaa
เอน​คา​นา	enkaanaa
เอ​บี​ยา​สาบ	ebiyaasaapg
เอ​บี​ยา​สาบ	ebiyaasaapg
ทา​หัด	taahatg
อุ​ลี​เอน	ulien
อุด​ซี​ยา	utgsiyaa
เอ​ลี​อับ	eliapg
เย​โล​ฮัม	yeloham
เย​โล​ฮัม	yeloham
ซิ​เม​อา	simeaa
มา​ฮ้าด	maahaatq
อา​มา​ไส	aamaasaij
โย​เอน	yoen
เส​ฟัน​ยา	sejfanyaa
อัด​สี	atgsij
อิด​ฮา	itghaa
โค​ฮ้าด	kohaatq
เบ​เล​คิ​ยา	belekiyaa
มัน​คิ​ยา	mankiyaa
สิม​มา	simjmaa
อับ​ดี	apgdi
ฮา​ซา​ปิ​ยา	haasaapiyaa
ฮา​ซา​ปิ​ยา	haasaapiyaa
เม​ลา​ลี	melaali
อุด​ซี	utgsi
เม​ลา​โย้ด	melaayotq
ดา​เบ​ลัด	daabelatq
พู​อา	puaa
เย​ดี​ยา​เอน	yediyaaen
เย​ลี​โม้ด	yelimotq
เย​เล​โม้ด	yelemotq
อา​เล​เม้ด	aalemetq
เค​นา​อะ​นา	kenaaaanaa
หุบ​ปิม	hupgpim
ซุบ​ปิม	supqpim
ทา​ฮัน	taahan
ลา​ดาน	laadaan
ลา​ดาน	laadaan
มัน​คี​เอน	mankien
ยา​เฟ​เล้ด	yaafeletq
โซ​เม	some
อัด​ดา	atgdaa
เอน​ปา​อัน	enpaaan
อา​หิ​โย	aahiyo
เส​บา​ดิ​ยา	sejbaadiyaa
เอ​เด	ede
โย​ฮา	yohaa
สิน​เล​ไท	sinjletai
เย​อี​เอน	yeien
สิม​ลี	simjli
บิ​เน​อา	bineaa
บิ​เน​อา	bineaa
เอ​เล​อา​สา	eleaasaaj
โบ​เค​ลู	bokelu
เซ​อา​ลิ​ยา	seaaliyaa
อิ​สะ​ลา​เอน	isaalaaen
เย​อู​เอน	yeuen
สัน​ลู	sanjlu
หัด​เส​นู​อา	hatgsejnuaa
เม​ซุน​ลาม	mesunlaam
เซ​ฟา​ทิ​ยา	sefaatiyaa
เล​อู​เอน	leuen
อา​ดา​ยา	aadaayaa
ปาด​เฮ	paatghe
ปาด​เฮ	paatghe
มัน​คิ​ยา	mankiyaa
มัด​ทา​นิ​ยา	matqtaaniyaa
สิก​ลี	sikgli
เย​ดู​ทูน	yedutun
เย​ดู​ทูน	yedutun
มิก​โล้ด	mikqlotq
เย​บุด	yebutg
สิบ​เบ​ไค	sipgbekai
ซา​อัน​โบน	saaanbon
เอ​ลี​ยา​บา	eliyaabaa
อู​อา	uaa
อิด​ไล	itglai
ยา​อา​ซี​เอน	yaaaasien
เซ​มา​ลิ​ยา	semaaliyaa
อิด​ซี​ยา	itgsiyaa
อา​ซา​เลน	aasaalen
ยา​โซ​เบ​อัม	yaasobeam
อา​บี​ไช	aabiqai
เซ​โล​โม้ด	selomotq
มิ​ยา​มิน	miyaamin
ฮัก​โขด	hakqkotg
เย​ซู​อา	yesuaa
บิน​กา	binkaa
เป​ทา​หิ​ยา	petaahiyaa
มา​อา​ซิ​ยา	maaaasiyaa
ยา​อา​ซี​ยา	yaaaasiyaa
เก​ดา​ลิ​ยา	kedaaliyaa
มัด​ที​ทิ​ยา	yedutun
เซ​บู​เอน	sebuen
ฮา​นา​นี	haanaani
เย​โฮ​ฮา​นัน	yehohaanan
เฮน​ได	hendai
เอ​ลี​ฮู	elihu
อิด​ไม​อา	itgmaiaa
ซา​โล​มอน	saalomxn
ยับ​ฟา	yapqfaa
เค​ลู​บิม	kelubim
อิ​สะ​ลา​เอน	isaalaaen
ซา​โล​มอน	saalomxn
เย​โล​โบ​อัม	yeloboam
มา​หะ​ลัด	maahaalatq
เย​ลู​ซา​เลม	yelusaalem
ยู​ดา	yudaa
โอ​เดด	odetg
บา​อา​ชา	baaaaqaa
เย​โฮ​ซา​ฟัด	yehosaafatq
เน​ทา​นิ​ยา	netaaniyaa
โท​บี​ยา	tobiyaa
เย​โฮ​ซา​บาด	yehosaabaatg
อา​หับ	aahapg
ยา​ฮา​ซี​เอน	yaahaasien
เส​คา​ลิ​ยา	se
เบ​ไน​ยา	se
อา​หัด​ยา	aahatgyaa
เย​โฮ​ลัม	yeholam
เย​ฮี​เอน	yehien
เอ​ที​โอ​เปีย	etiopia
เย​ฮู	yehu
เย​โฮ​ยา​ดา	yehoyaadaa
ซิ​เม​อัด	simeatg
เย​โฮ​อาด	yehoaatg
เย​โค​ลี​ยา	yekoliyaa
ฟี​ลิ​สะ​เตีย	filisaatia
มา​อา​เส​อา	maaaasejaa
เม​ซิน​เล​โม้ด	mesinlemotq
มะ​นัด​เส	maanatqsej
โย​ซา​บาด	yosaabaatg
โย​อา​หาด	yoaahaatg
เย​เล​มี	yelemi
ฮา​ดิด	haaditg
เส​นา​อา	sejnaaaa
อาน​ทา​เซ​ซี้ด	aantaasesitq
มิด​เล​ดาด	mitqledaatg
ดา​ลิ​อัด	daaliatg
ฮัก​ไก	hakqkai
อา​หิ​ทู้บ	aahitupq
อา​บี​ชู​วา	aabiquwaa
เอ​เล​อา​ซา	eleaasaa
เอ​สะ​ลา	esaalaa
อา​หะ​วา	aahaawaa
เอ​สะ​ลา	esaalaa
ซับ​เบ​ไท	sapqbetai
เค​ลิ​ทา	kelitaa
เม​เล​โม้ด	melemotq
มัด​เท​ไน	matqtenai
เซ​เล​มิ​ยา	selemiyaa
ฮา​คา​ลิ​ยา	haakaaliyaa
เน​หะ​มี	nehaami
สัน​บาน​ลัด	sanjbaanlatq
โท​บี​อา	tobiaa
เม​เซ​ซา​เบน	mesesaaben
โย​ยา​ดา	yoyaadaa
ฮา​ซับ​เน​ยา	haasapqneyaa
หัด​ซู้บ	hatgsupq
ฮัน​โล​เหด	hanlohetg
เล​ฮูม	lehum
สับ​ไบ	sapgbai
หัด​ซู้บ	hatgsupq
เฮ​นา​ดัด	henaadatg
โท​บี​อา	tobiaa
โม​เด​ไค	modekai
บิก​ไว	bikgwai
ขัด​มี​เอน	katgmien
เช​บา​นี​ยา	qebaaniyaa
เซ​เล​ปี​ยา	selepiyaa
โฮ​ดี​ยา	hodiyaa
ดา​นี​เอน	daanien
กิน​เน​โทน	kinneton
ปัด​โล้ด	patglotq
สัด​ทู	satgtu
อัด​กาด	atgkaatg
เบ​ไบ	bebai
อา​ดีน	aadin
อา​เท	aate
ย้าด​ดู​วา	yaatqduwaa
อา​นา​ยา	aanaayaa
สัน​ไล	sanjlai
โย​ยา​ลิบ	yoyaalipq
อัด​ลี​คัม	atglikam
สี​หะ	sijhag
เซ​อัน​ทิ​เอน	seantien
โย​ยา​คิม	yoyaakim
โย​นา​ทาน	yonaataan
มิน​ยา​มิน	minyaamin
โฮ​ซา​ยา	hosaayaa
มัด​ทา​นิ​ยา	matqtaaniyaa
มี​คา​ยา	mikaayaa
เอ​ลี​ยา​คิม	eliyaakim
อา​หะ​สุ​เอ​ลัด	aahaasuelatq
อิน​เดีย	india
วัด​ชา​ที	watqqaati
เย​โค​นี​ยา	yekoniyaa
โม​เด​ไค	modekai
เอ​เซ​เท	esete
เอ​เซ​เท	esete
เอ​เซ​เท	esete
เคน​เดีย	kendia
เล​วี​อา​ทาน	lewiaataan
บิน​ดัด	bindatg
นา​อา​เม	naaaame
เอ​ลี​ฮู	elihu
เบ​เฮ​โม้ด	behemotq
เล​บา​นอน	lebaanxn
เก​บาน	kebaan
เมน​คี​เซ​เดก	menkisedekg
จอ​แดน	jxdcn
เอ​ฟา​ทา	efaataa
อิ​ที​เอน	itien
อิ​ที​เอน	itien
อัน​มัน	anman
ดา​มัด​กัด	daamatqkatg
เอ​ฟา​อิม	efaaim
บา​บี​โลน	baabilon
โม​อับ	moapg
ไน​อา	naiaa
อี​ยิบ	iyipq
อัด​ซี​เลีย	atgsilia
เซ้บ​นา	sepqnaa
อา​ลี​เอน	aalien
อา​ลี​เอน	aalien
สิ​โอน	sion
อิ​สะ​ยา	isaayaa
ฟาน​เกน​เซน	zauj
บา​อัน	baaan
มัน​คี​อา	mankiaa
โย​สิ​ยา	yosiyaa
สี​ดา	sijdaa
อัด​เค​โลน	atgkelon
อุ​ลี​อา	uliaa
เก​มา​ลิ​ยา	kemaaliyaa
โค​ลา​ยา	kolaayaa
เน​เฮ​ลาม	nehelaam
เส​ฟัน​ยา	sejfanyaa
เส​เด​คี​ยา	sejdekiyaa
เคน​เดีย	kendia
เน​ลิ​ยา	neliyaa
โค​นิ​ยา	koniyaa
เย​ฮู​คัน	yehukan
เบน​ยา​มิน	benyaamin
มัด​ทาน	matqtaan
คา​เล​อา	kaaleaa
ทัน​หุ​เม้ด	tanhumetq
คา​เล​อา	kaaleaa
เก​ดา​ลิ​ยา	kedaaliyaa
ทา​ปาน​เหด	taapaanhetg
คี​ลิ​ยา​ทา​อิม	kiliyaataaim
ดี​โบน	dibon
เอ​โดม	edom
เอ​โดม	edom
บา​บี​โลน	baabilon
เน​บู​คัด​เน้ด​ซา	nebukatqnetqsaa
เค​บา	kebaa
ยา​อา​ซัน​ยา	yaaaasanyaa
โอ​โฮ​ลา	oholaa
โอ​โฮ​ลี​บา	oholibaa
เอ​ที​โอ​เปีย	etiopia
โฮ​เม	home
ดา​นี​เอน	daanien
เบน​เท​ซัด​ซา	bentesatqsaa
ซัด​ลัก	satqlakq
อา​เบด​เน​โก	aabetgneko
อา​เบด​เน​โก	aabetgneko
เบน​ซัด​ซา	bensatqsaa
กา​เบ​เลียน	kaabelyen
โฮ​เซ​ยา	hoseyaa
เค​ลิ​โอด	keliotg
กิน​กาน	kinkaan
ฟี​นี​เซีย	finisia
สา​เล​ฟัด	saajlefatq
นิ​นะ​เว	ninaawe
นา​ฮูม	naahum
ลิ​เบีย	libia
ฮา​บา​กุก	haabaakukg
โย​ซู​วา	yosuwaa
เฮ้ด​โลน	hetqlon
โบ​อาด	boaatg
เจียด​ซี	jyetgsi
เอ​ลี​ยา​คิม	eliyaakim
มา​ลี​ยา	maaliyaa
มา​ลี​ยา	maaliyaa
อี​มา​นู​เอน	imaanuen
ยู​เดีย	yudia
นา​ซา​เล้ด	naasaaletq
นา​ซา​เล้ด	naasaaletq
โย​ฮัน	yohan
โย​ฮัน	yohan
โย​ฮัน	yohan
เส​เบ​ดี	sejbedi
โท้ด​บุ​ลี	totqbuli
บา​โท​โล​มิว	baatolomiu
มัด​ทาย	matqtaai
อัน​เฟ​อัด	anfeatg
ทัด​เด​อัด	tatqdeatg
ยู​ดาด	yudaatg
อิ​สะ​คา​ลิ​โอด	isaakaaliotg
ฟา​ลิ​สี	faalisij
ฟา​ลิ​สี	faalisij
เบ​เอน​เซ​บูน	beensebun
เฮ​โล​เดียด	helodyetg
สะ​ดู​สี	saadusij
สะ​ดู​สี	saadusij
เบ​ทา​นี	betaani
คา​ยา​ฟ้าด	kaayaafaatq
ยู​ดาด	yudaatg
บา​ลับ​บัด	baalapqbatg
บา​ลับ​บัด	baalapqbatg
ลา​มา​ซา​บัก​ทา​นี	laamaasaabakgtaani
มัก​ดา​ลา	makqdaalaa
อัน​ดา​ลู	andaalu
คา​เป​นา​อุม	kaapenaaum
เบด​ไซ​ดา	betgsaidaa
โฮ​ซา​นา	hosaanaa
อา​เล้ก​ซาน​เด	aalekqsaande
มัด​ทัด	matqtatq
มัด​ทัด	matqtatq
มัด​ทา​ที​อัด	matqtaatiatg
มัด​ทา​ที​อัด	matqtaatiatg
เอ​อา	eaa
สิ​เม​โอน	simeon
อับ​ลา​ฮัม	apglaaham
นา​โฮ	naaho
เล​อู	leu
เอ​เบ	ebe
อาน​ฟา​ซัด	aanfaasatq
อา​ดัม	aadam
เก​ลา​ซา	kelaasaa
สะ​มา​เลีย	saamaalia
กา​ลิ​ลี	kaalili
สี​โล​อัม	sijloam
ลา​ซา​ลัด	laasaalatq
สัก​เคี้ยด	sakgkyetq
นา​ทา​นา​เอน	naataanaaen
นี​โค​เด​มัด	nikodematq
ลา​ซา​ลัด	laasaalatq
ลา​ซา​ลัด	laasaalatq
ยู​ดาด	yudaatg
อา​นา​เนีย	aanaania
อา​นา​เนีย	aanaania
สะ​เท​เฟน	saatefen
อัน​ที​โอก	antiokg
นี​โค​เลา	nikolau
ไอ​เน​อัด	aineatg
ลิด​ดา	litqdaa
โค​เน​ลิ​อัด	koneliatg
โค​เน​ลิ​อัด	koneliatg
ซี​ซา​ลี​ยา	sisaaliyaa
บา​นา​บัด	baanaabatg
บา​นา​บัด	baanaabatg
อี​โค​นี​ยูม	ikoniyum
มา​ซี​โด​เนีย	maasidonia
เท​สะ​โล​นิ​กา	tesaalonikaa
ทิ​โม​ไท	timotai
โค​ลิน​โท	kolinto
คะ​ลิด​ปัด	kaalitqpatg
กัน​ลิ​โอ	kanlio
อา​คา​ยา	aakaayaa
เอ​เฟ​โซ	efeso
ปิด​สิน​ลา	pitgsinjlaa
อา​ควิน​ลา	aakwinlaa
อา​ปอ​โล	aapxlo
อาน​เท​มิด	aantemitq
เด​เม้ด​ลิ​อัด	demetqliatg
เบ​โล​อา	beloaa
อา​ลิด​ทา​คัด	aalitqtaakatq
กาย​อัด	kaaiatg
ที​คิ​กัด	tikikatg
โต​ฟี​มัด	tofimatq
โต​อัด	toatg
ซี​ลี​เซีย	silisia
คา​ลาว​ดิ​อัด	kaalaaudiatg
เฟ​สะ​ทัด	fesaatatq
เฟ​สะ​ทัด	fesaatatq
อา​ฆี​พา	aagipaa
อา​ฆี​พา	aagipaa
อับ​ลา​ฮัม	apglaaham
ลู​สิ​อัด	lusiatg
สะ​เท​ฟา​นัด	saatefaanatq
อา​ปอ​โล	aapxlo
มา​ซี​โด​เนีย	maasidonia
เอ​ปา​ฟา	epaafaa
เลา​ดี​เซีย	laudisia
ฮี​เม​เน​อัด	himeneatg
กา​ลา​เทีย	kaalaatia
โอ​เน​สิ​โฟ​ลัด	onesifolatq
เอ​ลัด​ทัด	elatqtatq
มิ​เล​ทัด	miletatq
ฟี​เล​โมน	filemon
โอ​เน​สิ​มัด	onesimatq
บา​ลา​อัม	baalaaam
คา​อิน	kaain
ทินฮู่ง	tinb huvb
ธีงเหฑ่ง	revg
เจ๊าโหล่ว	lrug
เนียบูง	buv
แซงคู้	kuq
ตอนเจว๊ย	jweiq
ฟุนฟะ	faq
เดาเป้ย	daub
หญู่งๆ	euvg
เฒ้ยฟุน	zeib
ฝีงๆ	fivj
เต่ยปูง	puv
เหฒี่ยต้อง	ziab
หฮญังเจ๊ย	havb
หฒั่นๆ	zang
ด๊บลิ่ว	liub
จาตี้ง	tivb
หล่มฮวาง	lomb
ฟินเมี่ยน	myenb
หมิ่วฝัง	miub
ลุยโหว	hruj
แปงเปย๊ย	pcvb
วินวั้ง	wavq
ค้อยเฮลน	len
กั๊บจ๋าย	kapg
จั๋งโห่	hog
เล์ยหลัด	latg
หละเปย๊ยเป๊น	penq
ฟูสู	fub
แซงเยี้ยด	scvb
บ๊วนหม่วน	bwrnb
ธะโป่ว	zag
เล์ยเหญ่ย	eeig
เก๊าะเมี่ยน	kxg
ฮูงโล่ว	huvb
ฮนอยเหญียะ	eiag
จาสี่	sig
เหฑียมย่าง	ryemb
ปย๊าบย่า	byaag
องถาย	taaij
ววนแป่ง	pcvg
ปั์วเดี๊ย	diaq
ม์านหฮมวัง	maanb
ม์าเธีย	zia
ก๋อโย์ว	yrud
ธุนแกง	zunb
ปองปั์ว	pxvb
บงไอ๊	aiq
ววมฒี้ง	zivq
ด๊ามฝีง	fivj
นอมๆ	nxmb
เธียนเธะ	zeq
กะน้ายเธ้น	kanaaib
จวังหฒิน	zinj
จุนแปง	pcv
เฌียนโย่ว	fyenb
ธงเม่ง	mevb
กงเมี่ยน	myenb
ฒองฒุ	zuq
แปงกวั้น	pcvb
แซงเหฒียบ	scvb
ฟิ้วต้าน	fiub
ฌังหล่าง	laavg
หฮญังๆ	havb
เซี้ยบๆ	syepq
กงฒิ่น	kovb
ออนเหลาะ	lxg
หฑยาวหฒุ่น	zung
กอนโด๊ะ	doq
เดาฮวาง	daub
แซงเอ๋ย	eij
ธง	zovb
ก๊องแปะ	kxvb
ค้อเลี่ยน	lyenb
จ๊บเหญ่ย	eeig
โชวๆ	qru
กงฟิม	fim
เดี๋ยงฆว่า	gwaab
เดี๋ยงก์า	dyavb
โซวหฌุ่น	fung
ฒองเหฒง	zevj
โพวทง	tov
ค้อยโฑว	rru
ก๋อ	kxb
หลงๆ	lovj
เอนฒี่ง	zivb
โล์ฮนอย	nxi
เซียงฑูง	syavb
แฒะเฒี้ยว	zyruq
ฮนอยๆ	nxib
อา​ดัม	aadam
ฮา​วา	haawaa
คา​อิน	kaain
กะน้ายหฒวัง	kanaaib
อา​แบน	aabcn
เอ​โน้ก	enokq
อิ​ล้าด	ilaatq
เม​หู​ยา​เอน	mehujyaaen
เม​ทู​ซา​เอน	metusaaen
ลา​เม้ก	laamekq
อา​ดา	aadaa
สิน​ลา	sinjlaa
เอ​โน้ด	enotq
เค​นัน	kenan
มา​หะ​ลา​เลน	maahaalaalen
ยา​เล้ด	yaaletq
เม​ทู​เส​ลา	metusejlaa
โน​ยา	noyaa
ยา​เฟ้ด	yaafetq
คา​นา​อัน	kaanaaan
โก​เม	kome
มา​โกก	maakokg
มา​ได	maadai
ยา​วาน	yaawaan
ทู​บัน	tuban
เม​เซ้ก	mesekq
ทิ​ล้าด	tilaatq
อัด​เค​นัด	atgkenatq
ลี​ฟ้าด	lifaatq
โท​กาน​มา	tokaanmaa
เอ​ลี​เซ​อา	eliseaa
ทาน​ซิด	taansitq
คิด​ทิม	kitqtim
โล​ดา​นิม	lodaanim
อี​ยิบ	iyipq
เส​บา	sejbaa
ฮา​วิ​ลา	haawilaa
สับ​ทา	sapgtaa
ลา​อา​มา	laaaamaa
สับ​เท​คา	sapgtekaa
เช​บา	qebaa
เด​ดาน	dedaan
นิม​โล้ด	nimlotq
เล​เสน	lesenj
นิ​นะ​เว	ninaawe
คา​ลา	kaalaa
ลู​ดิม	ludim
อา​นา​มิม	aanaamim
เล​หะ​บิม	lehaabim
นับ​ทู​ฮิม	napqtuhim
ฮี​ไว	hiwai
อาน​คา	aankaa
สี​นี	sijni
เอ​ลาม	elaam
อัด​ซู	atgsu
อาน​ฟา​ซัด	aanfaasatq
ลู​เด	lude
อา​ลัม	aalam
เก​เท	kete
เช​ลา	qelaa
เอ​เบ	ebe
โย้ก​ทาน	yokqtaan
อัน​โม​ดัด	anmodatg
เช​เล้บ	qelepq
ฮา​ซาน​มา​เว้ด	haasaanmaawetq
เย​ลา	yelaa
ฮา​โด​ลัม	haadolam
อุ​ซาน	usaan
ดิก​ลา	dikglaa
โอ​บาน	obaan
อา​บี​มา​เอน	aabimaaen
โอ​ฟี	ofi
โย​บับ	yobapg
บา​เบน	baaben
เป​เล้ก	pelekq
เล​อู	leu
เส​ลุก	sejlukq
นา​โฮ	naaho
เท​ลา	telaa
อับ​ลาม	apglaam
ฮา​ลาน	haalaan
ซา​ลาย	saalaai
มิน​คา	minkaa
อิด​คา	itgkaa
เน​เกบ	nekepg
ฟา​โล	faalo
เบด​เอน	betgen
โส​โดม	sojdom
เบย​ลา	beilaa
โก​โม​ลา	komolaa
บิน​ซา	binsaa
อัด​มา	atgmaa
ซี​น้าบ	sinaapq
เส​โบ​ยิม	sejboyim
เซ​เม​เบ	semebe
เบ​ลา	belaa
โส​อา	sojaa
เอน​มิด​ฟัด	enmitqfatq
คา​เดด	kaadetg
ฮา​ซา​โซน	haasaason
ทา​มา	taamaa
อา​มา​เล้ก	aamaalekq
อา​โม​ไล	aamolai
สิด​ดิม	sitgdim
โฮ​บา	hobaa
ดา​มัด​กัด	daamatqkatg
เค​โด​ลา​โอ​เม	kedolaaome
ซา​เว	saawe
อา​เน	aane
เอด​โค	etgko
มัม​เล	mamle
ท้องป้าย	paaib
เอ​ลี​เย​เซ	eliyese
อับ​ลา​ฮัม	apglaaham
ฮิด​ไท	hitqtai
เป​ลิด​ซี	pelitqsi
เล​ฟา​อิม	lefaaim
ฮา​กา	haakaa
อิ​สะ​มา​เอน	isaamaaen
ซา​ลา	saalaa
เก​ลา​อา	kelaaaa
อา​บี​เม​เล้ก	aabimelekq
อี​สัก	isakg
เบ​เอ​เช​บา	beeqebaa
เค​เสด	kesetg
ฮา​โซ	haaso
ปิน​ดาด	pindaatg
ยิด​ล้าบ	yitqlaapq
เบ​ทู​เอน	betuen
เล​เบ​คา	lebekaa
คี​ลิ​ย้าด​อาน​บา	kiliyaatqaanbaa
เฮ​โบ​โลน	hebolon
โส​หา	sojhaaj
เอ​โฟ​โลน	efolon
ลา​บาน	laabaan
เค​ทู​ลา	ketulaa
โย้ก​ซาน	yokqsaan
อัด​ซู​ลิม	atgsulim
เล​ทู​ซิม	letusim
เล​อุม​มิม	leummim
มิด​มา	mitqmaa
ดู​มา	dumaa
มัด​ซา	matqsaa
ฮา​ดัด	haadatg
เท​มา	temaa
เย​ทู	yetu
นา​ฟิด	naafitq
เค​เด​มา	kedemaa
ปัด​ดาน​อา​ลัม	patgdaanaalam
เอ​ซาว	esaau
ยา​โค้บ	yaakopq
ฟี​ลิ​สะ​เตีย	filisaatia
เบ​เอ​ลี	beeli
ยู​ดิด	yuditg
เอ​โลน	elon
บา​เส​มัด	baasejmatq
ลา​เซน	laasen
ลา​บาน	laabaan
บิน​ฮา	binhaa
เล​อา	leaa
เล​วี	lewi
นับ​ทา​ลี	napqtaali
สิน​ปา	sinjpaa
ดู​ดา​อิม	dudaaim
ดี​นา	dinaa
อิ​สะ​ลา​เอน	isaalaaen
โย​เซ้บ	yosepq
เส​อี	seji
ฮา​โม	haamo
เซ​เคม	sekem
สิ​เม​โอน	simeon
เอ​ฟา​ลา​ทา	efaalaataa
เบน​ยา​มิน	benyaamin
อา​เซ	aase
เอ​ลี​ฟัด	elifatq
เล​อู​เอน	leuen
เท​มาน	temaan
โอ​มา	omaa
เส​โฟ	sejfo
นา​หัด	naahatg
เฒ​ลา	zelaa
อา​นา	aanaa
เย​อูด	yeutg
ยา​ลาม	yaalaam
โค​ลา	kolaa
โอ​โฮ​ลี​บา​มา	oholibaamaa
เอ​โดม	edom
โฮ​ลี	holi
โฮ​มัม	homam
โล​ทาน	lotaan
ทิม​นา	timnaa
โซ​บาน	sobaan
มา​นา​ฮ้าด	maanaahaatq
เอ​บาน	ebaan
เช​โฟ	qefo
โอ​นัม	onam
ดี​โซน	dison
เฮม​ดาน	hemdaan
เอด​บาน	etgbaan
อิด​ลาน	itglaan
เค​ลาน	kelaan
เอ​เซ	ese
อา​ขาน	aakaanj
ดี​ซาน	disaan
อา​ลัน	aalan
สิ​เบ​โอน	sibeon
เอ​โดม	edom
ดิน​ฮา​บา	dinhaabaa
โบ​ซา​ลา	bosaalaa
หุ​ซาม	husaam
เบ​ดัด	bedatg
โม​อับ	moapg
มี​เดียน	midyen
อา​วี้ด	aawitq
สัม​ลา	samjlaa
เล​โห​โบด	lehojbotg
ซา​อุน	saaun
อัก​โบ	akgbo
บา​อัน​ฮา​นัน	baaanhaanan
ปา​อู	paau
มัด​เล้ด	matqletq
เม​ซา​หับ	mesaahapg
อัน​วา	anwaa
เย​เท้ด	yetetq
เอ​ลา	elaa
ปี​โนน	pinon
เค​นัด	kenatq
มิบ​ซา	mipqsaa
โด​ทาน	dotaan
ลู​เบน	luben
ยู​ดา	yudaa
ชู​อา	quaa
เอ​อา	eaa
โอ​นัน	onan
เค​ซี้บ	kesipq
ฮิบ​ลู	hipqlu
ไน​อา	naiaa
ฮา​โน้ก	haanokq
ปัน​ลู	panlu
เฮ้ด​โลน	hetqlon
คาน​มี	kaanmi
เย​มู​เอน	yemuen
ยา​มีน	yaamin
โอ​หาด	ohaatg
ยา​คีน	yaakin
เก​โซน	keson
โค​ฮ้าด	kohaatq
เม​ลา​ลี	melaali
อิด​สา​คา	itgsaajkaa
โท​ลา	tolaa
ปู​วา	puwaa
อิ​โอบ	iopg
ซิม​โลน	simlon
เส​บู​ลุน	sejbulun
เส​เล้ด	sejletq
ยา​เล​เอน	yaaleen
ฮัก​กี	hakqki
ซู​นี	suni
เอด​โบน	etgbon
เอ​เล​อี	elei
อา​โล​ดี	aalodi
อา​เล​ลี	aaleli
อิม​นา	imnaa
อิด​วา	itgwaa
อิด​วี	itgwi
เบ​ลี​ยา	beliyaa
เซ​ลา​อา	selaaaa
เฮ​เบ	hebe
เบ​เค	beke
อัด​เบน	atgben
เก​ลา	kelaa
นา​อา​มาน	naaaamaan
เอ​ไฮ	ehai
โล​อัด	loatg
มับ​ปิม	mapqpim
หุ​ซิม	husim
ยา​ซี​เอน	yaasien
กุ​นี	kuni
เย​เซ	yese
ซิน​เลม	sinlem
โก​เซน	kosen
มะ​นัด​เส	maanatqsej
เอ​ฟา​อิม	efaaim
จอ​แดน	jxdcn
อา​ท้าด	aataatq
มา​คี	maaki
โม​เซ	mose
อา​โลน	aalon
ลิบ​นี	lipqni
ซิ​เม​อี	simei
มา​ลี	maali
มู​ซี	musi
อิด​ฮา	itghaa
เน​เฟ้ก	nefekq
สิก​ลี	sikgli
อุด​ซี​เอน	utgsien
มิ​ซา​เอน	misaaen
เอน​ซา​ฟาน	ensaafaan
สิด​ลี	sitgli
นา​โซน	naason
เอ​ลี​เช​บา	eliqebaa
นา​ดับ	naadapg
อิ​ทา​มา	itaamaa
อัด​สี	atgsij
เอน​คา​นา	enkaanaa
อา​บี​ยา​สาบ	aabiyaasaapg
เอ​เล​อา​ซา	eleaasaa
ปู​ทิ​เอน	putien
ฟี​เน​หัด	finehatg
เปย๊าเฮลน	len
โต์วเหฑ่า	raug
บา​ลี	baali
หุ​โสบ	husopg
ลา​มา​เสด	laamaasetg
สุก​โค้ด	sukgkotq
อา​บีบ	aabipg
มิ​เลียม	milyem
เล​ฟี​ดิม	lefidim
ฮู​อา	huaa
โย​ซู​วา	yosuwaa
เย​โท	yeto
ซี​นาย	sinaai
บง	bovb
บงเหฆน	genj
อา​บี​ฮู	aabihu
เค​ลู​บิม	kelubim
เอ​โฟ้ด	efotq
เจียมป้าย	jyemb
ดามตอง	txv
ฌั้วเปียะ	piag
ฟามปวน	faamb
อุ​ลี	uli
เบ​ซา​เลน	besaalen
เซียวเซ้ด	setq
เย​บุด	yebutg
อา​หิ​สะ​มัก	aahisaamakq
โอ​โฮ​ลี​อับ	oholiapg
ฮลางบั๊ว	laavb
แธะจ้าง	jaavb
อุ​ลิม	ulim
ทุม​มิม	tummim
ปั์วฒ้าง	puab
โม​เล้ก	molekq
เซ​โล​มิด	selomitq
ดิบ​ลี	dipgli
ป๊วนฝีง	fivj
เซ​เด​เอ	sedee
เอ​ลี​ซู	elisu
สู​ลิ​ซัด​ได	sujlisatqdai
เซ​ลู​มิ​เอน	selumien
อัม​มี​นา​ดับ	amminaadapg
ฒู​อา	zuaa
เน​ทัน​เอน	netanen
เฮ​โลน	helon
เอ​ลี​อับ	eliapg
อัม​มี​ฮู้ด	ammihutq
เอ​ลี​ซา​มา	elisaamaa
เป​ดา​ซู	pedaasu
กา​มา​ลิ​เอน	kaamaalien
กิ​เด​โอ​นี	kideoni
อา​บี​ดัน	aabidan
อัม​มี​ชัด​ได	ammiqatqdai
อา​หิ​เย​เซ	aahiyese
โอ​คาน	okaan
ปา​กี​เอน	paakien
เด​อู​เอน	deuen
เอ​ลี​ยา​สาบ	eliyaasaapg
เอ​นัน	enan
อา​หิ​ลา	aahilaa
อัม​ลาม	amlaam
เอ​ลี​ซา​ฟาน	elisaafaan
นา​สี	naasij
ทา​เบ​ลา	taabelaa
มา​นา	maanaa
ขิบ​โล้ด​หัด​ตา​อา​วา	kipglotqhatgtaaaawaa
ฮา​เซ​โล้ด	haaselotq
สัก​เก	sakgke
ซัม​มุ​วา	sammuwaa
ซา​ฟัด	saafatq
เย​ฟุน​เน	yefunne
คา​เล้บ	kaalepq
อิ​กาน	ikaan
โฮ​เซ​ยา	hoseyaa
ลา​ฟู	laafu
ปัน​ที	panti
โส​ดี	sojdi
กัด​เดียน	katgdyen
สุ​สี	susij
กัด​ดี	katgdi
เก​มัน​ลี	kemanli
อัม​มี​เอน	ammien
มี​คา​เอน	mikaaen
เส​ทู	sejtu
โว้บ​สี	wopqsij
นา​บี	naabi
เก​อู​เอน	keuen
โฮ​มา	homaa
ต๋อยเตก	tekg
ดา​ทาน	daataan
อา​บี​ลัม	aabilam
เซียงสี่	syavb
เซียงอะหงุ่น	avung
เม​ลี​บา	melibaa
คา​เดด	kaadetg
โฮ​อา	hoaa
อา​ล้าด	aalaatq
อา​ทา​ลิม	aataalim
นางโตะ	tog
เฒ​เล้ด	zeletq
มัด​ทา​นา	matqtaanaa
นา​หะ​ลี​เอน	naahaalien
บา​โม้ด	baamotq
สิ​โหน	sihonj
เฮ้ด​โบน	hetqbon
เค​โม้ด	kemotq
สิบ​โป	sipgpo
บา​ล้าก	baalaakq
บา​ลา​อัม	baalaaam
คี​ลิ​ย้าด​หุ​โซ้ด	kiliyaatqhusotq
บา​อัน	baaan
เบ​โอ	beo
เค​ไน	kenai
ซิด​ทิม	sitqtim
เป​โอ	peo
สิม​ลี	simjli
สา​ลู	saajlu
โค้ด​บี	kotqbi
สู​อา	sujaa
โอด​นี	otgni
อา​โล้ด	aalotq
ยา​ซู้บ	yaasupq
อัด​ลี​เอน	atglien
เซ​มิ​ดา	semidaa
เฮ​เฟ	hefe
เฮ​เฟ	hefe
เส​โล​เฟ​หัด	sejlofehatg
มา​ฮา​ลา	maahaalaa
โฮ้ก​ลา	hokqlaa
ที​ละ​ซา	tilaasaa
เซ​ฟู​ฟาม	sefufaam
หุ​ฟาม	hufaam
ซู​ฮัม	suham
อา​เซ	aase
กิ​เล​อาด	kileaatg
มา​คี​เล	maakile
อา​บา​ลิม	aabaalim
เอ​วี	ewi
เล​เคม	lekem
เล​บา	lebaa
ตอนหละเก๊า	txnb
เอ​ทาม	etaam
ปี​หะ​หิ​โล้ด	pihaahilotq
บา​อัน​เซ​โฟน	baaansefon
มิก​โดน	mikqdon
โด​ฟะ​คา	dofaakaa
อา​ลู้ด	aalutq
ลิด​มา	litqmaa
ลิม​โมน​เป​เล้ด	limmonpeletq
ลิบ​นา	lipqnaa
ลิด​สา	litqsaaj
เค​เฮ​ลา​ทา	kehelaataa
เซ​เฟ	sefe
ฮา​ลา​ดา	haalaadaa
มัก​เฮ​โล้ด	makqhelotq
ทา​หัด	taahatg
มิด​คา	mitqkaa
ฮัด​โม​นา	hatqmonaa
โม​เส​โล้ด	mosejlotq
เบ​เน​ยา​อะ​คัน	beneyaaaakan
โฮ​ฮัก​กีด​กาด	hohakqkitgkaatg
โย้ด​บา​ทา	yotqbaataa
อับ​โล​นา	apglonaa
เอ​ซี​โอน​เก​เบ	esionkebe
สัน​โม​นา	sanjmonaa
ปู​โนน	punon
โอ​โบด	obotg
อี​เย​อา​บา​ลิม	iyeaabaalim
ดี​โบน​กาด	dibonkaatg
อัน​โมน​ดิบ​ลา​ทา​อิม	anmondipglaataaim
เน​โบ	nebo
อัด​โมน	atgmon
เม​ดิ​เต​เล​เนียน	meditelenyen
ฮา​มัด	haamatq
เส​ดัด	sejdatg
เซ​มู​เอน	semuen
ชิด​โลน	qitqlon
เอ​ลี​ดาด	elidaatg
โย้ก​ลี	yokqli
บุก​คี	bukgki
ฮัน​นี​เอน	hannien
ซิบ​ทาน	sipqtaan
เค​มู​เอน	kemuen
ปา​น้าก	paanaakq
อัด​ซาน	atgsaan
ปัน​ที​เอน	pantien
เซ​โล​มี	selomi
อา​หิ​ฮู้ด	aahihutq
เป​ดา​เฮน	pedaahen
เอ​เดน​อี	edeni
อัด​ทา​โล้ด	atgtaalotq
บา​ซาน	baasaan
โฮ​เล้บ	holepq
เอ​มิม	emim
อา​น้าก	aanaakq
คา​เดด​บา​เนีย	kaadetgbaania
ยา​ฮ้าด	yaahaatq
อาน​โกบ	aankopg
เฮ​โมน	hemon
ไซ​ดอน	saidxn
สี​ลี​ออน	sijlixn
เส​นี	sejni
อา​ลา​บา	aalaabaa
ปิด​กา	pitgkaa
เดี๋ยงฟาง	faav
กุด​โก​ดา	kutgkodaa
ขูงปั์ว	puad
อัม​โมน	ammon
เก​ลิ​ซิม	kelisim
อา​เมน	aamen
ลา​หับ	laahapg
กิน​กาน	kinkaan
โต์วเลา	lau
เย​ลี​โค	yeliko
เช​บา​ลิม	qebaalim
สับ​ดี	sapgdi
อา​คาน	aakaan
กิ​เบ​โอน	kibeon
เค​ฟี​ลา	kefilaa
เบ​เอ​โล้ด	beelotq
คี​ลิ​ย้าด​เย​อา​ลิม	kiliyaatqyeaalim
เย​ลู​ซา​เลม	yelusaalem
อา​โด​นี​เซ​เดก	aadonisedekg
โฮ​ฮัม	hoham
ยาน​มู้ด	yaanmutq
ปี​ลาม	pilaam
ลา​คี้ด	laakitq
ยา​เฟีย	yaafia
เอก​โลน	ekglon
เด​บี	debi
เบด​โฮ​โลน	betgholon
อา​เซ​คา	aasekaa
มัก​เค​ดา	makqkedaa
ไอ​ยา​โลน	aiyaalon
เก​เซ	kese
โฮ​ลาม	holaam
ยา​บิน	yaabin
มา​โดน	maadon
อัก​ซ้าบ	akgsaapq
เม​โลม	melom
ววม	uamb
มิด​เล​โฟ้ด​มา​อิม	mitqlefotqmaaim
มิด​ปา	mitqpaa
เก​เด	kede
อา​ดุน​ลัม	aadunlam
ทับ​ปู​วา	tapqpuwaa
อา​เฟ้ก	aafekq
ลา​ซา​โลน	laasaalon
ซิม​โลน​เม​โลน	simlonmelon
ทา​อา​น้าก	taaaanaakq
เม​กิด​โด	mekitgdo
เค​เดด	kedetg
คาน​เมน	kaanmen
โย้ก​เน​อัม	yokqneam
นา​โฟ้ด​โด​อา	naafotqdoaa
โด​อา	doaa
กา​ลิ​ลีเญย	kaalilieei
โก​ยิม	koyim
เก​ซู	kesu
มา​อา​คา	maaaakaa
สา​เล​คา	saajlekaa
เค​เด​โม้ด	kedemotq
เม​ฟา​อาด	mefaaaatg
เบด​เป​โอ	betgpeo
เบด​เย​ซิ​โม้ด	betgyesimotq
บา​อา​ลา	baaaalaa
เย​ลา​ลิม	yelaalim
เค​สะ​โลน	kesaalon
เบด​เซ​เม้ด	betgsemetq
ทิม​นา​ฮา	timnaahaa
คี​ลิ​ย้าด​เส​เฟ	kiliyaatqsejfe
อัก​สา	akgsaaj
โอด​นี​เอน	otgnien
คี​นา	kinaa
ดี​โม​นา	dimonaa
อา​ดา​ดา	aadaadaa
อิด​นาน	itgnaan
สิบ​อา	sipgaa
เท​เลม	telem
เบ​อา​โล้ด	beaalotq
ฮา​โซ​ฮา​ดัด​ทา	haasohaadatgtaa
เค​ลิ​โอด​เฮ้ด​โลน	keliotghetqlon
อา​มัม	aamam
เซ​มา	semaa
โม​ลา​ดา	molaadaa
ฮา​ซาน​กัด​ดา	haasaankatgdaa
เฮ้ด​โมน	hetqmon
เบด​เป​เล้ด	betgpeletq
ฮา​ซาน​ซู​อาน	haasaansuaan
บิ​ซิ​โอ​ทิ​ยา	bisiotiyaa
อิ​ยิม	iyim
เอ​เซม	esem
เอน​โท​ลัด	entolatq
เค​สิน	kesinj
โฮน​มา	honmaa
สิก​ล้าก	sikglaakq
มัด​มัน​นา	matqmannaa
สัน​สัน​นา	sanjsanjnaa
สา​โน​อา	saajnoaa
เอน​กัน​นิม	enkannim
เอ​นาม	enaam
โส​โค	sojko
เส​นัน	sejnan
ฮา​ดา​ชา	haadaaqaa
มิก​ดัน​กาด	mikqdankaatg
ดิ​เล​อัน	dilean
โย้ด​เท​เอน	yotqteen
โบด​ค้าด	botgkaatq
คับ​โบน	kapqbon
ลา​มัม	laamam
คิด​ลิด	kitqlitq
เอ​เท	ete
อา​ชัน	aaqan
อิบ​ทา	ipgtaa
อัด​นา	atgnaa
เน​ซี้บ	nesipq
ดาน​นา	daannaa
คี​ลิ​ย้าด​สัน​นา	kiliyaatqsanjnaa
อา​น้าบ	aanaapq
เอด​เท​โม​อา	etgtemoaa
อา​นิม	aanim
อา​หลับ	aalapg
เอ​ซาน	esaan
ยา​นิม	yaanim
เบด​ทับ​ปู​วา	betgtapqpuwaa
อา​เฟ​คา	aafekaa
มา​โอน	maaon
ยุด​ทา	yutqtaa
ยิด​เล​เอน	yitqleen
โย้ก​เด​อัม	yokqdeam
ฮัน​ฮูน	hanhun
เบด​สู​อา	betgsujaa
เก​โด	kedo
ยา​โน​อา	yaanoaa
อา​ทา​โล้ด	aataalotq
นา​อา​ลา	naaaalaa
ซี​โล	silo
เบด​โฮ้ก​ลา	betghokqlaa
เอ​เม้ก​เค​ซี้ด	emekqkesitq
เบด​อา​ลา​บา	betgaalaabaa
เส​มา​ลา​อิม	sejmaalaaim
อับ​วิม	apgwim
ปา​ลา	paalaa
โอ​ฟา​ลา	ofaalaa
ลา​มา	laamaa
โม​ซา	mosaa
อิน​เป​เอน	inpeen
ทา​ละ​ลา	taalaalaa
เช​บา	qebaa
บา​ลา	baalaa
เบด​มาน​คา​โบด	betgmaankaabotg
ฮา​ซาน​สู​สา	haasaansujsaaj
ฮา​ฟา​ลา​อิม	haafaalaaim
ซี​โยน	siyon
อา​นา​หะ​ล้าด	aanaahaalaatq
ลับ​บีด	lapqbitg
คี​ซิ​โอน	kision
เอ​เบด	ebetg
เล​เม้ด	lemetq
เอน​หัด​ดา	enhatgdaa
เบด​ปัด​เซ้ด	betgpatgsetq
เฒ​อา	zeaa
ฮัม​มัด	hammatq
ลัก​คัด	lakqkatq
คิน​เน​เล้ด	kinneletq
อา​ดา​มา	aadaamaa
เอน​ฮา​โซ	enhaaso
โส​ลา	sojlaa
เอด​ทา​โอน	etgtaaon
อิน​เซ​เม้ด	insemetq
ซา​อัน​บิน	saaanbin
อิด​ลา	itglaa
เอ​โค​โลน	ekolon
เอน​เท​เค	enteke
กิบ​เบ​โทน	kipgbeton
บา​อา​ลัด	baaaalatq
เย​ฮู้ด	yehutq
เบ​เน​เบ​ล้าก	benebelaakq
กัด​ลิม​โมน	katglimmon
เบ​เซ้ก	besekq
อา​โด​นี​เบ​เซ้ก	aadonibesekq
เซ​ไซ	sesai
อา​หิ​มาน	aahimaan
ทัน​ไม	tanmai
อัก​โค	akgko
อัก​ล้าบ	akglaapq
อัก​ซี้บ	akgsipq
เฮน​บา	henbaa
เล​โหบ	lehopg
เอ​ฮู้ด	ehutq
อา​น้าด	aanaatq
ซัม​กา	samkaa
ลับ​ปิ​โดด	lapqpidotg
เด​โบ​ลา	debolaa
อา​บี​โน​อัม	aabinoam
ทา​โบ	taabo
สิ​เส​ลา	sisejlaa
กิ​เด​โอน	kideon
โย​อาด	yoaatg
ววมเฮลน	uamb
อา​บี​เย​เซ	aabiyese
เฒ​บา	zebaa
สัน​มุน​นา	sanjmunnaa
เป​นู​เอน	penuen
เฮ​เล้ด	heletq
เย​ลุบ​บา​อัน	yelupqbaaan
บา​อัน​เบ​ลี้ด	baaanbelitq
เบด​มิน​โล	betgminlo
โย​ทาม	yotaam
เบ​เอ	bee
เส​บุน	sejbun
กา​อัน	kaaan
เท​เบด	tebetg
ซา​มี	saami
จา​อี	jaai
ฮาว​โว้ด​จา​อี	haauwotqjaai
คา​โมน	kaamon
เย้บ​ทา	yepqtaa
อา​โล​เอ	aaloe
มิน​นิด	minnitq
อา​เบน​เค​ลา​มิม	aabenkelaamim
สา​โฟน	saajfon
เบด​เล​เฮม	betglehem
อิบ​ซาน	ipgsaan
ปิ​ลา​โทน	pilaaton
ฮิน​เลน	hinlen
อับ​โดน	apgdon
มา​โน​อา	maanoaa
แซม​สัน	scmsanj
เล​ฮี	lehi
ลา​ม้าด​เล​ฮี	laamaatqlehi
กา​ซา	kaasaa
โส​เล้ก	sojlekq
เด​ลิ​ลา	delilaa
มี​คา	mikaa
มา​หะ​เน​ดาน	maahaanedaan
ลา​อิด	laaitg
เบด​เล​โหบ	betglehopg
กิ​เบ​อา	kibeaa
บา​อัน​ทา​มา	baaantaamaa
ยา​เบด​กิ​เล​อาด	yaabetgkileaatg
เล​โบ​นา	lebonaa
นา​โอ​มี	naaomi
เอ​ลี​เม​เล้ก	elimelekq
โอ​ฟา	ofaa
ลู​เท	lute
มา​โลน	maalon
คิ​ลิ​โอน	kilion
เซียงจา	jaa
เฮนี้ยๆ	niaq
มา​ลา	maalaa
โบ​อาด	boaatg
ธั้มๆ	zamq
สัน​โมน	sanjmon
โอ​เบด	obetg
เจียด​ซี	jyetgsi
ดา​วิด	daawitq
ป๊วนฒี่ง	eei
เอ​ลี	eli
เป​นิน​นา	peninnaa
ฮัน​นา	hannaa
แซงยู์ง	yuvd
ฮวั้วเจ๋ย	jeij
หละฟับดุย	lafapg
ซา​มู​เอน	saamuen
อัด​โดด	atgdotg
โล์ต๋อง	txvj
อา​บี​นา​ดับ	aabinaadapg
เบด​คา	betgkaa
เซา​โล	saulo
เสน​ซา	senjsaa
กะน้ายดุย	dwi
ยา​เบด	yaabetg
นา​หาด	naahaatg
มิก​ม้าด	mikqmaatq
ซู​อัน	suan
โย​นา​ทาน	yonaataan
มิ​โกน	mikon
อา​หิ​ยา	aahiyaa
อับ​เน	apgne
อา​บี​เอน	aabien
เท​ลา​อิม	telaaim
ซู​วา	suwaa
อา​กัก	aakakg
ซินเพย	sinb
ซัม​มา	sammaa
เฮมียนฝัง	myenb
โก​ลิ​อัด	koliatg
ซา​อา​ลา​อิม	saaaalaaim
เซียะโฮล	siag
มี​คาน	mikaan
นา​โย้ด	naayotq
อา​หิ​เม​เล้ก	aahimelekq
อา​คิด	aakitq
โด​เอก	doekg
อา​หิ​ทู้บ	aahitupq
อา​บี​ยา​ทา	aabiyaataa
เค​อี​ลา	keilaa
เซ​ลา​ฮัม​มา​เล​โค้ด	selaahammaalekotq
เอน​เก​ดี	enkedi
นา​บาน	naabaan
อา​บี​กา​ยิน	aabikaayin
อา​หิ​โน​อัม	aahinoam
เส​ลุ​ยา	sejluyaa
โย​อาบ	yoaapg
อา​บี​ไช	aabiqai
มา​โอก	maaokg
ซู​เนม	sunem
กิน​โบ​อา	kinboaa
เอน​โด	endo
เบ​โส	besoj
เค​เล​ที	keleti
ลา​โม้ด	laamotq
ย้าด​ที	yaatqti
สิบ​โม้ด	sipgmotq
ลา​คาน	laakaan
เย​ลา​เม​เอน	yelaameen
โบ​ลา​ชาน	bolaaqaan
อา​ท้าก	aataakq
มัน​คี​ซู​วา	mankisuwaa
เบด​ซาน	betgsaan
ยา​ซา	yaasaa
อิด​โบ​เซ้ด	itgbosetq
มา​หะ​นา​อิม	maahaanaaim
เฮน​ขัด​ฮัด​ซู​ลิม	henkatghatqsulim
อา​สา​เฮน	aasaajhen
บิ๊ด​โลน	bitqlon
อัม​โนน	amnon
อา​โด​นี​ยา	aadoniyaa
ฮัก​กีด	hakqkitg
เซ​ฟา​ทิ​ยา	sefaatiyaa
อา​บี​ทัน	aabitan
อิด​เล​อัม	itgleam
เอก​ลา	ekglaa
กิด​ทา​อิม	kitgtaaim
ลิม​โมน	limmon
เล​ค้าบ	lekaapq
บา​อา​นา	baaaanaa
มิน​โล	minlo
โซ​บับ	sobapg
นา​ทัน	naatan
ซา​โล​มอน	saalomxn
อิบ​ฮา	ipghaa
เอ​ลี​ซู​วา	elisuwaa
เอ​ลี​ยา​ดา	eliyaadaa
เอ​ลี​เฟ​เล้ด	elifeletq
เก​บา	kebaa
อุด​ซา	utgsaa
เป​เล้ด​อุด​ซา	peletqutgsaa
โอ​เบด​เอ​โดม	obetgedom
ตอนจุ่น	jung
สี​ดา	sijdaa
โส​บา	sojbaa
ฮา​ดัด​เอ​เซ	haadatgese
ยู​เฟ​ติด	yufetitg
ซี​เลีย	silia
เบ​ทา	betaa
เบ​โล​ไท	belotai
เย​โฮ​ยา​ดา	yehoyaadaa
เบ​ไน​ยา	benaiyaa
เพ​เล้ด	peletq
ซิ​บา	sibaa
โล​เด​บา	lodebaa
เม​ฟี​โบ​เซ้ด	mefibosetq
ฮา​นูน	haanun
เอ​ลี​อัม	eliam
บัด​เช​บา	batgqebaa
อุ​ลี​อา	uliaa
เย​ลุบ​เบ​เซ้ด	yelupqbesetq
ลับ​บา	lapqbaa
อับ​ซา​โลม	apgsaalom
โย​นา​ดับ	yonaadapg
บา​อัน​ฮา​โซ	baaanhaaso
เท​โค​อา	tekoaa
อิด​ไท	itgtai
สา​โดก	saajdokg
อา​หิ​มา​อัด	aahimaaatg
อา​หิ​โท​เฟน	aahitofen
หุ​ไซ	husai
โซ​บี	sobi
โล​เก​ลิม	lokelim
บา​ซิน​ไล	baasinlai
คิม​ฮาม	kimhaam
อา​มา​สา	aamaasaaj
บีก​ลี	bikgli
อิ​ละ	ilaa
ไอ​อา	aiaa
ลิด​ปา	litqpaa
อาน​โม​นี	aanmoni
เม​โห​ลา	mehojlaa
อาด​ลี​เอน	aatglien
ซี​เม​ฮา	simehaa
อา​โห​ไฮ	aahojhai
โด​โด	dodo
ฮา​ลา	haalaa
อา​เก	aake
เอน​ฮา​นัน	enhaanan
ฮา​โล้ด	haalotq
เอ​ลี​คา	elikaa
เฮ​เล้ด​เท	heletqte
อิก​เขด	ikgketg
อา​นา​โท้ด	aanaatotq
หุ​ซา	husaa
เม​บุน​ไน	mebunnai
เน​โท​ฟา	netofaa
มา​หะ​ไล	maahaalai
ลี​ไบ	libai
กา​อัด	kaaatg
ฮิด​ได	hitqdai
อา​บี​ยัน​โบน	aabiyanbon
บา​ฮู​ลิม	baahulim
อัด​มา​เว้ด	atgmaawetq
ซา​มา	saamaa
ชา​ลา	qaalaa
อา​หิ​ยัม	aahiyam
อา​หัด​ไบ	aahatgbai
กิ​โลน	kilon
เฮ้ด​โล	hetqlo
อา​ล้าบ	aalaapq
ปา​ไล	paalai
บา​นี	baani
เส​เล้ก	sejlekq
นา​หะ​ไล	naahaalai
อิด​ไล	itglai
กา​เล้บ	kaalepq
อุ​ลี​ยา	uliyaa
ยา​เซ	yaase
ตา​ทิม​โหด​ชี	taatimhotgqi
ดัน​ยา​อัน	danyaaan
อา​ลาว​นา	aalaaunaa
อา​บี​ช้าก	aabiqaakq
อา​ซา​ลิ​ยา	aasaaliyaa
เบน​เด​เค	bendeke
มา​ค้าด	maakaatq
ซา​อัน​บิม	saaanbim
เอ​โลน​เบด​ฮา​นัน	elonbetghaanan
เบน​เฮ​เสด	benhesetg
อา​ลุบ​โบด	aalupqbotg
โส​โค	sojko
เบน​อา​บี​นา​ดับ	benaabinaadapg
ทา​ฟัด	taafatq
อา​หิ​ลู้ด	aahilutq
สา​เล​ทาน	saajletaan
อา​เบน​เม​โฮ​ลา	aabenmeholaa
โย้ก​เม​อัม	yokqmeam
อิด​โด	itgdo
อา​หิ​นา​ดับ	aahinaadapg
พา​ลู​อา	paaluaa
เย​โฮ​ซา​ฟัด	yehosaafatq
ฮี​ลาม	hilaam
เล​บา​นอน	lebaanxn
อา​โด​นี​ลัม	aadonilam
เดี๋ยงเป๊น	penq
ไท​ละ	tailaq
สิ​โอน	sion
เอ​ทา​นิม	etaanim
เล​โบ​ฮา​มัด	lebohaamatq
กา​ลิ​ลี	kaalili
คา​บุน	kaabun
อี​ยิบ	iyipq
ทา​เป​เน้ด	taapenetq
เก​นู​บัด	kenubatg
เย​โล​โบ​อัม	yeloboam
เล​โห​โบ​อัม	lehojboam
โล์เฒี้ยว	zyruq
อา​บี​ยา	aabiyaa
จาด่าง	daavg
นา​อา​มา	naaaamaa
ซิ​ซัก	sisakq
เน​บัด	nebatg
อา​บี​ยัม	aabiyam
อา​บี​ชา​โลม	aabiqaalom
อา​สา	aasaaj
บา​อา​ชา	baaaaqaa
เบน​ฮา​ดัด	benhaadatg
โอม​ลี	omli
กี​นัด	kinatq
ทิบ​นี	tipqni
สะ​มา​เลีย	saamaalia
อา​หับ	aahapg
อา​เซ​ลา	aaselaa
เค​ลี้ด​ทา	kelitqtaa
โด๊ะ	dog
เอ​ลี​ยา	eliyaa
โอ​บา​ดี	obaadi
เย​เซ​เบน	yeseben
คี​โซน	kison
นิม​ซี	nimsi
เย​ฮู	yehu
เอ​ลี​ซา	elisaa
ฮา​ซา​เอน	haasaaen
นา​โบด	naabotg
ลา​โม้ด​กิ​เล​อาด	laamotqkileaatg
อิม​ลา	imlaa
มี​คา​ยา	mikaayaa
อา​หัด​ยา	aahatgyaa
ซิน​หิ	sinhi
อา​ซุ​บา	aasubaa
บา​อัน​เซ​บูบ	baaansebupg
โย​ลัม	yolam
เย​โฮ​ลัม	yeholam
ไซเตี๋ย	saib
เก​หะ​ซี	kehaasi
เต่ย	teib
โย​ลัม	yolam
อา​หับ	aahapg
เบด​เอ​เขด	betgeketg
เย​โฮ​นา​ดับ	yehonaadapg
อาน​โนน	aannon
เย​โฮ​อา​หาด	yehoaahaatg
อา​ทา​ลิ​ยา	aataaliyaa
คา​ลี	kaali
สู​เอ	suje
สิ​บี​ยา	sibiyaa
เย​โฮ​อาด	yehoaatg
อา​มา​ซิ​ยา	aamaasiyaa
เอ​ลัด	elatq
เส​คา​ลิ​ยา	sejkaaliyaa
ซัน​ลูม	sanlum
อุด​ซี​ยา	utgsiyaa
กา​ดี	kaadi
เม​นา​เฮม	menaahem
อัด​ซี​เลีย	atgsilia
ปู​ลา	pulaa
เป​คา​หิ​ยา	pekaahiyaa
เล​มา​ลิ​ยา	lemaaliyaa
เป​คา	pekaa
ทิก​ลัด​ปิ​เล​เส	tikqlatqpilesej
อิ​โยน	iyon
อา​เบน​เบด​มา​อะ​คา	aabenbetgmaaaakaa
อา​หัด	aahatg
เล​ซิน	lesin
คี​อา	kiaa
ฮา​ลา​อา	haalaaaa
ฮา​โบ	haabo
โก​ซาน	kosaan
มี​เดีย	midia
บา​บี​โลน	baabilon
สุก​โค้ด​เบ​โน้ด	sukgkotqbenotq
คู​ทา	kutaa
เน​กัน	nekan
อา​ซิ​มา	aasimaa
อับ​วา	apgwaa
นิบ​หัด	nipqhatg
ทาน​ทัก	taantakq
เส​ฟาน​วา​อิม	sejfaanwaaim
อัด​ลัม​เม​เล้ก	atglammelekq
อา​นัม​เม​เล้ก	aanammelekq
เฮ​เซ​คี​ยา	hesekiyaa
แซน​มา​เน​เส	scnmaanesej
เซน​นา​เค​ลิบ	sennaakelipq
อิ​สะ​ยา	isaayaa
อาน​ปัด	aanpatg
เฮ​นา	henaa
อิบ​วา	ipgwaa
บา​ลา​ดัน	baalaadan
เม​โล​ดัก​บา​ลา​ดัน	melodakgbaalaadan
เฮ้บ​ซี​บา	hepqsibaa
อา​โมน	aamon
โย​สิ​ยา	yosiyaa
เย​ดี​ดา	yedidaa
อา​ดา​ยา	aadaayaa
เม​ซุน​ลาม	mesunlaam
อา​ซา​ไล​ยา	aasaalaiyaa
ซา​ฟาน	saafaan
ฮิน​คี​ยา	hinkiyaa
อา​หิ​คัม	aahikam
อา​สา​ยา	aasaajyaa
ฮุน​ดา	hundaa
ฮาน​ฮัด	haanhatq
ที้ก​วา	tikqwaa
ขิด​โลน	kitglon
ป๊วนซิน	sin
โท​เฟ้ด	tofetq
เบน​ฮิน​โนม	benhinnom
ฟา​โล​เน​โค	faaloneko
ฮา​มุ​ทาน	haamutaan
เย​เล​มี	yelemi
ลิบ​ลา	lipqlaa
เย​โฮ​ยา​คิม	yehoyaakim
เส​บิ​ดา	sejbidaa
ลู​มา	lumaa
เป​ดา​ยา	pedaayaa
เย​โฮ​ยา​คีน	yehoyaakin
เน​หุด​ทา	nehutgtaa
เอน​นา​ทัน	ennaatan
เส​เด​คี​ยา	sejdekiyaa
เอ​วิน​เม​โล​ดัก	ewinmelodakg
อาน​วัด	aanwatq
เส​เม	sejme
อับ​ลาม	apglaam
มัด​สา	matqsaaj
เฒ​ฟี	zefi
กา​ทาม	kaataam
มิด​ซา	mitqsaa
อัน​วาน	anwaan
เซ​ฟี	sefi
ฮัม​ลาน	hamlaan
บิน​ฮาน	binhaan
สา​วาน	saajwaan
ยา​อา​คาน	yaaaakaan
มัด​เล​คา	matqlekaa
เม​เฮ​ทา​เบน	mehetaaben
มัก​ดี​เอน	makqdien
อิ​ลาม	ilaam
เป​เล้ด	peletq
ฮา​มูน	haamun
เอ​ทาน	etaan
เฮ​มาน	hemaan
คาน​โค	kaanko
ดาน​ดา	daandaa
ลัด​ได	latqdai
โอ​เซม	osem
เย​เท	yete
เย​ลี​โอด	yeliotg
อาน​โดน	aandon
เส​กุบ	sejkupg
คา​เล้บ​เอ​ฟา​ลา​ทา	kaalepqefaalaataa
อัด​ฮู	atghu
อา​ทา​ลา	aataalaa
ซัม​ไม	sammai
ยา​ดา	yaadaa
อา​บี​ชู	aabiqu
อา​บี​ฮา​อิน	aabihaain
อัก​บาน	akgbaan
โม​ลิด	molitq
เซ​เล​เล้ด	seleletq
อับ​ปา​อิม	apgpaaim
อิด​อี	itgi
เซ​ซัน	sesan
อัก​ไล	akglai
ยา​ละ​ฮา	yaalaahaa
อัด​ไท	atgtai
สา​บาด	saajbaatg
เอ​ฟาน	efaan
เอ​เล​อา​สา	eleaasaaj
สิ​สะ​ไม	sisaamai
เย​คา​มิ​ยา	yekaamiyaa
ลา​ฮัม	laaham
โย​ละ​เค​อัม	yolaakeam
ยา​ได	yaadai
เก​ซาน	kesaan
เป​เหลด	peletg
เอ​ฟา	efaa
ซา​อับ	saaapg
มัก​เบ​นา	makqbenaa
เช​วา	qewaa
สัน​มา	sanjmaa
ฮา​เล้ด	haaletq
เบด​กา​เด	betgkaade
ปุ​ไท	putai
ซู​มัด	sumatq
มิด​ลา	mitqlaa
ซิ​เม​อา	simeaa
เอน​เป​เล้ด	enpeletq
โน​กา	nokaa
มัน​คี​ลาม	mankilaam
เซ​น้าด​ซา	senaatqsaa
โฮ​ซา​มา	hosaamaa
เน​ดา​บี​ยา	nedaabiyaa
เส​ลุบ​บา​เบน	sejlupqbaaben
ฮา​นัน​ยา	haananyaa
ฮา​ซู​บา	haasubaa
โอ​เฮน	ohen
เบ​เล​คิ​ยา	belekiyaa
ฮา​สา​ดิ​ยา	haasaajdiyaa
ยู​ซับ​เฮ​เสด	yusapqhesetg
เป​ลา​ที​ยา	pelaatiyaa
เย​ซา​ยา	yesaayaa
เล​ไฟ​ยา	lefaiyaa
อาน​นัน	aannan
เซ​คา​นิ​ยา	sekaaniyaa
เซ​ไม​อา	semaiaa
ฮัด​ทัด	hatqtatq
บา​ลี​ยา	baaliyaa
เน​อา​ลี​ยา	neaaliyaa
เอ​ลี​โอ​ไน	elionai
อัด​ลี​คัม	atglikam
โฮ​ดา​วิ​ยา	hodaawiyaa
เอ​ลี​ยา​ซี้บ	eliyaasipq
เป​ไล​ยา	pelaiyaa
อัก​ขูบ	akgkupg
โย​ฮา​นัน	yohaanan
เด​ไล​ยา	delaiyaa
อา​นา​นี	aanaani
เล​อา​ยา	leaayaa
ยา​หาด	yaahaatg
อา​หุ​ไม	aahumai
ลา​ฮ้าด	laahaatq
เอ​ตาม	etaam
อิด​มา	itgmaa
อิด​บาด	itgbaatg
ฮัด​เซ​เลน​โพ​นี	hatqselenponi
เฮ​ลา	helaa
เธ​เอ​เล้ด	zeeletq
เอด​นาน	etgnaan
ซู​ฮา	suhaa
เม​หิ	mehi
เอด​โทน	etgton
เบด​ลา​ฟา	betglaafaa
ปา​เส​อา	paasejaa
เท​หิน​นา	tehinjnaa
เล​คา	lekaa
เส​ไล​อา	sejlaiaa
ฮา​ท้าด	haataatq
เม​โอ​โน​ไท	meonotai
อิ​ลู	ilu
นา​อัม	naaam
เย​ฮาน​เล​เลน	yehaanlelen
สิ​ฟา	sifaa
ทิ​ลี​ยา	tiliyaa
อา​สา​เลน	aasaajlen
เอด​ลา	etglaa
เม​เล้ด	meletq
เอ​เฟ	efe
เค​นัน	kenan
มา​หะ​ลา​เลน	maahaalaalen
เอ​โน้ก	enokq
เม​ทู​เส​ลา	metusejlaa
โน​ยา	noyaa
นิม​โล้ด	nimlotq
อา​ลัม	aalam
เช​ลา	qelaa
อี​สัก	isakg
โล​ทาน	lotaan
ดี​โซน	dison
ฮา​ดัด	haadatg
เม​เฮ​ทา​เบน	mehetaaben
ยู​ดา	yudaa
อัม​มี​นา​ดับ	amminaadapg
นา​โซน	naason
สัน​โมน	sanjmon
โอ​เบด	obetg
เส​ลุ​ยา	sejluyaa
เย​ลี​โอด	yeliotg
อุ​ลี	uli
จา​อี	jaai
อัด​ฮู	atghu
อา​ทา​ลา	aataalaa
อา​บี​ฮา​อิน	aabihaain
อิด​อี	itgi
เซ​ซัน	sesan
เย​เท	yete
นา​ทัน	naatan
เอ​ฟาน	efaan
เย​ฮู	yehu
เฮ​เล้ด​เท	heletqte
สิ​สะ​ไม	sisaamai
เย​คา​มิ​ยา	yekaamiyaa
ลา​ฮัม	laaham
มา​โอน	maaon
ดา​วิด	daawitq
เล​โห​โบ​อัม	lehojboam
อา​บี​ยา	aabiyaa
อา​สา	aasaaj
อา​มา​ซิ​ยา	aamaasiyaa
อา​ซา​ลิ​ยา	aasaaliyaa
อา​หัด	aahatg
เฮ​เซ​คี​ยา	hesekiyaa
อัม​โมน	ammon
เย​โฮ​ยา​คีน	yehoyaakin
เส​ลุบ​บา​เบน	sejlupqbaaben
เย​ซา​ยา	yesaayaa
เล​ไฟ​ยา	lefaiyaa
อาน​นัน	aannan
โอ​บา​ดี	obaadi
เซ​คา​นิ​ยา	sekaaniyaa
เซ​ไม​อา	semaiaa
ยา​หาด	yaahaatg
เม​หิ	mehi
เท​หิน​นา	tehinjnaa
ยา​โลน	yaalon
อิด​บา	itgbaa
บิ​ทิ​ยา	bitiyaa
เย​เล้ด	yeletq
เย​คู​ที​เอน	yekutien
ซิ​โมน	siqmon
ลิน​นา	linnaa
เบน​ฮา​นัน	benhaanan
ทิ​โลน	tilon
โส​เหด	sojhetg
เบน​โซ​เฮ้ด	bensohetq
มา​เล​ซา	maalesaa
ลา​อา​ดา	laaaadaa
เบด​อัด​เบ​อา	betgatgbeaa
เน​ทา​อิม	netaaim
เก​เด​ลา	kedelaa
เน​มู​เอน	nemuen
ยา​ลี้บ	yaalipq
ซัน​ลูม	sanlum
มิบ​สัม	mipqsamj
มิบ​สัม	mipqsamj
ฮัม​มู​เอน	hammuen
ฮัม​มู​เอน	hammuen
สัก​เก	sakgke
โท​ลัด	tolatq
ฮา​ซาน​สู​สิม	haasaansujsimj
เบด​บี​ลี	betgbili
อา​ยิน	aayin
โท​เคน	token
เม​โซ​บับ	mesobapg
ยัม​เล้ก	yamlekq
โย​ซา	yosaa
โย​เอน	yoen
โย​ซิ​บี​ยา	yosibiyaa
โย​ซิ​บี​ยา	yosibiyaa
อา​สิ​เอน	aasien
อา​สิ​เอน	aasien
ยา​อา​โค​บา	yaaaakobaa
เย​โซ​ฮา​ยา	yesohaayaa
อา​ดี​เอน	aadien
เย​สิ​มี​เอน	yesimien
ฒี​ฒา	zizaa
ฒี​ฒา	zizaa
ซิ​ฟี	sifi
ซิ​ฟี	sifi
อัน​โลน	anlon
อัน​โลน	anlon
เย​ดา​ยา	yedaayaa
เย​ดา​ยา	yedaayaa
ซิม​ลี	simli
ซิม​ลี	simli
มี​คา	mikaa
เล​อา​ยา	leaayaa
เบ​เอ​ลา	beelaa
เบ​เอ​ลา	beelaa
ซา​ฟาม	saafaam
ยา​ไน	yaanai
หุ​ลี	huli
หุ​ลี	huli
ยา​โล​อา	yaaloaa
ยา​โล​อา	yaaloaa
กิ​เล​อาด	kileaatg
มี​คา​เอน	mikaaen
เย​ซิ​ไซ	yesisai
เย​ซิ​ไซ	yesisai
ยา​โด	yaado
ยา​โด	yaado
อับ​ดี​เอน	apgdien
อา​หิ	aahi
โน​ดับ	nodapg
เอ​ลี​เอน	elien
ยา​ดี​เอน	yaadien
ฟี​เน​หัด	finehatg
อา​บี​ชู​วา	aabiquwaa
บุก​คี	bukgki
อุด​ซี	utgsi
เส​ลา​หิ​ยา	sejlaahiyaa
เส​ลา​หิ​ยา	sejlaahiyaa
เม​ลา​โย้ด	melaayotq
อา​มา​ลิ​ยา	aamaaliyaa
อา​มา​ลิ​ยา	aamaaliyaa
สา​โดก	saajdokg
ฮิน​คี​ยา	hinkiyaa
เส​ไล​อา	sejlaiaa
เย​โฮ​ซา​ดัก	yehosaadakg
เน​บู​คัด​เน้ด​ซา	nebukatqnetqsaa
สิม​มา	simjmaa
โย​อา	yoaa
โย​อา	yoaa
อิด​โด	itgdo
เฒ​ลา	zelaa
เย​อา​เท​ไล	yeaatelai
เอน​คา​นา	enkaanaa
เอ​บี​ยา​สาบ	ebiyaasaapg
เอ​บี​ยา​สาบ	ebiyaasaapg
ทา​หัด	taahatg
อุ​ลี​เอน	ulien
อุ​ลี​เอน	ulien
อุด​ซี​ยา	utgsiyaa
อา​หิ​โม้ด	aahimotq
โส​ไฟ	sojfai
โส​ไฟ	sojfai
เอ​ลี​อับ	eliapg
เย​โล​ฮัม	yeloham
เย​โล​ฮัม	yeloham
ซิ​เม​อา	simeaa
ฮัก​กี​ยา	hakqkiyaa
ฮัก​กี​ยา	hakqkiyaa
เอ​ลี​เอน	elien
โท​อา	toaa
มา​ฮ้าด	maahaatq
มา​ฮ้าด	maahaatq
อา​มา​ไส	aamaasaij
โย​เอน	yoen
เส​ฟัน​ยา	sejfanyaa
อัด​สี	atgsij
อิด​ฮา	itghaa
โค​ฮ้าด	kohaatq
เล​วี	lewi
อา​สาบ	aasaapg
อา​สาบ	aasaapg
เบ​เล​คิ​ยา	belekiyaa
บา​อา​เส​ยา	baaaasejyaa
บา​อา​เส​ยา	baaaasejyaa
มัน​คิ​ยา	mankiyaa
เอด​นี	etgni
เอด​นี	etgni
เอ​ทาน	etaan
สิม​มา	simjmaa
เก​โซน	keson
คี​ซี	kisi
คี​ซี	kisi
อับ​ดี	apgdi
อับ​ดี	apgdi
มัน​ลุก	manlukq
ฮา​ซา​ปิ​ยา	haasaapiyaa
ฮา​ซา​ปิ​ยา	haasaapiyaa
อัม​ซี	amsi
อัม​ซี	amsi
บา​นี	baani
เช​เม	qeme
มา​ลี	maali
มู​ซี	musi
เม​ลา​ลี	melaali
อุด​ซี	utgsi
เม​ลา​โย้ด	melaayotq
ฮี​เลน	hilen
ดา​เบ​ลัด	daabelatq
มา​ซาน	maasaan
พู​อา	puaa
เย​ดี​ยา​เอน	yediyaaen
เย​ลี​โม้ด	yelimotq
อิ​ลี	ili
เส​มิ​ลา	sejmilaa
เย​เล​โม้ด	yelemotq
อา​เล​เม้ด	aalemetq
บิน​ฮาน	binhaan
เค​นา​อะ​นา	kenaaaanaa
เส​ทาน	sejtaan
อา​หิ​ชา​ฮา	aahiqaahaa
หุบ​ปิม	hupgpim
ซุบ​ปิม	supqpim
เส​โล​เฟ​หัด	sejlofehatg
เป​แล้ด	pelctq
เช​เล้ด	qeletq
เป​แล้ด	pelctq
อุ​ลาม	ulaam
ลา​เคม	laakem
ฮัม​โม​เล​เค้ด	hammoleketq
อิด​โฮ้ด	itghotq
อา​หิ​ยัน	aahiyan
ลิก​ฮี	likqhi
อา​นี​ยัม	aaniyam
เช​เอ​ลา	qeelaa
อุด​เซน​เช​เอ​ลา	utgsenqeelaa
เล​ฟา	lefaa
เล​ฟา	lefaa
เล​เซ้บ	lesepq
เล​เซ้บ	lesepq
เท​ลา	telaa
ทา​ฮัน	taahan
ลา​ดาน	laadaan
ลา​ดาน	laadaan
อัม​มี​ฮู้ด	ammihutq
บิน​ซา​อิด	binsaaitg
มัน​คี​เอน	mankien
ยา​เฟ​เล้ด	yaafeletq
โซ​เม	some
โฮ​ทาม	hotaam
ปา​สัก	paasakg
บิม​ฮาน	bimhaan
อัด​ว้าด	atgwaatq
โล​กา	lokaa
เย​ฮุบ​บา	yehupqbaa
เฮ​เลม	helem
โส​ฟา	sojfaa
เช​เอ​เล้ด	qeeletq
อา​มัน	aaman
สุ​อา	suaa
ฮาน​เน​เฟ	haannefe
เบ​ลี	beli
เบ​เซ	bese
ซิน​ซา	sinsaa
ปิด​ปา	pitgpaa
อา​ลา	aalaa
อุน​ลา	unlaa
ลี​เสีย	lisiaj
โน​ฮา	nohaa
ลา​ฟา	laafaa
อัด​ดา	atgdaa
อา​บี​ฮู้ด	aabihutq
อา​โห​อา	aahojaa
เซ​ฟู​ฟาน	sefufaan
หุ​ลาม	hulaam
เก​ลา	kelaa
ซา​หะ​ลา​อิม	saahaalaaim
บา​อา​ลา​อา	baaaalaaaa
โฮ​เดด	hodetg
สิ​เบีย	sibia
เม​ซา	mesaa
มัน​คาม	mankaam
เย​อุด​เอ	yeutge
สา​เคีย	saajkia
มิน​มา	minmaa
อา​บี​ทู้บ	aabitupq
เอน​ปา​อัน	enpaaan
อา​หิ​โย	aahiyo
ซา​ซัก	saasakq
เส​บา​ดิ​ยา	sejbaadiyaa
เอ​เด	ede
อิด​ปา	itgpaa
โย​ฮา	yohaa
ฮิด​คี	hitqki
อิด​เม​ไล	itgmelai
อิ​สะ​ลิ​ยา	isaaliyaa
ยา​คิม	yaakim
เอ​ลี​เย​ไน	eliyenai
สิน​เล​ไท	sinjletai
เบ​ไล​อา	belaiaa
ซิม​ล้าด	simlaatq
อิด​ปาน	itgpaan
ฮา​นัน	haanan
อัน​โท​ที​ยา	antotiyaa
อิบ​ได​ยา	ipgdaiyaa
ซัม​เซ​ไล	samselai
เซ​หะ​ลี​ยา	sehaaliyaa
ยา​อา​เล​ซี​ยา	yaaaalesiyaa
เย​อี​เอน	yeien
เส​เค	sejke
เซา​โล	saulo
เอด​บา​อัน	etgbaaan
เม​ลิบ​บา​อัน	melipqbaaan
เม​ลิบ​บา​อัน	melipqbaaan
ปิ​โทน	piton
เม​เล้ก	melekq
ทา​เลีย	taalia
เย​โฮ​อัด​ดา	yehoatgdaa
เย​โฮ​อัด​ดา	yehoatgdaa
สิม​ลี	simjli
บิ​เน​อา	bineaa
บิ​เน​อา	bineaa
ลา​ฟา	laafaa
เอ​เล​อา​สา	eleaasaaj
อา​เซน	aasen
โบ​เค​ลู	bokelu
เซ​อา​ลิ​ยา	seaaliyaa
อิ​สะ​ลา​เอน	isaalaaen
เย​อู​เอน	yeuen
สัน​ลู	sanjlu
โฮ​ดา​วิ​ยา	hodaawiyaa
หัด​เส​นู​อา	hatgsejnuaa
อิบ​เน​ยา	ipgneyaa
อิบ​เน​ยา	ipgneyaa
เอ​ลา	elaa
มิก​ลี	mikqli
มิก​ลี	mikqli
เม​ซุน​ลาม	mesunlaam
เซ​ฟา​ทิ​ยา	sefaatiyaa
เล​อู​เอน	leuen
อิบ​นี​ยา	ipgniyaa
เย​โฮ​ยา​ลิบ	yehoyaalipq
อา​ดา​ยา	aadaayaa
ปาด​เฮ	paatghe
ปาด​เฮ	paatghe
มัน​คิ​ยา	mankiyaa
มะ​อา​ไส	maaaasaij
มะ​อา​ไส	maaaasaij
อา​ดี​เอน	aadien
ยา​เซ​ลา	yaaselaa
ยา​เซ​ลา	yaaselaa
เม​ซิน​เล​มิด	mesinlemitq
เม​ซิน​เล​มิด	mesinlemitq
อิม​เม	imme
บัก​บัก​คา	bakgbakgkaa
เฮ​เล้ด​เส	heletqsej
กา​ลาน	kaalaan
มัด​ทา​นิ​ยา	matqtaaniyaa
สิก​ลี	sikgli
กา​ลาน	kaalaan
เย​ดู​ทูน	yedutun
เย​ดู​ทูน	yedutun
เย​อี​เอน	yeien
มิก​โล้ด	mikqlotq
ยา​ลา	yaalaa
ยา​ลา	yaalaa
เย​บุด	yebutg
ปัด​ดัม​มิม	patgdammim
ซัม​โม้ด	sammotq
เป​โลน	pelon
สิบ​เบ​ไค	sipgbekai
อิ​ไล	ilai
อิ​ไท	itai
หุ​ไล	hulai
อาน​บา	aanbaa
ซา​อัน​โบน	saaanbon
เอ​ลี​ยา​บา	eliyaabaa
กิม​โซ	kimso
ฮา​เซม	haasem
ซา​กี	saaki
สา​คา	saajkaa
อู​อา	uaa
เอ​ลี​ฟัน	elifan
เม​เค​ลา	mekelaa
เอด​ไบ	etgbai
นา​อา​ไล	naaaalai
ฮา​กี	haaki
มิบ​ฮา	mipqhaa
อิด​ไล	itglai
ซิ​ซา​อา	sisaaaa
อา​ดี​นา	aadinaa
มิด​เน	mitqne
โย​ซา​ฟัด	yosaafatq
ทิ​ไซ	tisai
มา​หะ​ไว	maahaawai
เอน​นา​อัม	ennaaam
เย​ลี​ไบ	yelibai
โย​ซา​วิ​ยา	yosaawiyaa
เม​โซ​ไบ	mesobai
ยา​อา​ซี​เอน	yaaaasien
เซ​มา​อา	semaaaa
เย​ซี​เอน	yesien
เพ​เหลด	peletg
เบ​ลา​คา	belaakaa
เอ​ลู​ไซ	elusai
เบ​อัน​ยา	beanyaa
เซ​มา​ลิ​ยา	semaaliyaa
ฮา​ลู้บ	haalupq
อิด​ซี​ยา	itgsiyaa
อา​ซา​เลน	aasaalen
โย​เอ​เซ	yoese
ยา​โซ​เบ​อัม	yaasobeam
โย​เอ​ลา	yoelaa
มิด​มัน​นา	mitqmannaa
เอน​ซา​บาด	ensaabaatg
มัก​บัน​ไน	makqbannai
คิ​โดน	kidon
เบ​เอน​ยา​ดา	beenyaadaa
เค​นา​นี​ยา	kenaaniyaa
อา​บี​ไช	aabiqai
ซี​เลีย	silia
ซา​ตาน	saataan
เซ​โล​โม้ด	selomotq
ฮา​ซี​เอน	haasien
เก​โซม	kesom
ฮา​ลิม	haalim
เส​โอ​ลิม	sejolim
มิ​ยา​มิน	miyaamin
ฮัก​โขด	hakqkotg
เย​ซู​อา	yesuaa
หุบ​ปา	hupgpaa
เย​เซ​เบ​อับ	yesebeapg
บิน​กา	binkaa
เฮ​ซี	hesi
หับ​ปิด​เซ้ด	hapgpitgsetq
เป​ทา​หิ​ยา	petaahiyaa
เย​เฮ​เซ​เคน	yeheseken
กา​มุน	kaamun
มา​อา​ซิ​ยา	maaaasiyaa
ยา​อา​ซี​ยา	yaaaasiyaa
เบ​โน	beno
เก​ดา​ลิ​ยา	kedaaliyaa
เส​ลี	yesaayaa
มัด​ที​ทิ​ยา	yedutun
บุก​คี​ยา	bukgkiyaa
เซ​บู​เอน	sebuen
ฮา​นา​นี	haanaani
เอ​ลี​ยา​ทา	eliyaataa
กิด​ดาน​ที	kitgdaanti
โล​มัม​ที​เอ​เซ	lomamtiese
โย้ด​เบ​คา​ซา	yotqbekaasaa
มัน​โล​ที	manloti
โฮ​ที	hoti
มา​หะ​ซิ​โอด	maahaasiotg
เย​โฮ​ฮา​นัน	yehohaanan
เอ​ลี​โฮ​ไน	elihonai
เป​อุน​เล​ไท	peunletai
โฮ​สา	hosaaj
ซัน​เล​เค้ด	sanleketq
เย​ฮี​เอ​ลี	ye
เส​ทาม	yoen
เย​ลี​ยา	yeliyaa
สับ​ดี​เอน	sapgdien
อิ​สะ​ลา	isaalaa
ซัม​หุด	samhutg
เฮน​ได	hendai
เอ​ลี​ฮู	elihu
อิด​ไม​อา	itgmaiaa
เค​ลู้บ	kelupq
เอ​สะ​ลี	esaali
เซ​ฟาม	sefaam
โอ​บิน	obin
เม​โล​โน้ด	melonotq
อาน​คี	aanki
ซา​โล​มอน	saalomxn
ไท​ละ	tailaq
ยับ​ฟา	yapqfaa
เค​ลู​บิม	kelubim
เค​ลู​บิม	kelubim
ซา​โล​มอน	saalomxn
อิ​สะ​ลา​เอน	isaalaaen
ฮา​มัด​โส​บา	haamatqsojbaa
เบด​โฮ​โลน	betgholon
ซา​โล​มอน	saalomxn
เซ​เคม	sekem
เย​โล​โบ​อัม	yeloboam
เล​โห​โบ​อัม	lehojboam
อา​โด​ลา​อิม	aadolaaim
มา​หะ​ลัด	maahaalatq
มา​หะ​ลัด	maahaalatq
มา​หะ​ลัด	maahaalatq
สา​ฮัม	saajham
มา​อา​คา	maaaakaa
อั๊ด​ไท	atqtai
เย​ลู​ซา​เลม	yelusaalem
ยู​ดา	yudaa
เส​ฟา​ทา	sejfaataa
โอ​เดด	odetg
บา​อา​ชา	baaaaqaa
เย​โฮ​ซา​ฟัด	yehosaafatq
เน​ทา​นิ​ยา	netaaniyaa
เซ​มิ​ลา​โม้ด	semilaamotq
เย​โฮ​นา​ทัน	yehonaatan
โท​บี​ยา	tobiyaa
โท้บ​อา​โด​นิ​ยา	topqaadoniyaa
เย​โฮ​ซา​บาด	yehosaabaatg
อา​หับ	aahapg
ลา​โม้ด​กิ​เล​อาด	laamotqkileaatg
เม​อู​นี	meuni
เซียงต๋อง	txvj
ยา​ฮา​ซี​เอน	yaahaasien
อา​หัด​ยา	aahatgyaa
เย​โฮ​ลัม	yeholam
เย​ฮี​เอน	yehien
อา​ซา​ลี​ยา​ฮู	aasaaliyaahu
เย​โฮ​ลัม	yeholam
เอ​ที​โอ​เปีย	etiopia
เย​โฮ​ลัม	yeholam
อา​หับ	aahapg
โย​ลัม	yolam
โย​ลัม	yolam
เย​ฮู	yehu
เย​โฮ​ยา​ดา	yehoyaadaa
ซิ​เม​อัด	simeatg
ซิม​ลิด	simlitq
เย​โฮ​อาด	yehoaatg
เย​โฮ​อาด	yehoaatg
อา​มา​ซิ​ยา	aamaasiyaa
ลา​คี้ด	laakitq
เย​โค​ลี​ยา	yekoliyaa
ยับ​เน	yapqne
ฟี​ลิ​สะ​เตีย	filisaatia
กู​อา​บา​อัน	kuaabaaan
อุด​ซี​ยา	utgsiyaa
อา​ม้อด	aamxtq
โอ​เฟน	ofen
โย​ทาม	yotaam
มา​อา​เส​อา	maaaasejaa
เม​ซิน​เล​โม้ด	mesinlemotq
เย​ฮิด​คี​ยา	yehitqkiyaa
หัด​ไล	hatglai
โค​นา​นิ​ยา	konaaniyaa
โค​เล	kole
เซน​นา​เค​ลิบ	sennaakelipq
ปั์วเดี๊ย	diaq
เฮ​เซ​คี​ยา	hesekiyaa
มะ​นัด​เส	maanatqsej
อา​โมน	aamon
ฮา​ซา​บี​ยา	haasaabiyaa
โย​ซา​บาด	yosaabaatg
เน​โค	neko
คาน​เค​มิด	kaankemitq
โย​อา​หาด	yoaahaatg
เย​เล​มี	yelemi
เป​เซีย	pesia
ไซ​ลัด	sailatq
มัก​บีด	makqbitg
ฮา​ดิด	haaditg
โอ​โน	ono
เส​นา​อา	sejnaaaa
อาน​ทา​เซ​ซี้ด	aantaasesitq
บิด​ลาม	bitglaam
มิด​เล​ดาด	mitqledaatg
ทา​เบ​เอน	taabeen
อาน​ทา​เซ​ซี้ด	aantaasesitq
อาน​ทา​เซ​ซี้ด	aantaasesitq
ดา​ลิ​อัด	daaliatg
เอก​บา​ทา​นา	ekgbaataanaa
ฮัก​ไก	hakqkai
ยิว​ไท	yiutai
อา​หิ​ทู้บ	aahitupq
มา​ลา​โย้ด	maalaayotq
อา​บี​ชู​วา	aabiquwaa
เอ​เล​อา​ซา	eleaasaa
เอ​สะ​ลา	esaalaa
อา​หะ​วา	aahaawaa
เอ​สะ​ลา	esaalaa
เอ​สะ​ลา	esaalaa
ยา​ไซ​อา	yaasaiaa
ซับ​เบ​ไท	sapqbetai
เค​ลา​ยา	kelaayaa
เค​ลิ​ทา	kelitaa
เบ​ได​ยา	bedaiyaa
เค​ลุ​ฮี	keluhi
วา​นิ​ยา	waaniyaa
เม​เล​โม้ด	melemotq
มัด​เท​ไน	matqtenai
ยา​อา​สุ	yaaaasu
เซ​เล​มิ​ยา	selemiyaa
มัก​นา​เด​ไบ	makqnaadebai
ซา​ไซ	saasai
ซา​ไล	saalai
เซ​เล​มิ​ยา	selemiyaa
ฮา​คา​ลิ​ยา	haakaaliyaa
เน​หะ​มี	nehaami
คิด​เล้บ	kitqlepq
สุ​สา	susaaj
นิ​สาน	nisaanj
สัน​บาน​ลัด	sanjbaanlatq
โท​บี​อา	tobiaa
เก​เซม	kesem
อิม​ลี	imli
เม​เซ​ซา​เบน	mesesaaben
โย​ยา​ดา	yoyaadaa
เบ​โส​ได​อา	besojdaiaa
เย​ซา​นา	yesaanaa
ฮา​ลุ​มับ	haalumapq
ฮา​ซับ​เน​ยา	haasapqneyaa
ปา​หัด​โม​อับ	paahatgmoapg
หัด​ซู้บ	hatgsupq
ฮัน​โล​เหด	hanlohetg
เล​ฮูม	lehum
สับ​ไบ	sapgbai
บา​ลุก	baalukq
หัด​ซู้บ	hatgsupq
อา​นา​นี​ยา	aanaaniyaa
เฮ​นา​ดัด	henaadatg
บิน​นุย	binnwi
อุ​ไซ	usai
ปา​ลาน	paalaan
ปา​โล้ด	paalotq
สา​ล้าบ	saajlaapq
โท​บี​อา	tobiaa
โน​อัด​ยา	noatgyaa
ลา​อา​มี​อา	laaaamiaa
นา​หะ​มา​นี	naahaamaani
โม​เด​ไค	modekai
บิน​ซาน	binsaan
มิด​เป​เล้ด	mitqpeletq
บิก​ไว	bikgwai
เน​ฮูม	nehum
เบด​อัด​มา​เว้ด	betgatgmaawetq
ขัด​มี​เอน	katgmien
เช​บา​นี​ยา	qebaaniyaa
บุน​นี	bunni
เซ​เล​ปี​ยา	selepiyaa
เค​นา​นี	kenaani
ขัด​มี​เอน	katgmien
เซ​เล​ปี​ยา	selepiyaa
โฮ​ดี​ยา	hodiyaa
เช​บา​นี​ยา	qebaaniyaa
ดา​นี​เอน	daanien
กิน​เน​โทน	kinneton
บิน​ไก	binkai
เบ​นิ​นู	beninu
ปัด​โล้ด	patglotq
สัด​ทู	satgtu
อัด​กาด	atgkaatg
เบ​ไบ	bebai
อา​ดีน	aadin
อา​เท	aate
ฮา​ซูม	haasum
เบ​ไซ	besai
ฮา​ลิบ	haalipq
เน​ไบ	nebai
มัก​บี​อาด	makqbiaatg
ย้าด​ดู​วา	yaatqduwaa
อา​นา​ยา	aanaayaa
ปิน​หา	pinhaaj
โซ​เบก	sobekg
ฮา​ซับ​นา	haasapqnaa
อา​หิ​อา	aahiaa
อา​นัน	aanan
กับ​ไบ	kapgbai
สัน​ไล	sanjlai
โย​ยา​ลิบ	yoyaalipq
อัด​ลี​คัม	atglikam
สับ​ดี	sapgdi
บัก​บู​คิ​ยา	bakgbukiyaa
อับ​ดา	apgdaa
สี​หะ	sijhag
กิด​ปา	kitgpaa
เบด​เพ​เหลด	betgpeletg
เอน​ลิม​โมน	enlimmon
เส​โบ​อิม	sejboim
เน​บัน​ลัด	nebanlatq
เซ​อัน​ทิ​เอน	seantien
กิน​เน​ทอย	kinnetxi
มา​อา​ดี​ยา	maaaadiyaa
โย​ยา​คิม	yoyaakim
โย​ยา​คิม	yoyaakim
เอ​ลี​ยา​ซี้บ	eliyaasipq
โย​ยา​ดา	yoyaadaa
โย​นา​ทาน	yonaataan
โย​ยา​คิม	yoyaakim
เม​ลา​ยา	melaayaa
มัน​ลู​คี	manluki
เฮน​คาย	henkaai
มิน​ยา​มิน	minyaamin
โม​อัด​ยา	moatgyaa
ปิน​ไท	pintai
คาน​ไล	kaanlai
อา​โม้ก	aamokq
ทัน​โมน	tanmon
เบด​กิน​กาน	betgkinkaan
โฮ​ซา​ยา	hosaayaa
มัด​ทา​นิ​ยา	matqtaaniyaa
มี​คา​ยา	mikaayaa
เอ​ลี​ยา​คิม	eliyaakim
มิน​ยา​มิน	minyaamin
ยิด​สะ​ลา​ยา	yitqsaalaayaa
อัด​โดด	atgdotg
อา​หะ​สุ​เอ​ลัด	aahaasuelatq
อิน​เดีย	india
อา​หะ​สุ​เอ​ลัด	aahaasuelatq
สุ​สา	susaaj
วัด​ชา​ที	watqqaati
อา​หะ​สุ​เอ​ลัด	aahaasuelatq
วัด​ชา​ที	watqqaati
คาน​เซ​นา	kaansenaa
เช​ทา	qetaa
อัด​มา​ทา	atgmaataa
มาน​เส​นา	maansejnaa
เม​มู​คาน	memukaan
เป​เซีย	pesia
เม​มู​คาน	memukaan
วัด​ชา​ที	watqqaati
เย​โค​นี​ยา	yekoniyaa
โม​เด​ไค	modekai
เอ​เซ​เท	esete
เฮ​ไก	hekai
เอ​เซ​เท	esete
เอ​เซ​เท	esete
เท​เบ๊ด	tebetq
เอ​เซ​เท	esete
เอ​เซ​เท	esete
เอ​เซ​เท	esete
เอ​เซ​เท	esete
เอ​เซ​เท	esete
โม​เด​ไค	modekai
บิก​ทาน	bikgtaan
เท​เล้ด	teletq
เอ​เซ​เท	esete
เอ​เซ​เท	esete
ฮา​มาน	haamaan
ฮา​มาน	haamaan
ปู​อา	puaa
ฮา​มาน	haamaan
ฮา​ท้าก	haataakq
ฮา​ท้าก	haataakq
ฮา​ท้าก	haataakq
บิก​ทา​นา	bikgtaanaa
ปาน​ชัน​ดา​ทา	paanqandaataa
ดาน​โฟน	daanfon
อัด​ปา​ทา	atgpaataa
โป​ลา​ทา	polaataa
อา​ดัน​ยา	aadanyaa
อา​ลี​ดา​ทา	aalidaataa
ปาน​มัด​ทา	paanmatqtaa
อา​ลี​ไส	aalisaij
อา​ลี​ได	aalidai
ไว​ซา​ทา	waisaataa
ปู​ลิม	pulim
ปู​ลิม	pulim
เคน​เดีย	kendia
เล​วี​อา​ทาน	lewiaataan
ชู​วา	quwaa
บิน​ดัด	bindatg
นา​อา​เม	naaaame
เอ​ลี​ฮู	elihu
เบ​เฮ​โม้ด	behemotq
เซ​ลา	selaa
เซ​ลา	selaa
ตอเหฒี่ย	txb
ฒุ์ยเมี่ยน	myenb
เล​บา​นอน	lebaanxn
ซี​ลี​โอน	silion
ตั๋งต๋น	tonj
มิ​ซา	misaa
เก​บาน	kebaan
โอ​เล้บ	olepq
เส​เอบ	sejepg
สาน​มุน​นา	saanjmunnaa
อา​เมน	aamen
ววมหล่าง	laavg
เมน​คี​เซ​เดก	menkisedekg
จอ​แดน	jxdcn
ดา​เล้ด	daaletq
ลา​เม้ด	laametq
ยา​โค้บ	yaakopq
เอ​ฟา​ทา	efaataa
ยา​อา	yaaaa
ซีงเฉีย	qiaj
ฟุป่วน	pwrng
ก๊องหฌาว	faauj
ยา​เค	yaake
อา​กู	aaku
อิ​ที​เอน	itien
อิ​ที​เอน	itien
อู​คาน	ukaan
เล​มู​เอน	lemuen
ซา​โลน	saalon
จั๋น	janb
อัน​มัน	anman
ซู​เลม	sulem
ซู​เลม	sulem
หละเปย๊ยแบ๋ง	bcvj
สี่ต้อง	txvb
ปี๋งเธี้ยว	zyruq
เปย๊าฮวาง	waav
ววมต้ม	tomb
เล​มา​ลิ​ยา	lemaaliyaa
ดา​มัด​กัด	daamatqkatg
มา​เฮ​ซา​ลาน​หัด​บัด’	maahesaalaanhatgbatg’
ตาวน่อม	nxmb
เอ​ฟา​อิม	efaaim
คาน​โน	kaanno
แป่งง์าย	vaaid
เดี๋ยงด๋น	donj
ไอ​ย้าด	aiyaatq
มัด​เม​นา	matqmenaa
เก​บิม	kebim
บา​บี​โลน	baabilon
โม​อับ	moapg
โม​อับ	moapg
เอก​ลา​อิม	ekglaaim
เบ​เอ​เอ​ลิม	beeelim
คีน​หะ​เล​เซ้ด	kinhaalesetq
ไน​อา	naiaa
อี​ยิบ	iyipq
อัด​ซี​เลีย	atgsilia
ฮยวังเฮยี้ยน	ywavb
เซ้บ​นา	sepqnaa
ไลหฮนาง	naavj
เล​วี​อา​ทาน	lewiaataan
อา​ลี​เอน	aalien
อา​ลี​เอน	aalien
หฑยาวเจี๊ยะ	jiaq
สิ​โอน	sion
อิ​สะ​ยา	isaayaa
ไซ​ปัด	saipatg
เปี๊ยวจ้อย	jxib
เฑียววม	riab
โล์แกง	kcv
ยู​เฟ​ติด	yufetitg
บา​อัน	baaan
เนียหะโล่ว	halrub
ปั์วเหฒา	zauj
มัน​คี​อา	mankiaa
โย​สิ​ยา	yosiyaa
สี​ดา	sijdaa
อัด​เค​โลน	atgkelon
อุ​ลี​อา	uliaa
เอ​ลา​ซา	elaasaa
เก​มา​ลิ​ยา	kemaaliyaa
โค​ลา​ยา	kolaayaa
เน​เฮ​ลาม	nehelaam
เส​ฟัน​ยา	sejfanyaa
เน​เฮ​ลาม	nehelaam
ปู๋งหฒัวะ	puvb
โก​อา	koaa
เส​เด​คี​ยา	sejdekiyaa
เคน​เดีย	kendia
อิก​ดา​ลิ​ยา	ikgdaaliyaa
เน​ลิ​ยา	neliyaa
บา​ลุก	baalukq
เก๊าะเมี่ยน	kxg
บา​ลุก	baalukq
บา​ลุก	baalukq
บา​ลุก	baalukq
โค​นิ​ยา	koniyaa
เย​ฮู​คัน	yehukan
เบน​ยา​มิน	benyaamin
อิ​ลี​ยา	iliyaa
มัด​ทาน	matqtaan
เอ​เบด​เม​เล้ก	ebetgmelekq
เอ​เบด​เม​เล้ก	ebetgmelekq
เอ​เบด​เม​เล้ก	ebetgmelekq
เย​เล​มี	yelemi
เน​กัน​ซา​เล​เซ	nekansaalese
สัม​กา​เน​โบ	samjkaanebo
สาน​เส​คิม	saanjsejkim
เน​กัน​ซา​เล​เซ	nekansaalese
คา​เล​อา	kaaleaa
ทัน​หุ​เม้ด	tanhumetq
เอ​ฟาย	efaai
เย​ซัน​ยา	yesanyaa
คา​เล​อา	kaaleaa
เก​ดา​ลิ​ยา	kedaaliyaa
ทา​ปาน​เหด	taapaanhetg
ทา​ปาน​เหด	taapaanhetg
เมม​ฟิด	memfitq
อา​ปิด	aapitg
คี​ลิ​ยา​ทา​อิม	kiliyaataaim
มัด​เมน	matqmen
ลู​หิด	luhitg
โฮ​โล​นา​อิม	holonaaim
เค​โม้ด	kemotq
ดี​โบน	dibon
เบด​ดิบ​ลา​ทา​อิม	betgdipglaataaim
คี​ลิ​ยา​ทา​อิม	kiliyaataaim
เบด​กา​มุน	betgkaamun
เบด​เม​โอน	betgmeon
สิบ​มา	sipgmaa
ยา​เซ	yaase
เอ​เล​อา​เล	eleaale
โฮ​โล​นา​อิม	holonaaim
เอก​ลัด​เซ​ลี​ซี​ยา	ekglatqselisiyaa
นิม​ลิม	nimlim
เอ​โดม	edom
เอ​โดม	edom
เอ​ลาม	elaam
เจียมฒ้าน	jyemb
ฟองธัง	fxvb
บา​บี​โลน	baabilon
มา​เส​ยา	maasejyaa
เน​บู​คัด​เน้ด​ซา	nebukatqnetqsaa
ป๊วนกั๊วะ	pwrnb
แซงฮม์	scvb
เค​บา	kebaa
เค​บา	kebaa
ยา​อา​ซัน​ยา	yaaaasanyaa
ลุยจั๊วะ	lwib
บา​มา	baamaa
โอ​โฮ​ลา	oholaa
โอ​โฮ​ลี​บา	oholibaa
โอ​โฮ​ลา	oholaa
โอ​โฮ​ลี​บา	oholibaa
โอ​โฮ​ลา	oholaa
โอ​โฮ​ลี​บา	oholibaa
โอ​โฮ​ลา	oholaa
โอ​โฮ​ลี​บา	oholibaa
โอ​โฮ​ลี	oholi
โอ​โฮ​ลี​บา	oholibaa
เอ​เส​เคน	esejken
เบด​โท​กาน​มา	betgtokaanmaa
กาน​บุน	kaanbun
เอ​ที​โอ​เปีย	etiopia
เป​ลู​เซียม	pelusyem
เป​ลู​เซียม	pelusyem
พี​เบ​เสด	pibesetg
แซงเธี้ยด	scvb
เดี๋ยงเตว๊ย	tweiq
เมี้ยเธี้ยง	miab
โฮ​เม	home
โฮ​เม	home
โฮ​เม	home
เซ​เขน	sekenj
เซ​เขน	sekenj
เซ​เขน	sekenj
เซ​เขน	sekenj
เซ​เขน	sekenj
มี​นา	minaa
เซ​เขน	sekenj
โฮ​เม	home
โฮ​เม	home
โฮ​เม	home
อัด​เป​นัด	atgpenatq
ฮัน​นัน​ยา	hannanyaa
ดา​นี​เอน	daanien
ดา​นี​เอน	daanien
เบน​เท​ซัด​ซา	bentesatqsaa
ดา​นี​เอน	daanien
ซัด​ลัก	satqlakq
เม​ซ้าก	mesaakq
อา​เบด​เน​โก	aabetgneko
อา​เบด​เน​โก	aabetgneko
อา​เบด​เน​โก	aabetgneko
อา​เบด​เน​โก	aabetgneko
เบน​ซัด​ซา	bensatqsaa
เบน​ซัด​ซา	bensatqsaa
เบน​ซัด​ซา	bensatqsaa
เม​เน	mene
เม​เน	mene
เท​เคน	teken
ปา​ซิน	paasin
ปา​ซิน	paasin
ดา​ลิ​อัด	daaliatg
อู​ไล	ulai
อู​ไล	ulai
กา​เบ​เลียน	kaabelyen
ไท​กิด	taikitg
เย​เล​โบ​อัม	yeleboam
โฮ​เซ​ยา	hoseyaa
ดิบ​ลา​อิม	dipglaaim
โก​เม	kome
โล​ลุ​หะ​มา	loluhaamaa
โล​อัม​มี	loammi
อัม​มี	ammi
ลู​ฮา​มา	luhaamaa
หล่ม	lomb
อา​โค	aako
เบด​อา​เวน	betgaawen
ซัน​มัน	sanman
เบด​อาน​เบน	betgaanben
อา​โม้ด	aamotq
อา​โม้ด	aamotq
อา​เวน	aawen
เบด​เอ​เดน	betgeden
กา​ซา	kaasaa
เค​ลิ​โอด	keliotg
กิน​กาน	kinkaan
คาน​นา​อิม	kaannaaim
ฟี​นี​เซีย	finisia
สา​เล​ฟัด	saajlefatq
เส​ฟา​ล้าด	sejfaalaatq
อา​มิด​ไท	aamitqtai
โย​นา	yonaa
โย​นา	yonaa
นิ​นะ​เว	ninaawe
ซา​ฟี	saafi
ซา​นัน	saanan
เบด​เอ​เซน	betgesen
มา​โล้ด	maalotq
เปย๊ยเฒ้ย	pyeib
เอน​โขด	enkotg
นา​ฮูม	naahum
ลิ​เบีย	libia
ฮา​บา​กุก	haabaakukg
ซิ​กิ​โอ​โน้ด	sikionotq
คู​ซี	kusi
มิน​โคม	minkom
ติ๊วโหฌะ	tiub
จายห่อง	hxvg
เปย๊าบาง	baav
ฌังหล่าง	favb
ฮัก​ไก	hakqkai
อิ​สะลา​เอน	isaalaaen
โย​ซู​วา	yosuwaa
โย​ซา​ดัด	yosaadatg
ไธต๋อย	zaib
เป​เล้ด	peletq
เฮ้ด​โลน	hetqlon
โบ​อาด	boaatg
เจียด​ซี	jyetgsi
เซ​อัน​ทิ​เอน	seantien
อา​บี​ยุด	aabiyutq
อา​บี​ยุด	aabiyutq
เอ​ลี​ยา​คิม	eliyaakim
อา​ซอ	aasx
อา​ซอ	aasx
อา​คิม	aakim
อา​คิม	aakim
เอ​ลี​อูด	eliutg
เอ​ลี​อูด	eliutg
มัด​ทาน	matqtaan
โย​เซ้บ	yosepq
มา​ลี​ยา	maaliyaa
มา​ลี​ยา	maaliyaa
เย​ซู	yesu
เย​ซู	yesu
กี​ตู่	kitug
มา​ลี​ยา	maaliyaa
เย​ซู	yesu
อี​มา​นู​เอน	imaanuen
เฮ​โล้ด	helotq
ยู​เดีย	yudia
นา​ซา​เล้ด	naasaaletq
นา​ซา​เล้ด	naasaaletq
โย​ฮัน	yohan
โย​ฮัน	yohan
โย​ฮัน	yohan
โย​ฮัน	yohan
โย​ฮัน	yohan
ตอน	txnb
เส​เบ​ดี	sejbedi
ยา​กอบ	yaakxpg
โท้ด​บุ​ลี	totqbuli
กี​โล	kilo
กี​โล	kilo
ฟี​ลิบ	filipq
บา​โท​โล​มิว	baatolomiu
โท​มัด	tomatq
มัด​ทาย	matqtaai
อัน​เฟ​อัด	anfeatg
ทัด​เด​อัด	tatqdeatg
ซี​โมน	simon
ยู​ดาด	yudaatg
อิ​สะ​คา​ลิ​โอด	isaakaaliotg
ฟา​ลิ​สี	faalisij
ฟา​ลิ​สี	faalisij
เบ​เอน​เซ​บูน	beensebun
ซา​ตาน	saataan
เฮ​โล​เดียด	helodyetg
เย​ซู	yesu
เบย์าตอน	txn
สะ​ดู​สี	saadusij
สะ​ดู​สี	saadusij
ปี​เต	pite
ปี​เต	pite
ไซ	saib
เบ​ทา​นี	betaani
ซี​ซา	sisaa
ซี​ซา	sisaa
ซี​ซา	sisaa
สะ​ดู​สี	saadusij
กี​ตู่	kitug
คา​ยา​ฟ้าด	kaayaafaatq
ฒอง	zxvb
ปี​เต	pite
โล​มา	lomaa
ปี​ล้าด	pilaatq
ยู​ดาด	yudaatg
ปี​ล้าด	pilaatq
ปี​ล้าด	pilaatq
ปี​ล้าด	pilaatq
ฒุ์ย	zwib
บา​ลับ​บัด	baalapqbatg
ปี​ล้าด	pilaatq
บา​ลับ​บัด	baalapqbatg
ปี​ล้าด	pilaatq
ปี​ล้าด	pilaatq
บา​ลับ​บัด	baalapqbatg
ปี​ล้าด	pilaatq
บา​ลับ​บัด	baalapqbatg
ปี​ล้าด	pilaatq
ปี​ล้าด	pilaatq
ปี​ล้าด	pilaatq
ปี​ล้าด	pilaatq
ไซ​ลีน	sailin
ซี​โมน	simon
เอ​ลี	eli
ลา​มา​ซา​บัก​ทา​นี	laamaasaabakgtaani
มัก​ดา​ลา	makqdaalaa
ปี​ล้าด	pilaatq
ปี​ล้าด	pilaatq
มัก​ดา​ลา	makqdaalaa
ปี​ล้าด	pilaatq
อัน​ดา​ลู	andaalu
คา​เป​นา​อุม	kaapenaaum
อิ​ดู​เม​อา	idumeaa
เย​ซู	yesu
เย​ซู	yesu
โบ​อา​เน​เย	boaaneye
เย​ซู	yesu
เฮ​โล้ด	helotq
เบด​ไซ​ดา	betgsaidaa
โม​เซ	mose
บา​ทิ​เม​อัด	baatimeatg
โฮ​ซา​นา	hosaanaa
โล​มา	lomaa
นา​ดา	naadaa
อา​เล้ก​ซาน​เด	aalekqsaande
ลู​ฟัด	lufatq
เอ​โล​อี	eloi
เอ​โล​อี	eloi
โย​เสด	yosetg
สะ​โล​เม	saalome
เส​คา	sejkaaliyaa
เส​คา​ลิ​ยา	sejkaaliyaa
เอ​ลี​ซา​เบด	elisaabetg
เอ​ลี​ซา​เบด	elisaabetg
อัน​นา	annaa
ฟา​นู​เอน	faanuen
อัน​นา	annaa
ทิ​เบ​ลิ​อัด	tibeliatg
ปอน​ทิ​อัด	pxntiatg
อิ​ทู​เลีย	itulia
ตา​โค​นิ​ติด	taakonititg
ลี​ซา​เนี้ยด	lisaanyetq
อา​บี​เลน	aabilen
เฮ​ลี	heli
เฮ​ลี	heli
มัด​ทัด	matqtatq
มัด​ทัด	matqtatq
เมน​คี	menki
เมน​คี	menki
ยัน​นาย	yannaai
ยัน​นาย	yannaai
มัด​ทา​ที​อัด	matqtaatiatg
มัด​ทา​ที​อัด	matqtaatiatg
นา​ฮูม	naahum
เอด​ลี	etgli
เอด​ลี	etgli
นัก​กาย	nakqkaai
นัก​กาย	nakqkaai
มา​อาด	maaaatg
มา​อาด	maaaatg
มัด​ทา​ที​อัด	matqtaatiatg
มัด​ทา​ที​อัด	matqtaatiatg
เส​เม​อิน	sejmein
เส​เม​อิน	sejmein
โย​เสก	yosekg
โย​เสก	yosekg
โย​ดา	yodaa
โย​ดา	yodaa
โย​อา​นัน	yoaanan
โย​อา​นัน	yoaanan
เล​ซา	lesaa
เล​ซา	lesaa
เน​ลี	neli
เน​ลี	neli
เมน​คี	menki
เมน​คี	menki
อัด​ดี	atgdi
อัด​ดี	atgdi
โค​สัม	kosamj
โค​สัม	kosamj
เอน​มา​ดัม	enmaadam
เอน​มา​ดัม	enmaadam
เอ​อา	eaa
เอ​ลี​เย​เซ	eliyese
โย​ลิม	yolim
โย​ลิม	yolim
มัด​ทัด	matqtatq
มัด​ทัด	matqtatq
สิ​เม​โอน	simeon
โย​นาม	yonaam
โย​นาม	yonaam
เม​เล​อา	meleaa
เม​เล​อา	meleaa
เมน​นา	mennaa
เมน​นา	mennaa
มัด​ตะ​ทา	matqtaataa
มัด​ตะ​ทา	matqtaataa
อัด​มิน	atgmin
อัด​มิน	atgmin
อาน​นี	aanni
อาน​นี	aanni
อับ​ลา​ฮัม	apglaaham
นา​โฮ	naaho
เส​ลุก	sejlukq
เล​อู	leu
เป​เล้ก	pelekq
เอ​เบ	ebe
ไค​นาน	kainaan
ไค​นาน	kainaan
อาน​ฟา​ซัด	aanfaasatq
ลา​เม้ก	laamekq
ยา​เล้ด	yaaletq
มา​หะ​ลา​เล​เอน	maahaalaaleen
มา​หะ​ลา​เล​เอน	maahaalaaleen
เอ​โน้ด	enotq
อา​ดัม	aadam
ซี​โมน	simon
ปี​เต	pite
เก​ลา​ซา	kelaasaa
ไย​ลัด	yailatq
ปี​เต	pite
สะ​มา​เลีย	saamaalia
เปย๊าเฒี้ยว	pyaub
มา​ทา	maataa
กา​ลิ​ลี	kaalili
สี​โล​อัม	sijloam
แฒะตาน	taan
ลา​ซา​ลัด	laasaalatq
กง	kovb
สัก​เคี้ยด	sakgkyetq
มา​ลี	maali
เฮ​โล้ด	helotq
เคน​โอ​ปัด	kenopatg
ล์าง	laavb
อัน​ดา​ลู	andaalu
เค​ฟ้าด	kefaatq
เค​ฟ้าด	kefaatq
ฟี​ลิบ	filipq
นา​ทา​นา​เอน	naataanaaen
นา​ทา​นา​เอน	naataanaaen
นี​โค​เด​มัด	nikodematq
นี​โค​เด​มัด	nikodematq
อาย​โนน	aainon
สา​ลิม	saajlim
สิ​คา	sikaa
ยิว​ไท	yiutai
คา​นา	kaanaa
คา​เป​นา​อุม	kaapenaaum
ลิ​ลี	kaalili
ฟา​ลิ​สี	faalisij
เย​ซู	yesu
ลา​ซา​ลัด	laasaalatq
ลา​ซา​ลัด	laasaalatq
มา​ทา	maataa
มา​ทา	maataa
ลา​ซา​ลัด	laasaalatq
คา​ยา​ฟ้าด	kaayaafaatq
ยู​ดาด	yudaatg
มัน​คัด	mankatq
อัน​น้าด	annaatq
ลา​ติน	laatin
เท​โอ​ฟี​ลัด	teofilatq
อา​เคน​ดา​มา	aakendaamaa
เพน​เท​ค้อด	pentekxtq
อา​นา​เนีย	aanaania
สับ​ฟี​ลา	sapgfilaa
อา​นา​เนีย	aanaania
สะ​เท​เฟน	saatefen
สะ​เท​เฟน	saatefen
โป​โค​ลัด	pokolatq
นิ​คา​โน	nikaano
ทิ​โมน	timon
ปาน​เม​นัด	paanmenatq
อัน​ที​โอก	antiokg
นี​โค​เลา	nikolau
เซา​โล	saulo
ไอ​เน​อัด	aineatg
ไอ​เน​อัด	aineatg
ลิด​ดา	litqdaa
ลิด​ดา	litqdaa
ยับ​ฟา	yapqfaa
ลิด​ดา	litqdaa
โค​เน​ลิ​อัด	koneliatg
โค​เน​ลิ​อัด	koneliatg
ซี​ซา​ลี​ยา	sisaaliyaa
บา​นา​บัด	baanaabatg
บา​นา​บัด	baanaabatg
ทา​ซัด	taasatq
อา​กา​บัด	aakaabatg
คา​ลาว​ดิ​อัด	kaalaaudiatg
มา​โค	maako
โล​ดา	lodaa
มา​โค	maako
เอ​ลี​ม้าด	elimaatq
เปา​โล	paulo
เปา​โล	paulo
อี​โค​นี​ยูม	ikoniyum
เฮ​เม้ด	hemetq
อี​โค​นี​ยูม	ikoniyum
เป​กา	pekaa
อัด​ทา​ลิ​ยา	atgtaaliyaa
ซี​ลา	silaa
มา​ซี​โด​เนีย	maasidonia
เปา​โล	paulo
ซี​ลา	silaa
อัม​ฟี​บุ​ลี	amfibuli
อา​ปอ​โล​เนีย	aapxlonia
เท​สะ​โล​นิ​กา	tesaalonikaa
ยา​โสน	yaasonj
ยา​โสน	yaasonj
อา​เทน	aaten
ทิ​โม​ไท	timotai
อา​เล​โอ​ปา​กัด	aaleopaakatg
อา​เทน	aaten
โค​ลิน​โท	kolinto
ทิ​ทิ​อัด​ยุ​สะ​ทัด	titiatgyusaatatq
คะ​ลิด​ปัด	kaalitqpatg
โค​ลิน​โท	kolinto
กัน​ลิ​โอ	kanlio
อา​คา​ยา	aakaayaa
กัน​ลิ​โอ	kanlio
กัน​ลิ​โอ	kanlio
เอ​เฟ​โซ	efeso
ปิด​สิน​ลา	pitgsinjlaa
อา​ควิน​ลา	aakwinlaa
เอ​เฟ​โซ	efeso
อา​ปอ​โล	aapxlo
ปิด​สิน​ลา	pitgsinjlaa
อา​ควิน​ลา	aakwinlaa
เส​วา	sejwaa
อาน​เท​มิด	aantemitq
เอ​เซีย	esia
อา​เล้ก​ซาน​เด	aalekqsaande
เด​เม้ด​ลิ​อัด	demetqliatg
เบ​โล​อา	beloaa
ปี​ลัด	pilatq
โส​ปา​เท	sojpaate
อา​ลิด​ทา​คัด	aalitqtaakatq
เส​คุน​ดัด	sejkundatg
กาย​อัด	kaaiatg
ที​คิ​กัด	tikikatg
โต​ฟี​มัด	tofimatq
โต​อัด	toatg
ยู​ทิ​กัด	yutikatg
ยู​ทิ​กัด	yutikatg
อัด​โสด	atgsotg
อัด​โสด	atgsotg
มิ​ทิ​เล​นี	mitileni
ซี​ลี​เซีย	silisia
เปา​โล	paulo
เฟ​ลิก	felikq
เฟ​ลิก	felikq
คา​ลาว​ดิ​อัด	kaalaaudiatg
ลี​เซี้ยด	lisyetq
เท​ทู​ลัด	tetulatq
ปอ​สิ​อัด	pxsiatg
เฟ​สะ​ทัด	fesaatatq
เฟ​สะ​ทัด	fesaatatq
เฟ​สะ​ทัด	fesaatatq
เฟ​สะ​ทัด	fesaatatq
อา​ฆี​พา	aagipaa
เบ​นิด	benitq
อา​ฆี​พา	aagipaa
เฟ​สะ​ทัด	fesaatatq
อา​ฆี​พา	aagipaa
ปุบ​ลิ​อัด	pupgliatg
ไซ​ลา​คิว	sailaakiu
เล​ยี​อูม	leyium
ปู​ที​โอ​ลี	putioli
ยิว​ไท	yiutai
อับ​ลา​ฮัม	apglaaham
วิน	winb
กี​ตู่	kitug
สะ​เปน	saapen
สะ​เปน	saapen
สะ​เปน	saapen
อา​เปน​เล้ด	aapenletq
อา​ลิด​โท​บู​ลัด	aalitqtobulatq
ตี​เฟ​นา	tifenaa
ตี​โฟ​สา	tifosaaj
เป​สิด	pesitg
ลู​ฟัด	lufatq
ฟี​โล​โล​กัด	filolokatg
ยู​เลีย	yulia
เน​เล​อัด	neleatg
โอ​ลิม​ปัด	olimpatg
ลู​สิ​อัด	lusiatg
โส​สิ​ปา​เท	sojsipaate
เท​ทิ​อัด	tetiatg
สะ​เท​ฟา​นัด	saatefaanatq
อา​ปอ​โล	aapxlo
มา​ซี​โด​เนีย	maasidonia
ฟอ​ทู​นา​ทัด	fxtunaatatq
อา​คาย​คัด	aakaaikatq
กี​ตู่	kitug
เบ​ลี​อัน	belian
ทิ​ตัด	titatg
ทิ​ตัด	titatg
ทิ​ตัด	titatg
อา​บา	aabaa
ยู​โอ​เดีย	yuodia
สิน​ทิ​เค	sinjtike
เคน​เมน	kenmen
เอ​ปา​โฟ​ดิ​ทัด	epaafoditatq
เอ​ปา​ฟา	epaafaa
เอ​ปา​ฟา	epaafaa
ตอน	txnb
เลา​ดี​เซีย	laudisia
ยุ​สะ​ทัด	yusaatatq
ฮี​เม​เน​อัด	himeneatg
ปอง	pxvb
ฟี​เจ​ลัด	fijelatq
เฮ​โม​เก​เน้ด	hemokenetq
ฟี​เล​ทัด	filetatq
ยัน​เน้ด	yannetq
ยัม​เบ	yambe
เด​ม้าด	demaatq
เค​เล​เซน	kelesen
กา​ลา​เทีย	kaalaatia
ดาน​มา​เทีย	daanmaatia
ลู​กา	lukaa
โอ​เน​สิ​โฟ​ลัด	onesifolatq
เอ​ลัด​ทัด	elatqtatq
มิ​เล​ทัด	miletatq
เส​น้าด	sejnaatq
ฟี​เล​โมน	filemon
โอ​เน​สิ​มัด	onesimatq
โอ​เน​สิ​มัด	onesimatq
โอ​เน​สิ​มัด	onesimatq
โอ​เน​สิ​มัด	onesimatq
ซา​เลม	saalem
เมน​คี​เซ​เดก	menkisedekg
ซา​เลม	saalem
ซา​เลม	saalem
เมน​คี​เซ​เดก	menkisedekg
อา​แบน	aabcn
โม​เซ	mose
บา​ลา​อัม	baalaaam
คา​อิน	kaain
ยิว​ดา	yiudaa
โค​ลา	kolaa
อา​ละ​มา​เกด​โดน	aalaamaaketgdon
อา​เล​ลู​ยา	aaleluyaa
อัน​ฟา	anfaa
โอ​เม​กา	omekaa
